CODREG;REG;CODDEP;CODARR;CODCAN;CODCOM;COM;PMUN;PCAP;PTOT
84;Auvergne-Rhône-Alpes;01;2;08;001;L'Abergement-Clémenciat;779;19;798
84;Auvergne-Rhône-Alpes;01;1;01;002;L'Abergement-de-Varey;256;1;257
84;Auvergne-Rhône-Alpes;01;1;01;004;Ambérieu-en-Bugey;14134;380;14514
84;Auvergne-Rhône-Alpes;01;2;22;005;Ambérieux-en-Dombes;1751;25;1776
84;Auvergne-Rhône-Alpes;01;1;04;006;Ambléon;112;6;118
84;Auvergne-Rhône-Alpes;01;1;01;007;Ambronay;2800;115;2915
84;Auvergne-Rhône-Alpes;01;1;01;008;Ambutrix;762;15;777
84;Auvergne-Rhône-Alpes;01;1;04;009;Andert-et-Condon;326;9;335
84;Auvergne-Rhône-Alpes;01;1;10;010;Anglefort;1105;17;1122
84;Auvergne-Rhône-Alpes;01;4;14;011;Apremont;368;11;379
84;Auvergne-Rhône-Alpes;01;1;10;012;Aranc;329;4;333
84;Auvergne-Rhône-Alpes;01;1;01;013;Arandas;143;4;147
84;Auvergne-Rhône-Alpes;01;4;15;014;Arbent;3349;93;3442
84;Auvergne-Rhône-Alpes;01;1;04;015;Arboys en Bugey;650;17;667
84;Auvergne-Rhône-Alpes;01;2;17;016;Arbigny;460;9;469
84;Auvergne-Rhône-Alpes;01;1;01;017;Argis;457;16;473
84;Auvergne-Rhône-Alpes;01;1;10;019;Armix;27;4;31
84;Auvergne-Rhône-Alpes;01;2;22;021;Ars-sur-Formans;1457;28;1485
84;Auvergne-Rhône-Alpes;01;1;10;022;Artemare;1249;18;1267
84;Auvergne-Rhône-Alpes;01;2;17;023;Asnières-sur-Saône;76;0;76
84;Auvergne-Rhône-Alpes;01;2;02;024;Attignat;3251;65;3316
84;Auvergne-Rhône-Alpes;01;2;17;025;Bâgé-Dommartin;4065;106;4171
84;Auvergne-Rhône-Alpes;01;2;17;026;Bâgé-le-Châtel;973;68;1041
84;Auvergne-Rhône-Alpes;01;2;12;027;Balan;2563;52;2615
84;Auvergne-Rhône-Alpes;01;2;22;028;Baneins;617;17;634
84;Auvergne-Rhône-Alpes;01;2;18;029;Beaupont;685;8;693
84;Auvergne-Rhône-Alpes;01;2;21;030;Beauregard;829;15;844
84;Auvergne-Rhône-Alpes;01;4;14;031;Bellignat;3652;234;3886
84;Auvergne-Rhône-Alpes;01;2;12;032;Béligneux;3376;29;3405
84;Auvergne-Rhône-Alpes;01;4;03;033;Valserhône;16378;350;16728
84;Auvergne-Rhône-Alpes;01;1;04;034;Belley;9182;400;9582
84;Auvergne-Rhône-Alpes;01;4;14;035;Belleydoux;310;8;318
84;Auvergne-Rhône-Alpes;01;1;10;036;Valromey-sur-Séran;1326;19;1345
84;Auvergne-Rhône-Alpes;01;1;11;037;Bénonces;308;4;312
84;Auvergne-Rhône-Alpes;01;2;18;038;Bény;754;21;775
84;Auvergne-Rhône-Alpes;01;1;10;039;Béon;443;8;451
84;Auvergne-Rhône-Alpes;01;2;02;040;Béréziat;486;10;496
84;Auvergne-Rhône-Alpes;01;1;01;041;Bettant;748;21;769
84;Auvergne-Rhône-Alpes;01;2;23;042;Bey;291;14;305
84;Auvergne-Rhône-Alpes;01;2;13;043;Beynost;4754;113;4867
84;Auvergne-Rhône-Alpes;01;4;03;044;Billiat;632;16;648
84;Auvergne-Rhône-Alpes;01;2;22;045;Birieux;283;4;287
84;Auvergne-Rhône-Alpes;01;2;23;046;Biziat;895;8;903
84;Auvergne-Rhône-Alpes;01;1;11;047;Blyes;1182;32;1214
84;Auvergne-Rhône-Alpes;01;2;13;049;La Boisse;3283;73;3356
84;Auvergne-Rhône-Alpes;01;2;17;050;Boissey;365;4;369
84;Auvergne-Rhône-Alpes;01;4;16;051;Bolozon;91;1;92
84;Auvergne-Rhône-Alpes;01;2;22;052;Bouligneux;328;6;334
84;Auvergne-Rhône-Alpes;01;2;99;053;Bourg-en-Bresse;41111;1742;42853
84;Auvergne-Rhône-Alpes;01;1;12;054;Bourg-Saint-Christophe;1457;32;1489
84;Auvergne-Rhône-Alpes;01;4;16;056;Boyeux-Saint-Jérôme;349;5;354
84;Auvergne-Rhône-Alpes;01;2;17;057;Boz;519;16;535
84;Auvergne-Rhône-Alpes;01;1;04;058;Brégnier-Cordon;828;21;849
84;Auvergne-Rhône-Alpes;01;4;10;060;Brénod;493;21;514
84;Auvergne-Rhône-Alpes;01;1;04;061;Brens;1144;35;1179
84;Auvergne-Rhône-Alpes;01;2;12;062;Bressolles;934;22;956
84;Auvergne-Rhône-Alpes;01;4;14;063;Brion;533;7;540
84;Auvergne-Rhône-Alpes;01;1;11;064;Briord;1070;20;1090
84;Auvergne-Rhône-Alpes;01;2;02;065;Buellas;1812;64;1876
84;Auvergne-Rhône-Alpes;01;1;04;066;La Burbanche;89;1;90
84;Auvergne-Rhône-Alpes;01;4;16;067;Ceignes;255;13;268
84;Auvergne-Rhône-Alpes;01;4;16;068;Cerdon;775;15;790
84;Auvergne-Rhône-Alpes;01;2;07;069;Certines;1503;39;1542
84;Auvergne-Rhône-Alpes;01;3;09;071;Cessy;4808;117;4925
84;Auvergne-Rhône-Alpes;01;2;07;072;Ceyzériat;3194;62;3256
84;Auvergne-Rhône-Alpes;01;1;04;073;Ceyzérieu;1000;25;1025
84;Auvergne-Rhône-Alpes;01;2;07;074;Chalamont;2589;35;2624
84;Auvergne-Rhône-Alpes;01;2;22;075;Chaleins;1382;31;1413
84;Auvergne-Rhône-Alpes;01;1;10;076;Chaley;125;3;128
84;Auvergne-Rhône-Alpes;01;4;16;077;Challes-la-Montagne;196;3;199
84;Auvergne-Rhône-Alpes;01;3;20;078;Challex;1557;33;1590
84;Auvergne-Rhône-Alpes;01;1;10;079;Champagne-en-Valromey;811;31;842
84;Auvergne-Rhône-Alpes;01;1;10;080;Champdor-Corcelles;643;14;657
84;Auvergne-Rhône-Alpes;01;4;03;081;Champfromier;735;21;756
84;Auvergne-Rhône-Alpes;01;4;03;082;Chanay;628;14;642
84;Auvergne-Rhône-Alpes;01;2;22;083;Chaneins;927;17;944
84;Auvergne-Rhône-Alpes;01;2;23;084;Chanoz-Châtenay;895;18;913
84;Auvergne-Rhône-Alpes;01;2;08;085;La Chapelle-du-Châtelard;400;5;405
84;Auvergne-Rhône-Alpes;01;4;14;087;Charix;282;10;292
84;Auvergne-Rhône-Alpes;01;1;11;088;Charnoz-sur-Ain;903;27;930
84;Auvergne-Rhône-Alpes;01;1;01;089;Château-Gaillard;2253;50;2303
84;Auvergne-Rhône-Alpes;01;2;07;090;Châtenay;356;6;362
84;Auvergne-Rhône-Alpes;01;2;07;092;Châtillon-la-Palud;1604;58;1662
84;Auvergne-Rhône-Alpes;01;2;08;093;Châtillon-sur-Chalaronne;4931;203;5134
84;Auvergne-Rhône-Alpes;01;2;17;094;Chavannes-sur-Reyssouze;761;12;773
84;Auvergne-Rhône-Alpes;01;2;18;095;Nivigne et Suran;853;12;865
84;Auvergne-Rhône-Alpes;01;2;23;096;Chaveyriat;1034;30;1064
84;Auvergne-Rhône-Alpes;01;1;04;098;Chazey-Bons;1159;36;1195
84;Auvergne-Rhône-Alpes;01;1;11;099;Chazey-sur-Ain;1566;57;1623
84;Auvergne-Rhône-Alpes;01;1;04;100;Cheignieu-la-Balme;131;4;135
84;Auvergne-Rhône-Alpes;01;4;10;101;Chevillard;152;7;159
84;Auvergne-Rhône-Alpes;01;2;17;102;Chevroux;961;15;976
84;Auvergne-Rhône-Alpes;01;3;20;103;Chevry;2149;47;2196
84;Auvergne-Rhône-Alpes;01;3;20;104;Chézery-Forens;461;10;471
84;Auvergne-Rhône-Alpes;01;2;22;105;Civrieux;1829;53;1882
84;Auvergne-Rhône-Alpes;01;2;18;106;Cize;179;7;186
84;Auvergne-Rhône-Alpes;01;1;01;107;Cleyzieu;133;4;137
84;Auvergne-Rhône-Alpes;01;2;18;108;Coligny;1176;24;1200
84;Auvergne-Rhône-Alpes;01;3;20;109;Collonges;2226;46;2272
84;Auvergne-Rhône-Alpes;01;1;04;110;Colomieu;156;2;158
84;Auvergne-Rhône-Alpes;01;1;01;111;Conand;132;1;133
84;Auvergne-Rhône-Alpes;01;4;10;112;Condamine;450;12;462
84;Auvergne-Rhône-Alpes;01;2;08;113;Condeissiat;817;12;829
84;Auvergne-Rhône-Alpes;01;4;03;114;Confort;667;12;679
84;Auvergne-Rhône-Alpes;01;2;02;115;Confrançon;1333;30;1363
84;Auvergne-Rhône-Alpes;01;1;04;116;Contrevoz;498;12;510
84;Auvergne-Rhône-Alpes;01;1;04;117;Conzieu;151;2;153
84;Auvergne-Rhône-Alpes;01;1;10;118;Corbonod;1278;32;1310
84;Auvergne-Rhône-Alpes;01;1;10;121;Corlier;116;1;117
84;Auvergne-Rhône-Alpes;01;2;23;123;Cormoranche-sur-Saône;1162;35;1197
84;Auvergne-Rhône-Alpes;01;2;18;124;Cormoz;689;8;697
84;Auvergne-Rhône-Alpes;01;2;18;125;Corveissiat;612;13;625
84;Auvergne-Rhône-Alpes;01;2;18;127;Courmangoux;508;8;516
84;Auvergne-Rhône-Alpes;01;2;17;128;Courtes;305;1;306
84;Auvergne-Rhône-Alpes;01;2;07;129;Crans;291;6;297
84;Auvergne-Rhône-Alpes;01;2;02;130;Bresse Vallons;2363;44;2407
84;Auvergne-Rhône-Alpes;01;1;04;133;Cressin-Rochefort;394;6;400
84;Auvergne-Rhône-Alpes;01;2;23;134;Crottet;1758;45;1803
84;Auvergne-Rhône-Alpes;01;3;20;135;Crozet;2171;64;2235
84;Auvergne-Rhône-Alpes;01;2;23;136;Cruzilles-lès-Mépillat;893;20;913
84;Auvergne-Rhône-Alpes;01;1;10;138;Culoz;3004;64;3068
84;Auvergne-Rhône-Alpes;01;2;17;139;Curciat-Dongalon;444;5;449
84;Auvergne-Rhône-Alpes;01;2;02;140;Curtafond;767;19;786
84;Auvergne-Rhône-Alpes;01;1;04;141;Cuzieu;453;15;468
84;Auvergne-Rhône-Alpes;01;2;12;142;Dagneux;4777;57;4834
84;Auvergne-Rhône-Alpes;01;3;09;143;Divonne-les-Bains;9951;239;10190
84;Auvergne-Rhône-Alpes;01;2;07;145;Dompierre-sur-Veyle;1179;22;1201
84;Auvergne-Rhône-Alpes;01;2;08;146;Dompierre-sur-Chalaronne;436;3;439
84;Auvergne-Rhône-Alpes;01;2;18;147;Domsure;492;3;495
84;Auvergne-Rhône-Alpes;01;4;16;148;Dortan;1879;46;1925
84;Auvergne-Rhône-Alpes;01;1;01;149;Douvres;1076;28;1104
84;Auvergne-Rhône-Alpes;01;2;18;150;Drom;214;5;219
84;Auvergne-Rhône-Alpes;01;2;07;151;Druillat;1146;27;1173
84;Auvergne-Rhône-Alpes;01;4;14;152;Échallon;748;20;768
84;Auvergne-Rhône-Alpes;01;3;20;153;Échenevex;2115;74;2189
84;Auvergne-Rhône-Alpes;01;1;10;155;Évosges;143;4;147
84;Auvergne-Rhône-Alpes;01;1;12;156;Faramans;815;12;827
84;Auvergne-Rhône-Alpes;01;2;22;157;Fareins;2250;42;2292
84;Auvergne-Rhône-Alpes;01;3;20;158;Farges;1048;17;1065
84;Auvergne-Rhône-Alpes;01;2;17;159;Feillens;3365;71;3436
84;Auvergne-Rhône-Alpes;01;3;19;160;Ferney-Voltaire;10026;163;10189
84;Auvergne-Rhône-Alpes;01;1;04;162;Flaxieu;65;3;68
84;Auvergne-Rhône-Alpes;01;2;02;163;Foissiat;2038;35;2073
84;Auvergne-Rhône-Alpes;01;2;22;165;Francheleins;1594;33;1627
84;Auvergne-Rhône-Alpes;01;2;21;166;Frans;2423;61;2484
84;Auvergne-Rhône-Alpes;01;2;08;167;Garnerans;634;24;658
84;Auvergne-Rhône-Alpes;01;2;08;169;Genouilleux;641;22;663
84;Auvergne-Rhône-Alpes;01;4;14;170;Béard-Géovreissiat;1053;28;1081
84;Auvergne-Rhône-Alpes;01;4;14;171;Géovreisset;844;42;886
84;Auvergne-Rhône-Alpes;01;3;09;173;Gex;13121;270;13391
84;Auvergne-Rhône-Alpes;01;4;03;174;Giron;178;2;180
84;Auvergne-Rhône-Alpes;01;2;17;175;Gorrevod;784;23;807
84;Auvergne-Rhône-Alpes;01;2;18;177;Grand-Corent;183;6;189
84;Auvergne-Rhône-Alpes;01;2;23;179;Grièges;1881;52;1933
84;Auvergne-Rhône-Alpes;01;3;09;180;Grilly;839;21;860
84;Auvergne-Rhône-Alpes;01;4;14;181;Groissiat;1241;50;1291
84;Auvergne-Rhône-Alpes;01;2;08;183;Guéreins;1479;29;1508
84;Auvergne-Rhône-Alpes;01;2;18;184;Hautecourt-Romanèche;763;26;789
84;Auvergne-Rhône-Alpes;01;1;10;185;Plateau d'Hauteville;4844;176;5020
84;Auvergne-Rhône-Alpes;01;1;10;187;Haut Valromey;618;21;639
84;Auvergne-Rhône-Alpes;01;2;08;188;Illiat;663;20;683
84;Auvergne-Rhône-Alpes;01;4;03;189;Injoux-Génissiat;1115;26;1141
84;Auvergne-Rhône-Alpes;01;1;11;190;Innimond;87;3;90
84;Auvergne-Rhône-Alpes;01;4;10;191;Izenave;154;4;158
84;Auvergne-Rhône-Alpes;01;4;16;192;Izernore;2277;61;2338
84;Auvergne-Rhône-Alpes;01;1;04;193;Izieu;222;7;229
84;Auvergne-Rhône-Alpes;01;2;21;194;Jassans-Riottier;6346;93;6439
84;Auvergne-Rhône-Alpes;01;2;18;195;Jasseron;1783;54;1837
84;Auvergne-Rhône-Alpes;01;2;02;196;Jayat;1226;13;1239
84;Auvergne-Rhône-Alpes;01;2;07;197;Journans;351;13;364
84;Auvergne-Rhône-Alpes;01;1;12;198;Joyeux;268;3;271
84;Auvergne-Rhône-Alpes;01;4;16;199;Jujurieux;2137;46;2183
84;Auvergne-Rhône-Alpes;01;4;16;200;Labalme;214;5;219
84;Auvergne-Rhône-Alpes;01;1;11;202;Lagnieu;7161;147;7308
84;Auvergne-Rhône-Alpes;01;2;23;203;Laiz;1313;42;1355
84;Auvergne-Rhône-Alpes;01;4;14;204;Le Poizat-Lalleyriat;735;15;750
84;Auvergne-Rhône-Alpes;01;4;10;206;Lantenay;277;6;283
84;Auvergne-Rhône-Alpes;01;2;22;207;Lapeyrouse;317;12;329
84;Auvergne-Rhône-Alpes;01;1;04;208;Lavours;131;4;135
84;Auvergne-Rhône-Alpes;01;3;20;209;Léaz;778;16;794
84;Auvergne-Rhône-Alpes;01;3;20;210;Lélex;228;4;232
84;Auvergne-Rhône-Alpes;01;2;07;211;Lent;1395;35;1430
84;Auvergne-Rhône-Alpes;01;2;17;212;Lescheroux;718;9;727
84;Auvergne-Rhône-Alpes;01;1;11;213;Leyment;1341;29;1370
84;Auvergne-Rhône-Alpes;01;4;16;214;Leyssard;158;6;164
84;Auvergne-Rhône-Alpes;01;4;03;215;Surjoux-Lhopital;140;3;143
84;Auvergne-Rhône-Alpes;01;1;11;216;Lhuis;894;21;915
84;Auvergne-Rhône-Alpes;01;1;11;219;Lompnas;164;3;167
84;Auvergne-Rhône-Alpes;01;1;11;224;Loyettes;3225;31;3256
84;Auvergne-Rhône-Alpes;01;2;22;225;Lurcy;372;8;380
84;Auvergne-Rhône-Alpes;01;1;04;227;Magnieu;643;14;657
84;Auvergne-Rhône-Alpes;01;4;14;228;Maillat;660;14;674
84;Auvergne-Rhône-Alpes;01;2;02;229;Malafretaz;1235;24;1259
84;Auvergne-Rhône-Alpes;01;2;17;230;Mantenay-Montlin;312;7;319
84;Auvergne-Rhône-Alpes;01;2;17;231;Manziat;1948;48;1996
84;Auvergne-Rhône-Alpes;01;2;18;232;Marboz;2276;47;2323
84;Auvergne-Rhône-Alpes;01;1;11;233;Marchamp;130;3;133
84;Auvergne-Rhône-Alpes;01;1;04;234;Marignieu;169;3;172
84;Auvergne-Rhône-Alpes;01;2;08;235;Marlieux;1159;87;1246
84;Auvergne-Rhône-Alpes;01;2;02;236;Marsonnas;1011;29;1040
84;Auvergne-Rhône-Alpes;01;4;14;237;Martignat;1667;65;1732
84;Auvergne-Rhône-Alpes;01;2;21;238;Massieux;2670;56;2726
84;Auvergne-Rhône-Alpes;01;1;04;239;Massignieu-de-Rives;620;14;634
84;Auvergne-Rhône-Alpes;01;4;16;240;Matafelon-Granges;627;16;643
84;Auvergne-Rhône-Alpes;01;2;18;241;Meillonnas;1356;34;1390
84;Auvergne-Rhône-Alpes;01;4;16;242;Mérignat;135;2;137
84;Auvergne-Rhône-Alpes;01;2;22;243;Messimy-sur-Saône;1253;35;1288
84;Auvergne-Rhône-Alpes;01;1;12;244;Meximieux;7923;139;8062
84;Auvergne-Rhône-Alpes;01;2;18;245;Bohas-Meyriat-Rignat;943;21;964
84;Auvergne-Rhône-Alpes;01;2;23;246;Mézériat;2217;36;2253
84;Auvergne-Rhône-Alpes;01;3;20;247;Mijoux;312;14;326
84;Auvergne-Rhône-Alpes;01;2;22;248;Mionnay;2197;54;2251
84;Auvergne-Rhône-Alpes;01;2;13;249;Miribel;10122;151;10273
84;Auvergne-Rhône-Alpes;01;2;21;250;Misérieux;1974;252;2226
84;Auvergne-Rhône-Alpes;01;2;08;252;Mogneneins;786;22;808
84;Auvergne-Rhône-Alpes;01;2;07;254;Montagnat;2116;51;2167
84;Auvergne-Rhône-Alpes;01;1;11;255;Montagnieu;647;12;659
84;Auvergne-Rhône-Alpes;01;4;03;257;Montanges;351;10;361
84;Auvergne-Rhône-Alpes;01;2;08;258;Montceaux;1190;32;1222
84;Auvergne-Rhône-Alpes;01;2;02;259;Montcet;702;16;718
84;Auvergne-Rhône-Alpes;01;1;12;260;Le Montellier;302;5;307
84;Auvergne-Rhône-Alpes;01;2;22;261;Monthieux;668;23;691
84;Auvergne-Rhône-Alpes;01;2;12;262;Montluel;6886;83;6969
84;Auvergne-Rhône-Alpes;01;2;08;263;Montmerle-sur-Saône;3772;87;3859
84;Auvergne-Rhône-Alpes;01;2;02;264;Montracol;1016;20;1036
84;Auvergne-Rhône-Alpes;01;4;14;265;Montréal-la-Cluse;3456;71;3527
84;Auvergne-Rhône-Alpes;01;2;02;266;Montrevel-en-Bresse;2576;42;2618
84;Auvergne-Rhône-Alpes;01;4;16;267;Nurieux-Volognat;1025;23;1048
84;Auvergne-Rhône-Alpes;01;1;04;268;Murs-et-Gélignieux;246;3;249
84;Auvergne-Rhône-Alpes;01;4;14;269;Nantua;3454;135;3589
84;Auvergne-Rhône-Alpes;01;2;08;272;Neuville-les-Dames;1500;20;1520
84;Auvergne-Rhône-Alpes;01;4;16;273;Neuville-sur-Ain;1800;27;1827
84;Auvergne-Rhône-Alpes;01;4;14;274;Les Neyrolles;645;15;660
84;Auvergne-Rhône-Alpes;01;2;13;275;Neyron;2569;50;2619
84;Auvergne-Rhône-Alpes;01;2;13;276;Niévroz;1624;27;1651
84;Auvergne-Rhône-Alpes;01;1;01;277;Nivollet-Montgriffon;117;2;119
84;Auvergne-Rhône-Alpes;01;1;01;279;Oncieu;80;6;86
84;Auvergne-Rhône-Alpes;01;1;11;280;Ordonnaz;138;1;139
84;Auvergne-Rhône-Alpes;01;3;19;281;Ornex;4483;170;4653
84;Auvergne-Rhône-Alpes;01;4;10;282;Outriaz;258;6;264
84;Auvergne-Rhône-Alpes;01;4;15;283;Oyonnax;22456;479;22935
84;Auvergne-Rhône-Alpes;01;2;17;284;Ozan;694;13;707
84;Auvergne-Rhône-Alpes;01;2;21;285;Parcieux;1229;30;1259
84;Auvergne-Rhône-Alpes;01;1;04;286;Parves et Nattages;951;38;989
84;Auvergne-Rhône-Alpes;01;3;20;288;Péron;2717;55;2772
84;Auvergne-Rhône-Alpes;01;2;06;289;Péronnas;6520;291;6811
84;Auvergne-Rhône-Alpes;01;1;12;290;Pérouges;1273;32;1305
84;Auvergne-Rhône-Alpes;01;2;23;291;Perrex;842;7;849
84;Auvergne-Rhône-Alpes;01;4;16;293;Peyriat;148;4;152
84;Auvergne-Rhône-Alpes;01;1;04;294;Peyrieu;886;16;902
84;Auvergne-Rhône-Alpes;01;2;08;295;Peyzieux-sur-Saône;686;13;699
84;Auvergne-Rhône-Alpes;01;2;18;296;Pirajoux;420;8;428
84;Auvergne-Rhône-Alpes;01;2;12;297;Pizay;867;15;882
84;Auvergne-Rhône-Alpes;01;4;03;298;Plagne;150;2;152
84;Auvergne-Rhône-Alpes;01;2;07;299;Le Plantay;584;8;592
84;Auvergne-Rhône-Alpes;01;2;02;301;Polliat;2547;61;2608
84;Auvergne-Rhône-Alpes;01;1;04;302;Pollieu;163;5;168
84;Auvergne-Rhône-Alpes;01;4;16;303;Poncin;1699;36;1735
84;Auvergne-Rhône-Alpes;01;4;16;304;Pont-d'Ain;2924;53;2977
84;Auvergne-Rhône-Alpes;01;2;17;305;Pont-de-Vaux;2213;43;2256
84;Auvergne-Rhône-Alpes;01;2;23;306;Pont-de-Veyle;1641;64;1705
84;Auvergne-Rhône-Alpes;01;4;14;307;Port;836;21;857
84;Auvergne-Rhône-Alpes;01;3;20;308;Pougny;807;14;821
84;Auvergne-Rhône-Alpes;01;2;18;309;Pouillat;85;0;85
84;Auvergne-Rhône-Alpes;01;1;04;310;Prémeyzel;251;4;255
84;Auvergne-Rhône-Alpes;01;1;10;311;Prémillieu;44;0;44
84;Auvergne-Rhône-Alpes;01;3;19;313;Prévessin-Moëns;8711;239;8950
84;Auvergne-Rhône-Alpes;01;4;16;314;Priay;1729;33;1762
84;Auvergne-Rhône-Alpes;01;2;18;317;Ramasse;330;6;336
84;Auvergne-Rhône-Alpes;01;2;22;318;Rancé;726;17;743
84;Auvergne-Rhône-Alpes;01;2;22;319;Relevant;466;9;475
84;Auvergne-Rhône-Alpes;01;2;17;320;Replonges;3791;91;3882
84;Auvergne-Rhône-Alpes;01;2;07;321;Revonnas;888;29;917
84;Auvergne-Rhône-Alpes;01;2;21;322;Reyrieux;4984;140;5124
84;Auvergne-Rhône-Alpes;01;2;17;323;Reyssouze;989;14;1003
84;Auvergne-Rhône-Alpes;01;1;12;325;Rignieux-le-Franc;1032;18;1050
84;Auvergne-Rhône-Alpes;01;2;08;328;Romans;597;4;601
84;Auvergne-Rhône-Alpes;01;1;04;329;Rossillon;153;6;159
84;Auvergne-Rhône-Alpes;01;1;10;330;Ruffieu;182;6;188
84;Auvergne-Rhône-Alpes;01;4;16;331;Saint-Alban;187;0;187
84;Auvergne-Rhône-Alpes;01;2;17;332;Saint-André-de-Bâgé;779;23;802
84;Auvergne-Rhône-Alpes;01;2;22;333;Saint-André-de-Corcy;3369;59;3428
84;Auvergne-Rhône-Alpes;01;2;23;334;Saint-André-d'Huiriat;658;9;667
84;Auvergne-Rhône-Alpes;01;2;08;335;Saint-André-le-Bouchoux;402;6;408
84;Auvergne-Rhône-Alpes;01;2;07;336;Saint-André-sur-Vieux-Jonc;1174;22;1196
84;Auvergne-Rhône-Alpes;01;2;17;337;Saint-Bénigne;1311;27;1338
84;Auvergne-Rhône-Alpes;01;1;04;338;Groslée-Saint-Benoit;1227;37;1264
84;Auvergne-Rhône-Alpes;01;2;21;339;Saint-Bernard;1463;43;1506
84;Auvergne-Rhône-Alpes;01;2;12;342;Sainte-Croix;554;11;565
84;Auvergne-Rhône-Alpes;01;2;23;343;Saint-Cyr-sur-Menthon;1793;41;1834
84;Auvergne-Rhône-Alpes;01;2;06;344;Saint-Denis-lès-Bourg;5943;166;6109
84;Auvergne-Rhône-Alpes;01;1;01;345;Saint-Denis-en-Bugey;2266;34;2300
84;Auvergne-Rhône-Alpes;01;2;02;346;Saint-Didier-d'Aussiat;858;19;877
84;Auvergne-Rhône-Alpes;01;2;21;347;Saint-Didier-de-Formans;2035;63;2098
84;Auvergne-Rhône-Alpes;01;2;08;348;Saint-Didier-sur-Chalaronne;2938;65;3003
84;Auvergne-Rhône-Alpes;01;1;12;349;Saint-Éloi;503;5;508
84;Auvergne-Rhône-Alpes;01;2;18;350;Saint-Étienne-du-Bois;2542;40;2582
84;Auvergne-Rhône-Alpes;01;2;08;351;Saint-Étienne-sur-Chalaronne;1571;26;1597
84;Auvergne-Rhône-Alpes;01;2;17;352;Saint-Étienne-sur-Reyssouze;583;6;589
84;Auvergne-Rhône-Alpes;01;2;21;353;Sainte-Euphémie;1700;28;1728
84;Auvergne-Rhône-Alpes;01;3;19;354;Saint-Genis-Pouilly;13943;200;14143
84;Auvergne-Rhône-Alpes;01;2;23;355;Saint-Genis-sur-Menthon;486;7;493
84;Auvergne-Rhône-Alpes;01;2;08;356;Saint-Georges-sur-Renon;208;5;213
84;Auvergne-Rhône-Alpes;01;4;03;357;Saint-Germain-de-Joux;502;7;509
84;Auvergne-Rhône-Alpes;01;1;04;358;Saint-Germain-les-Paroisses;429;3;432
84;Auvergne-Rhône-Alpes;01;2;08;359;Saint-Germain-sur-Renon;246;3;249
84;Auvergne-Rhône-Alpes;01;3;20;360;Saint-Jean-de-Gonville;1895;48;1943
84;Auvergne-Rhône-Alpes;01;1;11;361;Saint-Jean-de-Niost;1577;48;1625
84;Auvergne-Rhône-Alpes;01;2;22;362;Saint-Jean-de-Thurigneux;786;15;801
84;Auvergne-Rhône-Alpes;01;4;16;363;Saint-Jean-le-Vieux;1772;70;1842
84;Auvergne-Rhône-Alpes;01;2;17;364;Saint-Jean-sur-Reyssouze;756;7;763
84;Auvergne-Rhône-Alpes;01;2;23;365;Saint-Jean-sur-Veyle;1162;20;1182
84;Auvergne-Rhône-Alpes;01;1;11;366;Sainte-Julie;1082;18;1100
84;Auvergne-Rhône-Alpes;01;2;17;367;Saint-Julien-sur-Reyssouze;746;4;750
84;Auvergne-Rhône-Alpes;01;2;23;368;Saint-Julien-sur-Veyle;838;15;853
84;Auvergne-Rhône-Alpes;01;2;07;369;Saint-Just;942;25;967
84;Auvergne-Rhône-Alpes;01;2;23;370;Saint-Laurent-sur-Saône;1688;28;1716
84;Auvergne-Rhône-Alpes;01;2;22;371;Saint-Marcel;1242;29;1271
84;Auvergne-Rhône-Alpes;01;1;04;372;Saint-Martin-de-Bavel;444;5;449
84;Auvergne-Rhône-Alpes;01;4;14;373;Saint-Martin-du-Frêne;1023;30;1053
84;Auvergne-Rhône-Alpes;01;2;07;374;Saint-Martin-du-Mont;1871;45;1916
84;Auvergne-Rhône-Alpes;01;2;02;375;Saint-Martin-le-Châtel;782;20;802
84;Auvergne-Rhône-Alpes;01;2;13;376;Saint-Maurice-de-Beynost;3962;39;4001
84;Auvergne-Rhône-Alpes;01;1;11;378;Saint-Maurice-de-Gourdans;2645;54;2699
84;Auvergne-Rhône-Alpes;01;1;01;379;Saint-Maurice-de-Rémens;760;11;771
84;Auvergne-Rhône-Alpes;01;2;17;380;Saint-Nizier-le-Bouchoux;632;13;645
84;Auvergne-Rhône-Alpes;01;2;07;381;Saint-Nizier-le-Désert;921;18;939
84;Auvergne-Rhône-Alpes;01;2;22;382;Sainte-Olive;279;2;281
84;Auvergne-Rhône-Alpes;01;2;08;383;Saint-Paul-de-Varax;1562;21;1583
84;Auvergne-Rhône-Alpes;01;1;01;384;Saint-Rambert-en-Bugey;2188;33;2221
84;Auvergne-Rhône-Alpes;01;2;06;385;Saint-Rémy;985;23;1008
84;Auvergne-Rhône-Alpes;01;1;11;386;Saint-Sorlin-en-Bugey;1127;66;1193
84;Auvergne-Rhône-Alpes;01;2;02;387;Saint-Sulpice;256;3;259
84;Auvergne-Rhône-Alpes;01;2;17;388;Saint-Trivier-de-Courtes;1102;9;1111
84;Auvergne-Rhône-Alpes;01;2;22;389;Saint-Trivier-sur-Moignans;1834;43;1877
84;Auvergne-Rhône-Alpes;01;1;11;390;Saint-Vulbas;1246;21;1267
84;Auvergne-Rhône-Alpes;01;2;18;391;Salavre;271;8;279
84;Auvergne-Rhône-Alpes;01;4;16;392;Samognat;656;27;683
84;Auvergne-Rhône-Alpes;01;2;08;393;Sandrans;544;5;549
84;Auvergne-Rhône-Alpes;01;1;11;396;Sault-Brénaz;977;13;990
84;Auvergne-Rhône-Alpes;01;3;09;397;Sauverny;978;19;997
84;Auvergne-Rhône-Alpes;01;2;22;398;Savigneux;1421;17;1438
84;Auvergne-Rhône-Alpes;01;3;20;399;Ségny;2107;51;2158
84;Auvergne-Rhône-Alpes;01;1;11;400;Seillonnaz;139;3;142
84;Auvergne-Rhône-Alpes;01;3;20;401;Sergy;2167;71;2238
84;Auvergne-Rhône-Alpes;01;2;17;402;Sermoyer;652;20;672
84;Auvergne-Rhône-Alpes;01;1;11;403;Serrières-de-Briord;1295;41;1336
84;Auvergne-Rhône-Alpes;01;4;16;404;Serrières-sur-Ain;135;2;137
84;Auvergne-Rhône-Alpes;01;2;07;405;Servas;1280;29;1309
84;Auvergne-Rhône-Alpes;01;2;17;406;Servignat;174;1;175
84;Auvergne-Rhône-Alpes;01;1;10;407;Seyssel;1002;18;1020
84;Auvergne-Rhône-Alpes;01;2;18;408;Simandre-sur-Suran;661;12;673
84;Auvergne-Rhône-Alpes;01;4;16;410;Sonthonnax-la-Montagne;300;7;307
84;Auvergne-Rhône-Alpes;01;1;11;411;Souclin;273;6;279
84;Auvergne-Rhône-Alpes;01;2;08;412;Sulignat;595;12;607
84;Auvergne-Rhône-Alpes;01;1;10;415;Talissieu;499;6;505
84;Auvergne-Rhône-Alpes;01;1;10;416;Tenay;1014;11;1025
84;Auvergne-Rhône-Alpes;01;2;13;418;Thil;1087;27;1114
84;Auvergne-Rhône-Alpes;01;3;20;419;Thoiry;6021;176;6197
84;Auvergne-Rhône-Alpes;01;2;08;420;Thoissey;1690;8;1698
84;Auvergne-Rhône-Alpes;01;1;01;421;Torcieu;729;16;745
84;Auvergne-Rhône-Alpes;01;2;07;422;Tossiat;1355;36;1391
84;Auvergne-Rhône-Alpes;01;2;21;423;Toussieux;1124;21;1145
84;Auvergne-Rhône-Alpes;01;2;13;424;Tramoyes;1776;43;1819
84;Auvergne-Rhône-Alpes;01;2;07;425;La Tranclière;288;7;295
84;Auvergne-Rhône-Alpes;01;2;18;426;Val-Revermont;2538;59;2597
84;Auvergne-Rhône-Alpes;01;2;21;427;Trévoux;6920;164;7084
84;Auvergne-Rhône-Alpes;01;2;08;428;Valeins;126;1;127
84;Auvergne-Rhône-Alpes;01;2;02;429;Vandeins;707;13;720
84;Auvergne-Rhône-Alpes;01;4;16;430;Varambon;619;12;631
84;Auvergne-Rhône-Alpes;01;1;01;431;Vaux-en-Bugey;1227;30;1257
84;Auvergne-Rhône-Alpes;01;2;18;432;Verjon;323;2;325
84;Auvergne-Rhône-Alpes;01;2;17;433;Vernoux;313;4;317
84;Auvergne-Rhône-Alpes;01;2;07;434;Versailleux;472;10;482
84;Auvergne-Rhône-Alpes;01;3;09;435;Versonnex;2157;69;2226
84;Auvergne-Rhône-Alpes;01;3;09;436;Vesancy;481;11;492
84;Auvergne-Rhône-Alpes;01;2;17;437;Vescours;223;5;228
84;Auvergne-Rhône-Alpes;01;2;17;439;Vésines;99;4;103
84;Auvergne-Rhône-Alpes;01;4;10;441;Vieu-d'Izenave;734;18;752
84;Auvergne-Rhône-Alpes;01;2;22;443;Villars-les-Dombes;4978;95;5073
84;Auvergne-Rhône-Alpes;01;1;11;444;Villebois;1196;17;1213
84;Auvergne-Rhône-Alpes;01;2;18;445;Villemotier;615;21;636
84;Auvergne-Rhône-Alpes;01;2;22;446;Villeneuve;1548;37;1585
84;Auvergne-Rhône-Alpes;01;2;18;447;Villereversure;1342;32;1374
84;Auvergne-Rhône-Alpes;01;4;03;448;Villes;389;8;397
84;Auvergne-Rhône-Alpes;01;2;07;449;Villette-sur-Ain;759;14;773
84;Auvergne-Rhône-Alpes;01;1;11;450;Villieu-Loyes-Mollon;3717;67;3784
84;Auvergne-Rhône-Alpes;01;2;05;451;Viriat;6595;150;6745
84;Auvergne-Rhône-Alpes;01;1;04;452;Virieu-le-Grand;1132;24;1156
84;Auvergne-Rhône-Alpes;01;1;10;453;Arvière-en-Valromey;710;23;733
84;Auvergne-Rhône-Alpes;01;1;04;454;Virignin;1112;21;1133
84;Auvergne-Rhône-Alpes;01;1;04;456;Vongnes;71;2;73
84;Auvergne-Rhône-Alpes;01;2;23;457;Vonnas;3181;59;3240
32;Hauts-de-France;02;2;03;001;Abbécourt;502;11;513
32;Hauts-de-France;02;2;18;002;Achery;610;8;618
32;Hauts-de-France;02;4;17;003;Acy;1021;24;1045
32;Hauts-de-France;02;2;11;004;Agnicourt-et-Séchelles;182;5;187
32;Hauts-de-France;02;2;06;005;Aguilcourt;380;8;388
32;Hauts-de-France;02;5;07;006;Aisonville-et-Bernoville;262;9;271
32;Hauts-de-France;02;2;06;007;Aizelles;122;1;123
32;Hauts-de-France;02;4;05;008;Aizy-Jouy;294;4;298
32;Hauts-de-France;02;3;12;009;Alaincourt;534;6;540
32;Hauts-de-France;02;4;05;010;Allemant;173;4;177
32;Hauts-de-France;02;4;20;011;Ambleny;1138;54;1192
32;Hauts-de-France;02;4;21;012;Ambrief;71;0;71
32;Hauts-de-France;02;2;06;013;Amifontaine;386;9;395
32;Hauts-de-France;02;2;03;014;Amigny-Rouy;729;23;752
32;Hauts-de-France;02;4;21;015;Ancienville;72;1;73
32;Hauts-de-France;02;2;18;016;Andelain;216;9;225
32;Hauts-de-France;02;2;18;017;Anguilcourt-le-Sart;323;4;327
32;Hauts-de-France;02;2;09;018;Anizy-le-Grand;2574;53;2627
32;Hauts-de-France;02;3;12;019;Annois;362;5;367
32;Hauts-de-France;02;5;08;020;Any-Martin-Rieux;455;8;463
32;Hauts-de-France;02;5;19;021;Archon;84;3;87
32;Hauts-de-France;02;4;21;022;Arcy-Sainte-Restitue;403;6;409
32;Hauts-de-France;02;1;21;023;Armentières-sur-Ourcq;102;3;105
32;Hauts-de-France;02;2;10;024;Arrancy;51;0;51
32;Hauts-de-France;02;3;12;025;Artemps;367;2;369
32;Hauts-de-France;02;2;11;027;Assis-sur-Serre;214;7;221
32;Hauts-de-France;02;2;10;028;Athies-sous-Laon;2606;60;2666
32;Hauts-de-France;02;3;13;029;Attilly;354;12;366
32;Hauts-de-France;02;3;01;030;Aubencheul-aux-Bois;257;4;261
32;Hauts-de-France;02;5;08;031;Aubenton;661;6;667
32;Hauts-de-France;02;3;12;032;Aubigny-aux-Kaisnes;253;4;257
32;Hauts-de-France;02;2;06;033;Aubigny-en-Laonnois;104;2;106
32;Hauts-de-France;02;4;20;034;Audignicourt;121;4;125
32;Hauts-de-France;02;5;07;035;Audigny;280;9;289
32;Hauts-de-France;02;4;05;036;Augy;72;1;73
32;Hauts-de-France;02;2;09;037;Aulnois-sous-Laon;1386;30;1416
32;Hauts-de-France;02;5;19;038;Les Autels;59;0;59
32;Hauts-de-France;02;2;11;039;Autremencourt;173;3;176
32;Hauts-de-France;02;5;19;040;Autreppes;180;3;183
32;Hauts-de-France;02;2;03;041;Autreville;807;15;822
32;Hauts-de-France;02;1;04;042;Azy-sur-Marne;384;2;386
32;Hauts-de-France;02;4;16;043;Bagneux;65;1;66
32;Hauts-de-France;02;5;19;044;Bancigny;25;0;25
32;Hauts-de-France;02;2;11;046;Barenton-Bugny;557;9;566
32;Hauts-de-France;02;2;11;047;Barenton-Cel;108;5;113
32;Hauts-de-France;02;2;11;048;Barenton-sur-Serre;133;4;137
32;Hauts-de-France;02;2;20;049;Barisis-aux-Bois;739;13;752
32;Hauts-de-France;02;5;07;050;Barzy-en-Thiérache;323;2;325
32;Hauts-de-France;02;1;04;051;Barzy-sur-Marne;391;6;397
32;Hauts-de-France;02;2;09;052;Bassoles-Aulers;135;6;141
32;Hauts-de-France;02;1;04;053;Vallées en Champagne;571;6;577
32;Hauts-de-France;02;4;05;054;Bazoches-sur-Vesles;461;4;465
32;Hauts-de-France;02;5;08;055;Beaumé;88;2;90
32;Hauts-de-France;02;2;03;056;Beaumont-en-Beine;179;1;180
32;Hauts-de-France;02;3;01;057;Beaurevoir;1406;18;1424
32;Hauts-de-France;02;2;06;058;Beaurieux;856;10;866
32;Hauts-de-France;02;2;18;059;Beautor;2714;28;2742
32;Hauts-de-France;02;3;13;060;Beauvois-en-Vermandois;257;7;264
32;Hauts-de-France;02;3;01;061;Becquigny;246;7;253
32;Hauts-de-France;02;1;02;062;Belleau;137;4;141
32;Hauts-de-France;02;3;01;063;Bellenglise;378;8;386
32;Hauts-de-France;02;4;17;064;Belleu;3832;53;3885
32;Hauts-de-France;02;3;01;065;Bellicourt;600;13;613
32;Hauts-de-France;02;3;12;066;Benay;196;2;198
32;Hauts-de-France;02;5;07;067;Bergues-sur-Sambre;210;5;215
32;Hauts-de-France;02;5;11;068;Berlancourt;88;4;92
32;Hauts-de-France;02;5;19;069;Berlise;105;2;107
32;Hauts-de-France;02;5;07;070;Bernot;445;12;457
32;Hauts-de-France;02;4;20;071;Berny-Rivière;658;15;673
32;Hauts-de-France;02;2;06;072;Berrieux;186;2;188
32;Hauts-de-France;02;2;06;073;Berry-au-Bac;670;4;674
32;Hauts-de-France;02;2;18;074;Bertaucourt-Epourdon;593;10;603
32;Hauts-de-France;02;3;12;075;Berthenicourt;195;2;197
32;Hauts-de-France;02;2;06;076;Bertricourt;152;3;155
32;Hauts-de-France;02;4;17;077;Berzy-le-Sec;379;9;388
32;Hauts-de-France;02;2;20;078;Besmé;163;3;166
32;Hauts-de-France;02;5;08;079;Besmont;149;0;149
32;Hauts-de-France;02;2;09;080;Besny-et-Loizy;333;9;342
32;Hauts-de-France;02;2;03;081;Béthancourt-en-Vaux;434;8;442
32;Hauts-de-France;02;4;21;082;Beugneux;110;0;110
32;Hauts-de-France;02;1;05;083;Beuvardes;750;15;765
32;Hauts-de-France;02;1;04;084;Bézu-le-Guéry;257;5;262
32;Hauts-de-France;02;1;02;085;Bézu-Saint-Germain;1015;25;1040
32;Hauts-de-France;02;2;20;086;Bichancourt;1006;11;1017
32;Hauts-de-France;02;4;20;087;Bieuxy;34;1;35
32;Hauts-de-France;02;2;10;088;Bièvres;92;3;95
32;Hauts-de-France;02;4;17;089;Billy-sur-Aisne;1148;21;1169
32;Hauts-de-France;02;4;21;090;Billy-sur-Ourcq;207;10;217
32;Hauts-de-France;02;4;05;091;Blanzy-lès-Fismes;95;1;96
32;Hauts-de-France;02;2;20;093;Blérancourt;1298;59;1357
32;Hauts-de-France;02;1;02;094;Blesmes;464;9;473
32;Hauts-de-France;02;3;01;095;Bohain-en-Vermandois;5686;78;5764
32;Hauts-de-France;02;2;11;096;Bois-lès-Pargny;197;3;200
32;Hauts-de-France;02;2;06;097;Boncourt;256;2;258
32;Hauts-de-France;02;1;04;098;Bonneil;379;14;393
32;Hauts-de-France;02;1;21;099;Bonnesvalyn;221;5;226
32;Hauts-de-France;02;3;01;100;Bony;138;0;138
32;Hauts-de-France;02;2;11;101;Bosmont-sur-Serre;192;5;197
32;Hauts-de-France;02;2;06;102;Bouconville-Vauclair;191;6;197
32;Hauts-de-France;02;5;07;103;Boué;1339;16;1355
32;Hauts-de-France;02;2;06;104;Bouffignereux;99;4;103
32;Hauts-de-France;02;1;02;105;Bouresches;196;2;198
32;Hauts-de-France;02;2;06;106;Bourg-et-Comin;810;12;822
32;Hauts-de-France;02;2;20;107;Bourguignon-sous-Coucy;107;4;111
32;Hauts-de-France;02;2;09;108;Bourguignon-sous-Montbavin;159;4;163
32;Hauts-de-France;02;5;19;109;La Bouteille;475;10;485
32;Hauts-de-France;02;4;05;110;Braine;2235;25;2260
32;Hauts-de-France;02;2;09;111;Brancourt-en-Laonnois;721;11;732
32;Hauts-de-France;02;3;01;112;Brancourt-le-Grand;553;13;566
32;Hauts-de-France;02;1;02;114;Brasles;1563;37;1600
32;Hauts-de-France;02;2;06;115;Braye-en-Laonnois;190;6;196
32;Hauts-de-France;02;5;19;116;Braye-en-Thiérache;147;1;148
32;Hauts-de-France;02;3;12;117;Bray-Saint-Christophe;68;0;68
32;Hauts-de-France;02;4;05;118;Braye;129;2;131
32;Hauts-de-France;02;1;02;119;Brécy;327;6;333
32;Hauts-de-France;02;4;05;120;Brenelle;196;6;202
32;Hauts-de-France;02;4;21;121;Breny;240;4;244
32;Hauts-de-France;02;2;18;122;Brie;54;1;55
32;Hauts-de-France;02;3;12;123;Brissay-Choigny;301;5;306
32;Hauts-de-France;02;3;12;124;Brissy-Hamégicourt;651;10;661
32;Hauts-de-France;02;1;21;125;Brumetz;193;11;204
32;Hauts-de-France;02;5;19;126;Brunehamel;455;5;460
32;Hauts-de-France;02;1;05;127;Bruyères-sur-Fère;192;5;197
32;Hauts-de-France;02;2;10;128;Bruyères-et-Montbérault;1475;47;1522
32;Hauts-de-France;02;4;05;129;Bruys;18;0;18
32;Hauts-de-France;02;5;08;130;Bucilly;194;7;201
32;Hauts-de-France;02;4;05;131;Bucy-le-Long;1861;42;1903
32;Hauts-de-France;02;2;09;132;Bucy-lès-Cerny;194;3;197
32;Hauts-de-France;02;2;06;133;Bucy-lès-Pierrepont;404;9;413
32;Hauts-de-France;02;5;08;134;Buire;862;18;880
32;Hauts-de-France;02;5;19;135;Buironfosse;1157;17;1174
32;Hauts-de-France;02;5;19;136;Burelles;128;3;131
32;Hauts-de-France;02;1;21;137;Bussiares;160;0;160
32;Hauts-de-France;02;4;21;138;Buzancy;200;3;203
32;Hauts-de-France;02;2;03;139;Caillouël-Crépigny;442;5;447
32;Hauts-de-France;02;2;20;140;Camelin;456;7;463
32;Hauts-de-France;02;5;19;141;La Capelle;1778;79;1857
32;Hauts-de-France;02;3;15;142;Castres;253;5;258
32;Hauts-de-France;02;3;01;143;Le Catelet;185;6;191
32;Hauts-de-France;02;3;13;144;Caulaincourt;144;3;147
32;Hauts-de-France;02;2;03;145;Caumont;545;10;555
32;Hauts-de-France;02;1;04;146;Celles-lès-Condé;94;1;95
32;Hauts-de-France;02;4;05;148;Celles-sur-Aisne;255;2;257
32;Hauts-de-France;02;3;12;149;Cerizy;62;2;64
32;Hauts-de-France;02;2;10;150;Cerny-en-Laonnois;63;0;63
32;Hauts-de-France;02;2;09;151;Cerny-lès-Bucy;116;3;119
32;Hauts-de-France;02;4;05;152;Cerseuil;89;0;89
32;Hauts-de-France;02;2;09;153;Cessières-Suzy;764;20;784
32;Hauts-de-France;02;4;21;154;Chacrise;365;7;372
32;Hauts-de-France;02;2;09;155;Chaillevois;166;5;171
32;Hauts-de-France;02;2;11;156;Chalandry;257;1;258
32;Hauts-de-France;02;2;09;157;Chambry;836;23;859
32;Hauts-de-France;02;2;10;158;Chamouille;273;2;275
32;Hauts-de-France;02;2;20;159;Champs;295;2;297
32;Hauts-de-France;02;5;19;160;Chaourse;544;12;556
32;Hauts-de-France;02;1;04;162;La Chapelle-sur-Chézy;291;8;299
32;Hauts-de-France;02;1;04;163;Charly-sur-Marne;2585;42;2627
32;Hauts-de-France;02;1;05;164;Le Charmel;325;7;332
32;Hauts-de-France;02;2;18;165;Charmes;1654;26;1680
32;Hauts-de-France;02;1;04;166;Chartèves;356;9;365
32;Hauts-de-France;02;4;05;167;Chassemy;890;14;904
32;Hauts-de-France;02;1;02;168;Château-Thierry;15254;362;15616
32;Hauts-de-France;02;2;11;169;Châtillon-lès-Sons;84;0;84
32;Hauts-de-France;02;3;12;170;Châtillon-sur-Oise;125;0;125
32;Hauts-de-France;02;2;06;171;Chaudardes;88;1;89
32;Hauts-de-France;02;4;21;172;Chaudun;252;9;261
32;Hauts-de-France;02;2;03;173;Chauny;11653;419;12072
32;Hauts-de-France;02;4;05;174;Chavignon;829;16;845
32;Hauts-de-France;02;4;16;175;Chavigny;161;4;165
32;Hauts-de-France;02;4;05;176;Chavonne;206;3;209
32;Hauts-de-France;02;2;10;177;Chérêt;139;2;141
32;Hauts-de-France;02;2;06;178;Chermizy-Ailles;106;2;108
32;Hauts-de-France;02;4;05;179;Chéry-Chartreuve;385;8;393
32;Hauts-de-France;02;2;11;180;Chéry-lès-Pouilly;721;14;735
32;Hauts-de-France;02;5;19;181;Chéry-lès-Rozoy;79;1;80
32;Hauts-de-France;02;5;11;182;Chevennes;117;3;120
32;Hauts-de-France;02;2;06;183;Chevregny;185;1;186
32;Hauts-de-France;02;3;12;184;Chevresis-Monceau;351;5;356
32;Hauts-de-France;02;1;21;185;Chézy-en-Orxois;390;15;405
32;Hauts-de-France;02;1;04;186;Chézy-sur-Marne;1351;45;1396
32;Hauts-de-France;02;1;02;187;Chierry;1134;15;1149
32;Hauts-de-France;02;5;07;188;Chigny;147;4;151
32;Hauts-de-France;02;2;06;189;Chivres-en-Laonnois;350;8;358
32;Hauts-de-France;02;4;05;190;Chivres-Val;518;12;530
32;Hauts-de-France;02;2;10;191;Chivy-lès-Étouvelles;523;5;528
32;Hauts-de-France;02;4;21;192;Chouy;371;7;378
32;Hauts-de-France;02;1;05;193;Cierges;65;1;66
32;Hauts-de-France;02;2;11;194;Cilly;186;8;194
32;Hauts-de-France;02;4;05;195;Ciry-Salsogne;910;25;935
32;Hauts-de-France;02;2;09;196;Clacy-et-Thierret;311;7;318
32;Hauts-de-France;02;5;19;197;Clairfontaine;535;102;637
32;Hauts-de-France;02;4;05;198;Clamecy;228;2;230
32;Hauts-de-France;02;3;12;199;Clastres;601;8;609
32;Hauts-de-France;02;5;19;200;Clermont-les-Fermes;106;1;107
32;Hauts-de-France;02;4;20;201;Cœuvres-et-Valsery;441;6;447
32;Hauts-de-France;02;1;02;203;Coincy;1282;20;1302
32;Hauts-de-France;02;5;08;204;Coingt;65;2;67
32;Hauts-de-France;02;2;10;205;Colligis-Crandelain;229;3;232
32;Hauts-de-France;02;5;11;206;Colonfay;76;3;79
32;Hauts-de-France;02;2;03;207;Commenchon;216;3;219
32;Hauts-de-France;02;2;06;208;Concevreux;267;6;273
32;Hauts-de-France;02;1;04;209;Condé-en-Brie;708;11;719
32;Hauts-de-France;02;4;05;210;Condé-sur-Aisne;364;6;370
32;Hauts-de-France;02;2;06;211;Condé-sur-Suippe;294;3;297
32;Hauts-de-France;02;2;03;212;Condren;708;11;719
32;Hauts-de-France;02;1;04;213;Connigis;343;2;345
32;Hauts-de-France;02;3;15;214;Contescourt;61;1;62
32;Hauts-de-France;02;2;06;215;Corbeny;841;6;847
32;Hauts-de-France;02;4;21;216;Corcy;294;4;298
32;Hauts-de-France;02;2;20;217;Coucy-le-Château-Auffrique;992;9;1001
32;Hauts-de-France;02;2;06;218;Coucy-lès-Eppes;628;12;640
32;Hauts-de-France;02;2;20;219;Coucy-la-Ville;200;72;272
32;Hauts-de-France;02;1;05;220;Coulonges-Cohan;436;15;451
32;Hauts-de-France;02;1;04;221;Coupru;152;4;156
32;Hauts-de-France;02;2;18;222;Courbes;32;0;32
32;Hauts-de-France;02;1;04;223;Courboin;301;12;313
32;Hauts-de-France;02;4;05;224;Courcelles-sur-Vesle;346;4;350
32;Hauts-de-France;02;1;21;225;Courchamps;84;2;86
32;Hauts-de-France;02;4;17;226;Courmelles;1863;30;1893
32;Hauts-de-France;02;1;05;227;Courmont;120;1;121
32;Hauts-de-France;02;1;04;228;Courtemont-Varennes;339;6;345
32;Hauts-de-France;02;2;06;229;Courtrizy-et-Fussigny;71;0;71
32;Hauts-de-France;02;4;05;230;Couvrelles;186;6;192
32;Hauts-de-France;02;2;11;231;Couvron-et-Aumencourt;941;9;950
32;Hauts-de-France;02;4;21;232;Coyolles;362;10;372
32;Hauts-de-France;02;4;21;233;Cramaille;145;8;153
32;Hauts-de-France;02;2;06;234;Craonne;83;1;84
32;Hauts-de-France;02;2;06;235;Craonnelle;115;3;118
32;Hauts-de-France;02;2;20;236;Crécy-au-Mont;330;3;333
32;Hauts-de-France;02;2;11;237;Crécy-sur-Serre;1502;16;1518
32;Hauts-de-France;02;2;09;238;Crépy;1816;31;1847
32;Hauts-de-France;02;1;04;239;Crézancy;1244;85;1329
32;Hauts-de-France;02;3;01;240;Croix-Fonsomme;218;3;221
32;Hauts-de-France;02;1;21;241;La Croix-sur-Ourcq;96;3;99
32;Hauts-de-France;02;1;04;242;Crouttes-sur-Marne;641;11;652
32;Hauts-de-France;02;4;16;243;Crouy;2923;47;2970
32;Hauts-de-France;02;5;07;244;Crupilly;63;3;66
32;Hauts-de-France;02;4;16;245;Cuffies;1805;35;1840
32;Hauts-de-France;02;3;12;246;Cugny;611;4;615
32;Hauts-de-France;02;2;11;248;Cuirieux;156;3;159
32;Hauts-de-France;02;4;21;249;Cuiry-Housse;100;0;100
32;Hauts-de-France;02;2;06;250;Cuiry-lès-Chaudardes;73;4;77
32;Hauts-de-France;02;5;19;251;Cuiry-lès-Iviers;27;1;28
32;Hauts-de-France;02;2;06;252;Cuissy-et-Geny;71;2;73
32;Hauts-de-France;02;4;16;253;Cuisy-en-Almont;358;3;361
32;Hauts-de-France;02;4;20;254;Cutry;129;5;134
32;Hauts-de-France;02;4;05;255;Cys-la-Commune;153;2;155
32;Hauts-de-France;02;5;19;256;Dagny-Lambercy;129;3;132
32;Hauts-de-France;02;3;12;257;Dallon;437;13;450
32;Hauts-de-France;02;4;21;258;Dammard;370;13;383
32;Hauts-de-France;02;4;21;259;Dampleux;392;15;407
32;Hauts-de-France;02;2;18;260;Danizy;650;11;661
32;Hauts-de-France;02;2;11;261;Dercy;391;9;400
32;Hauts-de-France;02;2;18;262;Deuillet;211;3;214
32;Hauts-de-France;02;4;05;263;Dhuizel;112;0;112
32;Hauts-de-France;02;5;19;264;Dizy-le-Gros;730;16;746
32;Hauts-de-France;02;5;19;265;Dohis;99;2;101
32;Hauts-de-France;02;5;19;266;Dolignon;46;2;48
32;Hauts-de-France;02;4;20;267;Dommiers;292;10;302
32;Hauts-de-France;02;1;04;268;Domptin;647;13;660
32;Hauts-de-France;02;5;07;269;Dorengt;155;6;161
32;Hauts-de-France;02;3;13;270;Douchy;164;3;167
32;Hauts-de-France;02;1;05;271;Dravegny;130;2;132
32;Hauts-de-France;02;4;21;272;Droizy;78;2;80
32;Hauts-de-France;02;3;12;273;Dury;207;0;207
32;Hauts-de-France;02;2;06;274;Ébouleau;195;6;201
32;Hauts-de-France;02;5;08;275;Effry;319;6;325
32;Hauts-de-France;02;5;19;276;Englancourt;117;5;122
32;Hauts-de-France;02;4;20;277;Épagny;342;7;349
32;Hauts-de-France;02;5;08;278;Éparcy;28;5;33
32;Hauts-de-France;02;1;02;279;Épaux-Bézu;553;25;578
32;Hauts-de-France;02;1;02;280;Épieds;409;12;421
32;Hauts-de-France;02;1;04;281;L'Épine-aux-Bois;256;11;267
32;Hauts-de-France;02;2;10;282;Eppes;427;8;435
32;Hauts-de-France;02;2;11;283;Erlon;287;8;295
32;Hauts-de-France;02;5;19;284;Erloy;102;1;103
32;Hauts-de-France;02;5;07;286;Esquéhéries;867;11;878
32;Hauts-de-France;02;3;12;287;Essigny-le-Grand;1048;27;1075
32;Hauts-de-France;02;3;14;288;Essigny-le-Petit;347;8;355
32;Hauts-de-France;02;1;04;289;Essises;411;11;422
32;Hauts-de-France;02;1;04;290;Essômes-sur-Marne;2745;73;2818
32;Hauts-de-France;02;3;01;291;Estrées;410;8;418
32;Hauts-de-France;02;1;02;292;Étampes-sur-Marne;1305;28;1333
32;Hauts-de-France;02;3;01;293;Étaves-et-Bocquiaux;553;10;563
32;Hauts-de-France;02;2;10;294;Étouvelles;207;8;215
32;Hauts-de-France;02;5;19;295;Étréaupont;853;7;860
32;Hauts-de-France;02;3;13;296;Étreillers;1197;21;1218
32;Hauts-de-France;02;1;02;297;Étrépilly;121;2;123
32;Hauts-de-France;02;5;07;298;Étreux;1420;9;1429
32;Hauts-de-France;02;2;06;299;Évergnicourt;546;6;552
32;Hauts-de-France;02;4;21;302;Faverolles;321;12;333
32;Hauts-de-France;02;3;13;303;Fayet;680;16;696
32;Hauts-de-France;02;2;18;304;La Fère;2838;135;2973
32;Hauts-de-France;02;1;05;305;Fère-en-Tardenois;3001;55;3056
32;Hauts-de-France;02;3;12;306;La Ferté-Chevresis;510;9;519
32;Hauts-de-France;02;4;21;307;La Ferté-Milon;2060;159;2219
32;Hauts-de-France;02;5;07;308;Fesmy-le-Sart;476;8;484
32;Hauts-de-France;02;2;10;309;Festieux;671;5;676
32;Hauts-de-France;02;3;14;310;Fieulaine;248;7;255
32;Hauts-de-France;02;4;05;311;Filain;120;2;122
32;Hauts-de-France;02;5;19;312;La Flamengrie;1100;10;1110
32;Hauts-de-France;02;5;07;313;Flavigny-le-Grand-et-Beaurain;444;5;449
32;Hauts-de-France;02;3;12;315;Flavy-le-Martel;1669;34;1703
32;Hauts-de-France;02;4;21;316;Fleury;128;5;133
32;Hauts-de-France;02;3;13;317;Fluquières;218;4;222
32;Hauts-de-France;02;2;20;318;Folembray;1381;18;1399
32;Hauts-de-France;02;3;14;319;Fonsomme;490;8;498
32;Hauts-de-France;02;3;12;320;Fontaine-lès-Clercs;237;4;241
32;Hauts-de-France;02;5;19;321;Fontaine-lès-Vervins;901;189;1090
32;Hauts-de-France;02;3;14;322;Fontaine-Notre-Dame;386;3;389
32;Hauts-de-France;02;3;01;323;Fontaine-Uterte;134;3;137
32;Hauts-de-France;02;5;19;324;Fontenelle;281;3;284
32;Hauts-de-France;02;4;20;326;Fontenoy;470;8;478
32;Hauts-de-France;02;3;13;327;Foreste;163;1;164
32;Hauts-de-France;02;1;02;328;Fossoy;513;6;519
32;Hauts-de-France;02;2;18;329;Fourdrain;425;9;434
32;Hauts-de-France;02;3;13;330;Francilly-Selency;530;7;537
32;Hauts-de-France;02;5;11;331;Franqueville;110;3;113
32;Hauts-de-France;02;1;05;332;Fresnes-en-Tardenois;265;4;269
32;Hauts-de-France;02;2;20;333;Fresnes-sous-Coucy;164;0;164
32;Hauts-de-France;02;3;01;334;Fresnoy-le-Grand;2958;70;3028
32;Hauts-de-France;02;2;18;335;Fressancourt;183;8;191
32;Hauts-de-France;02;2;03;336;Frières-Faillouël;983;15;998
32;Hauts-de-France;02;5;19;337;Froidestrées;168;4;172
32;Hauts-de-France;02;2;11;338;Froidmont-Cohartille;252;10;262
32;Hauts-de-France;02;1;21;339;Gandelu;690;9;699
32;Hauts-de-France;02;3;15;340;Gauchy;5235;74;5309
32;Hauts-de-France;02;5;19;341;Gercy;268;1;269
32;Hauts-de-France;02;5;19;342;Gergny;134;2;136
32;Hauts-de-France;02;3;13;343;Germaine;81;0;81
32;Hauts-de-France;02;3;12;345;Gibercourt;41;1;42
32;Hauts-de-France;02;2;06;346;Gizy;664;12;676
32;Hauts-de-France;02;1;02;347;Gland;444;6;450
32;Hauts-de-France;02;2;06;349;Goudelancourt-lès-Berrieux;56;0;56
32;Hauts-de-France;02;2;06;350;Goudelancourt-lès-Pierrepont;136;2;138
32;Hauts-de-France;02;1;05;351;Goussancourt;113;6;119
32;Hauts-de-France;02;3;01;352;Gouy;560;10;570
32;Hauts-de-France;02;2;11;353;Grandlup-et-Fay;287;10;297
32;Hauts-de-France;02;5;19;354;Grandrieux;80;2;82
32;Hauts-de-France;02;3;13;355;Gricourt;953;26;979
32;Hauts-de-France;02;1;02;356;Grisolles;240;2;242
32;Hauts-de-France;02;5;19;357;Gronard;71;2;73
32;Hauts-de-France;02;5;07;358;Grougis;333;3;336
32;Hauts-de-France;02;3;15;359;Grugies;1301;20;1321
32;Hauts-de-France;02;2;06;360;Villeneuve-sur-Aisne;2751;39;2790
32;Hauts-de-France;02;5;07;361;Guise;4645;78;4723
32;Hauts-de-France;02;2;03;362;Guivry;238;12;250
32;Hauts-de-France;02;2;20;363;Guny;390;3;393
32;Hauts-de-France;02;2;06;364;Guyencourt;258;5;263
32;Hauts-de-France;02;5;07;366;Hannapes;324;7;331
32;Hauts-de-France;02;3;12;367;Happencourt;130;4;134
32;Hauts-de-France;02;4;21;368;Haramont;574;7;581
32;Hauts-de-France;02;5;19;369;Harcigny;242;2;244
32;Hauts-de-France;02;3;01;370;Hargicourt;610;5;615
32;Hauts-de-France;02;3;15;371;Harly;1578;35;1613
32;Hauts-de-France;02;4;21;372;Hartennes-et-Taux;347;10;357
32;Hauts-de-France;02;5;19;373;Hary;197;5;202
32;Hauts-de-France;02;3;01;374;Lehaucourt;861;9;870
32;Hauts-de-France;02;1;21;375;Hautevesnes;159;3;162
32;Hauts-de-France;02;5;07;376;Hauteville;174;5;179
32;Hauts-de-France;02;5;19;377;Haution;135;8;143
32;Hauts-de-France;02;5;08;378;La Hérie;129;5;134
32;Hauts-de-France;02;5;11;379;Le Hérie-la-Viéville;209;123;332
32;Hauts-de-France;02;3;12;380;Hinacourt;24;1;25
32;Hauts-de-France;02;5;08;381;Hirson;8710;187;8897
32;Hauts-de-France;02;3;13;382;Holnon;1367;39;1406
32;Hauts-de-France;02;3;15;383;Homblières;1452;46;1498
32;Hauts-de-France;02;5;19;384;Houry;56;2;58
32;Hauts-de-France;02;5;11;385;Housset;160;3;163
32;Hauts-de-France;02;5;07;386;Iron;225;2;227
32;Hauts-de-France;02;3;12;387;Itancourt;1015;35;1050
32;Hauts-de-France;02;5;08;388;Iviers;225;6;231
32;Hauts-de-France;02;1;04;389;Jaulgonne;659;16;675
32;Hauts-de-France;02;3;13;390;Jeancourt;264;2;266
32;Hauts-de-France;02;5;08;391;Jeantes;206;0;206
32;Hauts-de-France;02;3;01;392;Joncourt;311;6;317
32;Hauts-de-France;02;4;05;393;Jouaignes;141;5;146
32;Hauts-de-France;02;2;20;395;Jumencourt;141;6;147
32;Hauts-de-France;02;2;06;396;Jumigny;64;1;65
32;Hauts-de-France;02;3;12;397;Jussy;1252;20;1272
32;Hauts-de-France;02;4;16;398;Juvigny;284;4;288
32;Hauts-de-France;02;2;06;399;Juvincourt-et-Damary;607;5;612
32;Hauts-de-France;02;4;05;400;Laffaux;148;4;152
32;Hauts-de-France;02;5;19;401;Laigny;194;2;196
32;Hauts-de-France;02;3;13;402;Lanchy;37;2;39
32;Hauts-de-France;02;5;11;403;Landifay-et-Bertaignemont;260;7;267
32;Hauts-de-France;02;5;19;404;Landouzy-la-Cour;190;0;190
32;Hauts-de-France;02;5;08;405;Landouzy-la-Ville;535;5;540
32;Hauts-de-France;02;2;20;406;Landricourt;132;5;137
32;Hauts-de-France;02;2;09;407;Laniscourt;199;9;208
32;Hauts-de-France;02;2;97;408;Laon;24304;666;24970
32;Hauts-de-France;02;2;06;409;Lappion;268;4;272
32;Hauts-de-France;02;4;21;410;Largny-sur-Automne;244;10;254
32;Hauts-de-France;02;1;21;411;Latilly;203;4;207
32;Hauts-de-France;02;4;21;412;Launoy;100;1;101
32;Hauts-de-France;02;2;10;413;Laval-en-Laonnois;244;4;248
32;Hauts-de-France;02;5;07;414;Lavaqueresse;201;5;206
32;Hauts-de-France;02;4;20;415;Laversine;160;4;164
32;Hauts-de-France;02;5;11;416;Lemé;420;10;430
32;Hauts-de-France;02;3;01;417;Lempire;116;0;116
32;Hauts-de-France;02;5;19;418;Lerzy;223;4;227
32;Hauts-de-France;02;5;07;419;Leschelle;269;9;278
32;Hauts-de-France;02;3;14;420;Lesdins;829;11;840
32;Hauts-de-France;02;4;05;421;Lesges;106;1;107
32;Hauts-de-France;02;5;07;422;Lesquielles-Saint-Germain;805;10;815
32;Hauts-de-France;02;2;20;423;Leuilly-sous-Coucy;422;8;430
32;Hauts-de-France;02;4;16;424;Leury;104;0;104
32;Hauts-de-France;02;5;08;425;Leuze;172;3;175
32;Hauts-de-France;02;3;01;426;Levergies;540;10;550
32;Hauts-de-France;02;4;05;427;Lhuys;138;1;139
32;Hauts-de-France;02;1;21;428;Licy-Clignon;74;2;76
32;Hauts-de-France;02;2;10;429;Lierval;122;1;123
32;Hauts-de-France;02;2;06;430;Liesse-Notre-Dame;1281;119;1400
32;Hauts-de-France;02;2;18;431;Liez;383;9;392
32;Hauts-de-France;02;4;05;432;Limé;189;5;194
32;Hauts-de-France;02;5;19;433;Lislet;221;8;229
32;Hauts-de-France;02;5;08;435;Logny-lès-Aubenton;79;0;79
32;Hauts-de-France;02;4;21;438;Longpont;249;9;258
32;Hauts-de-France;02;4;05;439;Les Septvallons;1177;20;1197
32;Hauts-de-France;02;2;06;440;Lor;138;0;138
32;Hauts-de-France;02;4;21;441;Louâtre;188;3;191
32;Hauts-de-France;02;1;05;442;Loupeigne;90;1;91
32;Hauts-de-France;02;1;04;443;Lucy-le-Bocage;203;6;209
32;Hauts-de-France;02;5;11;444;Lugny;121;0;121
32;Hauts-de-France;02;5;19;445;Luzoir;282;6;288
32;Hauts-de-France;02;3;12;446;Ly-Fontaine;118;1;119
32;Hauts-de-France;02;4;21;447;Maast-et-Violaine;147;5;152
32;Hauts-de-France;02;2;06;448;Mâchecourt;121;4;125
32;Hauts-de-France;02;4;21;449;Macogny;66;3;69
32;Hauts-de-France;02;5;07;450;Macquigny;366;4;370
32;Hauts-de-France;02;3;01;451;Magny-la-Fosse;124;1;125
32;Hauts-de-France;02;3;13;452;Maissemy;236;10;246
32;Hauts-de-France;02;2;06;453;Maizy;404;8;412
32;Hauts-de-France;02;2;06;454;La Malmaison;404;3;407
32;Hauts-de-France;02;5;07;455;Malzy;204;1;205
32;Hauts-de-France;02;2;20;456;Manicamp;299;4;303
32;Hauts-de-France;02;2;06;457;Marchais;404;10;414
32;Hauts-de-France;02;1;04;458;Dhuys et Morin-en-Brie;820;17;837
32;Hauts-de-France;02;3;14;459;Marcy;161;8;169
32;Hauts-de-France;02;2;11;460;Marcy-sous-Marle;201;1;202
32;Hauts-de-France;02;2;03;461;Marest-Dampcourt;383;6;389
32;Hauts-de-France;02;1;05;462;Mareuil-en-Dôle;231;2;233
32;Hauts-de-France;02;5;11;463;Marfontaine;89;2;91
32;Hauts-de-France;02;4;05;464;Margival;365;2;367
32;Hauts-de-France;02;1;04;465;Marigny-en-Orxois;513;7;520
32;Hauts-de-France;02;4;21;466;Marizy-Sainte-Geneviève;133;0;133
32;Hauts-de-France;02;4;21;467;Marizy-Saint-Mard;51;1;52
32;Hauts-de-France;02;2;11;468;Marle;2235;29;2264
32;Hauts-de-France;02;5;07;469;Marly-Gomont;485;13;498
32;Hauts-de-France;02;5;08;470;Martigny;435;12;447
32;Hauts-de-France;02;2;10;471;Martigny-Courpierre;135;2;137
32;Hauts-de-France;02;2;06;472;Mauregny-en-Haye;409;7;416
32;Hauts-de-France;02;2;18;473;Mayot;215;1;216
32;Hauts-de-France;02;2;18;474;Mennessis;392;4;396
32;Hauts-de-France;02;5;07;476;Mennevret;669;14;683
32;Hauts-de-France;02;4;17;477;Mercin-et-Vaux;964;21;985
32;Hauts-de-France;02;2;09;478;Merlieux-et-Fouquerolles;261;8;269
32;Hauts-de-France;02;2;11;480;Mesbrecourt-Richecourt;312;3;315
32;Hauts-de-France;02;3;15;481;Mesnil-Saint-Laurent;473;16;489
32;Hauts-de-France;02;2;06;482;Meurival;54;1;55
32;Hauts-de-France;02;3;12;483;Mézières-sur-Oise;513;10;523
32;Hauts-de-France;02;1;04;484;Mézy-Moulins;527;3;530
32;Hauts-de-France;02;4;17;485;Missy-aux-Bois;94;4;98
32;Hauts-de-France;02;2;06;486;Missy-lès-Pierrepont;107;1;108
32;Hauts-de-France;02;4;05;487;Missy-sur-Aisne;627;9;636
32;Hauts-de-France;02;5;07;488;Molain;156;2;158
32;Hauts-de-France;02;2;09;489;Molinchart;342;7;349
32;Hauts-de-France;02;4;05;490;Monampteuil;126;3;129
32;Hauts-de-France;02;5;11;491;Monceau-le-Neuf-et-Faucouzy;324;9;333
32;Hauts-de-France;02;2;18;492;Monceau-lès-Leups;454;8;462
32;Hauts-de-France;02;2;11;493;Monceau-le-Waast;224;6;230
32;Hauts-de-France;02;5;07;494;Monceau-sur-Oise;127;2;129
32;Hauts-de-France;02;5;08;495;Mondrepuis;1046;15;1061
32;Hauts-de-France;02;4;21;496;Monnes;100;1;101
32;Hauts-de-France;02;2;09;497;Mons-en-Laonnois;1154;29;1183
32;Hauts-de-France;02;2;06;498;Montaigu;763;13;776
32;Hauts-de-France;02;2;09;499;Montbavin;43;2;45
32;Hauts-de-France;02;3;01;500;Montbrehain;810;19;829
32;Hauts-de-France;02;2;10;501;Montchâlons;93;2;95
32;Hauts-de-France;02;5;19;502;Montcornet;1324;9;1333
32;Hauts-de-France;02;3;12;503;Mont-d'Origny;831;2;833
32;Hauts-de-France;02;3;12;504;Montescourt-Lizerolles;1616;28;1644
32;Hauts-de-France;02;1;04;505;Montfaucon;206;5;211
32;Hauts-de-France;02;4;21;506;Montgobert;195;6;201
32;Hauts-de-France;02;4;21;507;Montgru-Saint-Hilaire;31;1;32
32;Hauts-de-France;02;2;10;508;Monthenault;151;6;157
32;Hauts-de-France;02;1;21;509;Monthiers;156;0;156
32;Hauts-de-France;02;1;04;510;Monthurel;151;2;153
32;Hauts-de-France;02;3;01;511;Montigny-en-Arrouaise;295;4;299
32;Hauts-de-France;02;1;21;512;Montigny-l'Allier;270;5;275
32;Hauts-de-France;02;2;11;513;Montigny-le-Franc;138;2;140
32;Hauts-de-France;02;4;20;514;Montigny-Lengrain;704;15;719
32;Hauts-de-France;02;1;04;515;Montigny-lès-Condé;55;6;61
32;Hauts-de-France;02;2;11;516;Montigny-sous-Marle;67;1;68
32;Hauts-de-France;02;2;11;517;Montigny-sur-Crécy;299;5;304
32;Hauts-de-France;02;1;04;518;Montlevon;303;3;306
32;Hauts-de-France;02;5;19;519;Montloué;186;4;190
32;Hauts-de-France;02;4;05;520;Mont-Notre-Dame;741;7;748
32;Hauts-de-France;02;1;04;521;Montreuil-aux-Lions;1364;14;1378
32;Hauts-de-France;02;5;08;522;Mont-Saint-Jean;74;2;76
32;Hauts-de-France;02;4;05;523;Mont-Saint-Martin;72;1;73
32;Hauts-de-France;02;1;02;524;Mont-Saint-Père;694;15;709
32;Hauts-de-France;02;3;14;525;Morcourt;577;13;590
32;Hauts-de-France;02;5;19;526;Morgny-en-Thiérache;99;3;102
32;Hauts-de-France;02;4;20;527;Morsain;458;9;467
32;Hauts-de-France;02;4;20;528;Mortefontaine;228;5;233
32;Hauts-de-France;02;2;11;529;Mortiers;178;1;179
32;Hauts-de-France;02;2;06;530;Moulins;78;1;79
32;Hauts-de-France;02;2;06;531;Moussy-Verneuil;118;1;119
32;Hauts-de-France;02;3;12;532;Moÿ-de-l'Aisne;986;18;1004
32;Hauts-de-France;02;4;21;533;Muret-et-Crouttes;111;8;119
32;Hauts-de-France;02;2;06;534;Muscourt;48;1;49
32;Hauts-de-France;02;5;19;535;Nampcelles-la-Cour;113;5;118
32;Hauts-de-France;02;4;21;536;Nampteuil-sous-Muret;103;1;104
32;Hauts-de-France;02;4;05;537;Nanteuil-la-Fosse;202;1;203
32;Hauts-de-France;02;1;05;538;Nanteuil-Notre-Dame;70;0;70
32;Hauts-de-France;02;3;01;539;Nauroy;702;8;710
32;Hauts-de-France;02;1;02;540;Nesles-la-Montagne;1227;36;1263
32;Hauts-de-France;02;2;06;541;Neufchâtel-sur-Aisne;421;6;427
32;Hauts-de-France;02;2;03;542;Neuflieux;82;2;84
32;Hauts-de-France;02;1;21;543;Neuilly-Saint-Front;2066;34;2100
32;Hauts-de-France;02;5;08;544;Neuve-Maison;616;14;630
32;Hauts-de-France;02;2;11;545;La Neuville-Bosmont;187;2;189
32;Hauts-de-France;02;2;03;546;La Neuville-en-Beine;193;4;197
32;Hauts-de-France;02;5;11;547;La Neuville-Housset;66;1;67
32;Hauts-de-France;02;5;07;548;La Neuville-lès-Dorengt;377;7;384
32;Hauts-de-France;02;3;15;549;Neuville-Saint-Amand;846;25;871
32;Hauts-de-France;02;2;06;550;Neuville-sur-Ailette;115;3;118
32;Hauts-de-France;02;4;05;551;Neuville-sur-Margival;115;0;115
32;Hauts-de-France;02;3;12;552;Neuvillette;187;9;196
32;Hauts-de-France;02;2;06;553;Nizy-le-Comte;244;4;248
32;Hauts-de-France;02;1;04;554;Nogentel;1071;22;1093
32;Hauts-de-France;02;1;04;555;Nogent-l'Artaud;2108;46;2154
32;Hauts-de-France;02;5;19;556;Noircourt;81;1;82
32;Hauts-de-France;02;4;21;557;Noroy-sur-Ourcq;127;0;127
32;Hauts-de-France;02;5;07;558;Le Nouvion-en-Thiérache;2557;28;2585
32;Hauts-de-France;02;2;11;559;Nouvion-et-Catillon;462;4;466
32;Hauts-de-France;02;2;11;560;Nouvion-le-Comte;246;4;250
32;Hauts-de-France;02;2;10;561;Nouvion-le-Vineux;153;4;157
32;Hauts-de-France;02;4;20;562;Nouvron-Vingré;212;2;214
32;Hauts-de-France;02;5;07;563;Noyales;164;3;167
32;Hauts-de-France;02;4;17;564;Noyant-et-Aconin;495;5;500
32;Hauts-de-France;02;2;06;565;Œuilly;291;3;294
32;Hauts-de-France;02;2;03;566;Ognes;1104;23;1127
32;Hauts-de-France;02;5;08;567;Ohis;279;8;287
32;Hauts-de-France;02;4;21;568;Oigny-en-Valois;162;4;166
32;Hauts-de-France;02;5;07;569;Oisy;471;3;474
32;Hauts-de-France;02;3;12;570;Ollezy;177;0;177
32;Hauts-de-France;02;3;14;571;Omissy;717;75;792
32;Hauts-de-France;02;2;06;572;Orainville;502;9;511
32;Hauts-de-France;02;2;10;573;Orgeval;60;1;61
32;Hauts-de-France;02;5;08;574;Origny-en-Thiérache;1432;28;1460
32;Hauts-de-France;02;3;12;575;Origny-Sainte-Benoite;1670;14;1684
32;Hauts-de-France;02;4;16;576;Osly-Courtil;330;8;338
32;Hauts-de-France;02;4;05;577;Ostel;90;1;91
32;Hauts-de-France;02;2;06;578;Oulches-la-Vallée-Foulon;86;1;87
32;Hauts-de-France;02;4;21;579;Oulchy-la-Ville;125;9;134
32;Hauts-de-France;02;4;21;580;Oulchy-le-Château;816;10;826
32;Hauts-de-France;02;4;05;581;Paars;323;1;324
32;Hauts-de-France;02;2;06;582;Paissy;76;2;78
32;Hauts-de-France;02;2;06;583;Pancy-Courtecon;54;2;56
32;Hauts-de-France;02;5;19;584;Papleux;121;6;127
32;Hauts-de-France;02;4;21;585;Parcy-et-Tigny;259;7;266
32;Hauts-de-France;02;5;19;586;Parfondeval;139;6;145
32;Hauts-de-France;02;2;10;587;Parfondru;355;7;362
32;Hauts-de-France;02;2;06;588;Pargnan;68;2;70
32;Hauts-de-France;02;4;05;589;Pargny-Filain;261;0;261
32;Hauts-de-France;02;1;04;590;Pargny-la-Dhuys;169;4;173
32;Hauts-de-France;02;2;11;591;Pargny-les-Bois;135;1;136
32;Hauts-de-France;02;3;12;592;Parpeville;192;4;196
32;Hauts-de-France;02;4;16;593;Pasly;1064;21;1085
32;Hauts-de-France;02;4;21;594;Passy-en-Valois;132;6;138
32;Hauts-de-France;02;1;04;595;Passy-sur-Marne;133;0;133
32;Hauts-de-France;02;1;04;596;Pavant;763;15;778
32;Hauts-de-France;02;4;20;598;Pernant;669;18;687
32;Hauts-de-France;02;2;03;599;Pierremande;255;3;258
32;Hauts-de-France;02;2;11;600;Pierrepont;347;5;352
32;Hauts-de-France;02;2;06;601;Pignicourt;197;2;199
32;Hauts-de-France;02;2;09;602;Pinon;1698;27;1725
32;Hauts-de-France;02;3;12;604;Pithon;84;1;85
32;Hauts-de-France;02;3;12;605;Pleine-Selve;192;5;197
32;Hauts-de-France;02;4;21;606;Le Plessier-Huleu;70;3;73
32;Hauts-de-France;02;4;17;607;Ploisy;78;3;81
32;Hauts-de-France;02;5;19;608;Plomion;473;2;475
32;Hauts-de-France;02;2;06;609;Ployart-et-Vaurseine;20;0;20
32;Hauts-de-France;02;4;16;610;Pommiers;736;11;747
32;Hauts-de-France;02;4;05;612;Pont-Arcy;127;1;128
32;Hauts-de-France;02;2;06;613;Pontavert;605;11;616
32;Hauts-de-France;02;3;13;614;Pontru;265;7;272
32;Hauts-de-France;02;3;13;615;Pontruet;360;5;365
32;Hauts-de-France;02;2;20;616;Pont-Saint-Mard;211;3;214
32;Hauts-de-France;02;2;11;617;Pouilly-sur-Serre;508;4;512
32;Hauts-de-France;02;3;01;618;Prémont;694;12;706
32;Hauts-de-France;02;2;09;619;Prémontré;658;0;658
32;Hauts-de-France;02;4;05;620;Presles-et-Boves;347;9;356
32;Hauts-de-France;02;2;10;621;Presles-et-Thierny;379;15;394
32;Hauts-de-France;02;1;21;622;Priez;54;0;54
32;Hauts-de-France;02;5;19;623;Prisces;97;3;100
32;Hauts-de-France;02;5;07;624;Proisy;275;66;341
32;Hauts-de-France;02;5;07;625;Proix;142;2;144
32;Hauts-de-France;02;2;06;626;Prouvais;334;7;341
32;Hauts-de-France;02;2;06;627;Proviseux-et-Plesnoy;123;3;126
32;Hauts-de-France;02;4;21;628;Puiseux-en-Retz;217;6;223
32;Hauts-de-France;02;5;11;629;Puisieux-et-Clanlieu;311;12;323
32;Hauts-de-France;02;2;20;631;Quierzy;411;5;416
32;Hauts-de-France;02;2;20;632;Quincy-Basse;57;1;58
32;Hauts-de-France;02;4;05;633;Quincy-sous-le-Mont;60;0;60
32;Hauts-de-France;02;5;19;634;Raillimont;82;4;86
32;Hauts-de-France;02;3;01;635;Ramicourt;146;5;151
32;Hauts-de-France;02;3;12;636;Regny;199;5;204
32;Hauts-de-France;02;3;14;637;Remaucourt;293;10;303
32;Hauts-de-France;02;2;11;638;Remies;237;1;238
32;Hauts-de-France;02;3;12;639;Remigny;346;7;353
32;Hauts-de-France;02;3;12;640;Renansart;157;4;161
32;Hauts-de-France;02;5;19;641;Renneval;111;4;115
32;Hauts-de-France;02;5;19;642;Résigny;173;3;176
32;Hauts-de-France;02;4;20;643;Ressons-le-Long;769;8;777
32;Hauts-de-France;02;4;21;644;Retheuil;346;13;359
32;Hauts-de-France;02;1;04;645;Reuilly-Sauvigny;192;9;201
32;Hauts-de-France;02;5;07;647;Ribeauville;60;0;60
32;Hauts-de-France;02;3;12;648;Ribemont;1937;38;1975
32;Hauts-de-France;02;1;02;649;Rocourt-Saint-Martin;307;4;311
32;Hauts-de-France;02;5;19;650;Rocquigny;357;6;363
32;Hauts-de-France;02;2;18;651;Rogécourt;106;1;107
32;Hauts-de-France;02;5;11;652;Rogny;104;1;105
32;Hauts-de-France;02;1;04;653;Romeny-sur-Marne;500;13;513
32;Hauts-de-France;02;5;07;654;Romery;82;1;83
32;Hauts-de-France;02;1;05;655;Ronchères;135;0;135
32;Hauts-de-France;02;2;06;656;Roucy;394;10;404
32;Hauts-de-France;02;5;11;657;Rougeries;250;4;254
32;Hauts-de-France;02;3;13;658;Roupy;236;8;244
32;Hauts-de-France;02;3;14;659;Rouvroy;504;13;517
32;Hauts-de-France;02;5;19;660;Rouvroy-sur-Serre;38;2;40
32;Hauts-de-France;02;2;09;661;Royaucourt-et-Chailvet;254;3;257
32;Hauts-de-France;02;1;21;662;Rozet-Saint-Albin;322;9;331
32;Hauts-de-France;02;4;21;663;Rozières-sur-Crise;221;5;226
32;Hauts-de-France;02;1;04;664;Rozoy-Bellevalle;123;3;126
32;Hauts-de-France;02;4;21;665;Grand-Rozoy;300;5;305
32;Hauts-de-France;02;5;19;666;Rozoy-sur-Serre;1002;17;1019
32;Hauts-de-France;02;4;20;667;Saconin-et-Breuil;203;6;209
32;Hauts-de-France;02;5;11;668;Sains-Richaumont;1057;21;1078
32;Hauts-de-France;02;5;19;670;Saint-Algis;151;0;151
32;Hauts-de-France;02;2;20;671;Saint-Aubin;287;5;292
32;Hauts-de-France;02;4;20;672;Saint-Bandry;261;4;265
32;Hauts-de-France;02;4;20;673;Saint-Christophe-à-Berry;444;7;451
32;Hauts-de-France;02;5;08;674;Saint-Clément;48;0;48
32;Hauts-de-France;02;2;06;675;Sainte-Croix;133;1;134
32;Hauts-de-France;02;2;06;676;Saint-Erme-Outre-et-Ramecourt;1716;40;1756
32;Hauts-de-France;02;1;04;677;Saint-Eugène;240;3;243
32;Hauts-de-France;02;5;19;678;Sainte-Geneviève;68;0;68
32;Hauts-de-France;02;1;21;679;Saint-Gengoulph;150;4;154
32;Hauts-de-France;02;2;18;680;Saint-Gobain;2294;37;2331
32;Hauts-de-France;02;5;11;681;Saint-Gobert;279;5;284
32;Hauts-de-France;02;4;05;682;Saint-Mard;114;3;117
32;Hauts-de-France;02;5;07;683;Saint-Martin-Rivière;110;3;113
32;Hauts-de-France;02;5;08;684;Saint-Michel;3314;57;3371
32;Hauts-de-France;02;2;18;685;Saint-Nicolas-aux-Bois;120;1;121
32;Hauts-de-France;02;2;20;686;Saint-Paul-aux-Bois;373;4;377
32;Hauts-de-France;02;4;20;687;Saint-Pierre-Aigle;333;9;342
32;Hauts-de-France;02;5;11;688;Saint-Pierre-lès-Franqueville;48;4;52
32;Hauts-de-France;02;2;11;689;Saint-Pierremont;41;1;42
32;Hauts-de-France;02;2;06;690;Sainte-Preuve;80;1;81
32;Hauts-de-France;02;3;98;691;Saint-Quentin;53570;1281;54851
32;Hauts-de-France;02;4;21;693;Saint-Rémy-Blanzy;221;3;224
32;Hauts-de-France;02;3;12;694;Saint-Simon;641;10;651
32;Hauts-de-France;02;4;05;695;Saint-Thibaut;81;0;81
32;Hauts-de-France;02;2;06;696;Saint-Thomas;76;3;79
32;Hauts-de-France;02;2;10;697;Samoussy;384;5;389
32;Hauts-de-France;02;4;05;698;Sancy-les-Cheminots;101;2;103
32;Hauts-de-France;02;1;05;699;Saponay;280;3;283
32;Hauts-de-France;02;1;04;701;Saulchery;708;8;716
32;Hauts-de-France;02;3;13;702;Savy;602;22;624
32;Hauts-de-France;02;3;01;703;Seboncourt;1083;13;1096
32;Hauts-de-France;02;2;20;704;Selens;247;4;251
32;Hauts-de-France;02;2;06;705;La Selve;210;6;216
32;Hauts-de-France;02;4;17;706;Septmonts;566;11;577
32;Hauts-de-France;02;2;20;707;Septvaux;181;0;181
32;Hauts-de-France;02;3;01;708;Sequehart;215;8;223
32;Hauts-de-France;02;3;01;709;Serain;407;8;415
32;Hauts-de-France;02;3;12;710;Seraucourt-le-Grand;742;18;760
32;Hauts-de-France;02;4;17;711;Serches;293;7;300
32;Hauts-de-France;02;1;05;712;Sergy;142;3;145
32;Hauts-de-France;02;1;05;713;Seringes-et-Nesles;270;4;274
32;Hauts-de-France;02;4;17;714;Sermoise;358;2;360
32;Hauts-de-France;02;4;05;715;Serval;45;3;48
32;Hauts-de-France;02;2;18;716;Servais;290;5;295
32;Hauts-de-France;02;3;12;717;Séry-lès-Mézières;590;13;603
32;Hauts-de-France;02;4;21;718;Silly-la-Poterie;121;3;124
32;Hauts-de-France;02;2;03;719;Sinceny;2028;41;2069
32;Hauts-de-France;02;2;06;720;Sissonne;2034;74;2108
32;Hauts-de-France;02;3;12;721;Sissy;476;2;478
32;Hauts-de-France;02;4;99;722;Soissons;28712;651;29363
32;Hauts-de-France;02;5;19;723;Soize;98;1;99
32;Hauts-de-France;02;1;21;724;Sommelans;61;1;62
32;Hauts-de-France;02;5;19;725;Sommeron;139;6;145
32;Hauts-de-France;02;3;12;726;Sommette-Eaucourt;181;3;184
32;Hauts-de-France;02;2;11;727;Sons-et-Ronchères;221;3;224
32;Hauts-de-France;02;5;19;728;Sorbais;264;4;268
32;Hauts-de-France;02;4;21;729;Soucy;81;1;82
32;Hauts-de-France;02;4;05;730;Soupir;267;6;273
32;Hauts-de-France;02;5;11;731;Le Sourd;171;2;173
32;Hauts-de-France;02;3;12;732;Surfontaine;104;0;104
32;Hauts-de-France;02;4;21;734;Taillefontaine;274;6;280
32;Hauts-de-France;02;4;05;735;Tannières;17;0;17
32;Hauts-de-France;02;4;20;736;Tartiers;167;5;172
32;Hauts-de-France;02;2;11;737;Tavaux-et-Pontséricourt;552;12;564
32;Hauts-de-France;02;2;18;738;Tergnier;13588;200;13788
32;Hauts-de-France;02;4;05;739;Terny-Sorny;335;7;342
32;Hauts-de-France;02;5;19;740;Thenailles;221;6;227
32;Hauts-de-France;02;3;12;741;Thenelles;539;5;544
32;Hauts-de-France;02;2;11;742;Thiernu;114;0;114
32;Hauts-de-France;02;5;19;743;Le Thuel;158;1;159
32;Hauts-de-France;02;1;21;744;Torcy-en-Valois;72;2;74
32;Hauts-de-France;02;2;11;745;Toulis-et-Attencourt;121;1;122
32;Hauts-de-France;02;2;18;746;Travecy;658;8;666
32;Hauts-de-France;02;3;13;747;Trefcon;83;0;83
32;Hauts-de-France;02;1;04;748;Trélou-sur-Marne;939;24;963
32;Hauts-de-France;02;4;21;749;Troësnes;219;7;226
32;Hauts-de-France;02;2;20;750;Trosly-Loire;583;8;591
32;Hauts-de-France;02;2;06;751;Trucy;144;2;146
32;Hauts-de-France;02;3;12;752;Tugny-et-Pont;281;5;286
32;Hauts-de-France;02;5;07;753;Tupigny;328;4;332
32;Hauts-de-France;02;2;03;754;Ugny-le-Gay;185;3;188
32;Hauts-de-France;02;2;09;755;Urcel;589;10;599
32;Hauts-de-France;02;3;12;756;Urvillers;684;12;696
32;Hauts-de-France;02;5;07;757;Vadencourt;529;8;537
32;Hauts-de-France;02;4;05;758;Vailly-sur-Aisne;2012;37;2049
32;Hauts-de-France;02;5;11;759;La Vallée-au-Blé;370;3;373
32;Hauts-de-France;02;5;07;760;La Vallée-Mulâtre;142;3;145
32;Hauts-de-France;02;2;06;761;Variscourt;211;4;215
32;Hauts-de-France;02;4;20;762;Vassens;139;5;144
32;Hauts-de-France;02;4;05;763;Vasseny;219;4;223
32;Hauts-de-France;02;2;06;764;Vassogne;88;3;91
32;Hauts-de-France;02;2;09;765;Vaucelles-et-Beffecourt;246;10;256
32;Hauts-de-France;02;4;05;766;Vaudesson;235;6;241
32;Hauts-de-France;02;4;16;767;Vauxrezis;322;3;325
32;Hauts-de-France;02;2;09;768;Vauxaillon;542;6;548
32;Hauts-de-France;02;5;07;769;Vaux-Andigny;898;14;912
32;Hauts-de-France;02;4;17;770;Vauxbuin;788;20;808
32;Hauts-de-France;02;3;13;772;Vaux-en-Vermandois;160;1;161
32;Hauts-de-France;02;4;05;773;Vauxtin;39;0;39
32;Hauts-de-France;02;3;13;774;Vendelles;118;1;119
32;Hauts-de-France;02;3;12;775;Vendeuil;936;17;953
32;Hauts-de-France;02;3;01;776;Vendhuile;558;12;570
32;Hauts-de-France;02;1;04;777;Vendières;142;7;149
32;Hauts-de-France;02;2;06;778;Vendresse-Beaulne;97;1;98
32;Hauts-de-France;02;5;07;779;Vénérolles;219;3;222
32;Hauts-de-France;02;4;16;780;Venizel;1378;17;1395
32;Hauts-de-France;02;1;02;781;Verdilly;453;16;469
32;Hauts-de-France;02;3;13;782;Le Verguier;220;2;222
32;Hauts-de-France;02;5;07;783;Grand-Verly;138;0;138
32;Hauts-de-France;02;5;07;784;Petit-Verly;138;0;138
32;Hauts-de-France;02;3;13;785;Vermand;1100;30;1130
32;Hauts-de-France;02;2;20;786;Verneuil-sous-Coucy;127;2;129
32;Hauts-de-France;02;2;11;787;Verneuil-sur-Serre;258;2;260
32;Hauts-de-France;02;2;18;788;Versigny;460;7;467
32;Hauts-de-France;02;5;19;789;Vervins;2587;96;2683
32;Hauts-de-France;02;2;11;790;Vesles-et-Caumont;238;3;241
32;Hauts-de-France;02;2;10;791;Veslud;259;6;265
32;Hauts-de-France;02;1;04;792;Veuilly-la-Poterie;157;7;164
32;Hauts-de-France;02;4;20;793;Vézaponin;119;1;120
32;Hauts-de-France;02;1;05;794;Vézilly;188;4;192
32;Hauts-de-France;02;4;20;795;Vic-sur-Aisne;1618;18;1636
32;Hauts-de-France;02;1;21;796;Vichel-Nanteuil;83;0;83
32;Hauts-de-France;02;4;05;797;Viel-Arcy;172;1;173
32;Hauts-de-France;02;1;04;798;Viels-Maisons;1221;19;1240
32;Hauts-de-France;02;4;21;799;Vierzy;407;9;416
32;Hauts-de-France;02;1;04;800;Viffort;313;5;318
32;Hauts-de-France;02;5;19;801;Vigneux-Hocquet;272;3;275
32;Hauts-de-France;02;5;19;802;La Ville-aux-Bois-lès-Dizy;209;0;209
32;Hauts-de-France;02;2;06;803;La Ville-aux-Bois-lès-Pontavert;146;5;151
32;Hauts-de-France;02;4;21;804;Villemontoire;186;3;189
32;Hauts-de-France;02;4;16;805;Villeneuve-Saint-Germain;2549;44;2593
32;Hauts-de-France;02;1;02;806;Villeneuve-sur-Fère;294;5;299
32;Hauts-de-France;02;2;03;807;Villequier-Aumont;656;24;680
32;Hauts-de-France;02;3;01;808;Villeret;289;5;294
32;Hauts-de-France;02;1;05;809;Villers-Agron-Aiguizy;69;3;72
32;Hauts-de-France;02;4;21;810;Villers-Cotterêts;10424;417;10841
32;Hauts-de-France;02;4;21;812;Villers-Hélon;207;6;213
32;Hauts-de-France;02;3;12;813;Villers-le-Sec;252;8;260
32;Hauts-de-France;02;5;07;814;Villers-lès-Guise;162;0;162
32;Hauts-de-France;02;3;12;815;Villers-Saint-Christophe;430;17;447
32;Hauts-de-France;02;1;05;816;Villers-sur-Fère;531;6;537
32;Hauts-de-France;02;4;05;817;Ville-Savoye;82;1;83
32;Hauts-de-France;02;1;04;818;Villiers-Saint-Denis;1166;11;1177
32;Hauts-de-France;02;5;19;819;Vincy-Reuil-et-Magny;116;1;117
32;Hauts-de-France;02;2;03;820;Viry-Noureuil;1688;43;1731
32;Hauts-de-France;02;2;09;821;Vivaise;680;21;701
32;Hauts-de-France;02;4;21;822;Vivières;391;12;403
32;Hauts-de-France;02;5;11;823;Voharies;74;0;74
32;Hauts-de-France;02;2;10;824;Vorges;375;8;383
32;Hauts-de-France;02;5;11;826;Voulpaix;356;7;363
32;Hauts-de-France;02;2;11;827;Voyenne;312;5;317
32;Hauts-de-France;02;4;16;828;Vregny;94;0;94
32;Hauts-de-France;02;4;05;829;Vuillery;42;1;43
32;Hauts-de-France;02;5;07;830;Wassigny;955;16;971
32;Hauts-de-France;02;5;08;831;Watigny;379;6;385
32;Hauts-de-France;02;5;11;832;Wiège-Faty;189;5;194
32;Hauts-de-France;02;5;08;833;Wimy;508;7;515
32;Hauts-de-France;02;2;09;834;Wissignicourt;169;6;175
84;Auvergne-Rhône-Alpes;03;3;18;001;Abrest;2904;60;2964
84;Auvergne-Rhône-Alpes;03;2;16;002;Agonges;309;12;321
84;Auvergne-Rhône-Alpes;03;1;02;003;Ainay-le-Château;987;27;1014
84;Auvergne-Rhône-Alpes;03;3;08;004;Andelaroche;253;7;260
84;Auvergne-Rhône-Alpes;03;1;07;005;Archignat;338;3;341
84;Auvergne-Rhône-Alpes;03;3;08;006;Arfeuilles;633;17;650
84;Auvergne-Rhône-Alpes;03;1;11;007;Arpheuilles-Saint-Priest;357;7;364
84;Auvergne-Rhône-Alpes;03;3;08;008;Arronnes;372;14;386
84;Auvergne-Rhône-Alpes;03;2;13;009;Aubigny;135;36;171
84;Auvergne-Rhône-Alpes;03;1;07;010;Audes;424;13;437
84;Auvergne-Rhône-Alpes;03;2;19;011;Aurouër;421;9;430
84;Auvergne-Rhône-Alpes;03;2;16;012;Autry-Issards;323;5;328
84;Auvergne-Rhône-Alpes;03;2;13;013;Avermes;3953;96;4049
84;Auvergne-Rhône-Alpes;03;3;05;014;Avrilly;136;3;139
84;Auvergne-Rhône-Alpes;03;2;13;015;Bagneux;328;11;339
84;Auvergne-Rhône-Alpes;03;2;06;016;Barberier;143;2;145
84;Auvergne-Rhône-Alpes;03;3;08;017;Barrais-Bussolles;189;6;195
84;Auvergne-Rhône-Alpes;03;2;15;018;Bayet;685;14;699
84;Auvergne-Rhône-Alpes;03;2;05;019;Beaulon;1640;24;1664
84;Auvergne-Rhône-Alpes;03;1;03;020;Beaune-d'Allier;294;7;301
84;Auvergne-Rhône-Alpes;03;3;06;021;Bègues;224;2;226
84;Auvergne-Rhône-Alpes;03;3;06;022;Bellenaves;997;17;1014
84;Auvergne-Rhône-Alpes;03;3;01;023;Bellerive-sur-Allier;8741;231;8972
84;Auvergne-Rhône-Alpes;03;3;14;024;Bert;237;6;243
84;Auvergne-Rhône-Alpes;03;2;14;025;Bessay-sur-Allier;1328;31;1359
84;Auvergne-Rhône-Alpes;03;2;16;026;Besson;761;18;779
84;Auvergne-Rhône-Alpes;03;1;03;027;Bézenet;928;24;952
84;Auvergne-Rhône-Alpes;03;3;08;028;Billezois;364;7;371
84;Auvergne-Rhône-Alpes;03;3;15;029;Billy;783;12;795
84;Auvergne-Rhône-Alpes;03;3;06;030;Biozat;856;15;871
84;Auvergne-Rhône-Alpes;03;1;07;031;Bizeneuille;291;9;300
84;Auvergne-Rhône-Alpes;03;1;03;032;Blomard;244;2;246
84;Auvergne-Rhône-Alpes;03;3;04;033;Bost;181;4;185
84;Auvergne-Rhône-Alpes;03;3;15;034;Boucé;496;12;508
84;Auvergne-Rhône-Alpes;03;3;05;035;Le Bouchaud;212;4;216
84;Auvergne-Rhône-Alpes;03;2;02;036;Bourbon-l'Archambault;2572;72;2644
84;Auvergne-Rhône-Alpes;03;1;02;037;Braize;259;2;261
84;Auvergne-Rhône-Alpes;03;2;16;038;Bransat;521;8;529
84;Auvergne-Rhône-Alpes;03;2;16;039;Bresnay;384;7;391
84;Auvergne-Rhône-Alpes;03;2;16;040;Bressolles;1126;38;1164
84;Auvergne-Rhône-Alpes;03;1;07;041;Le Brethon;319;12;331
84;Auvergne-Rhône-Alpes;03;3;08;042;Le Breuil;530;17;547
84;Auvergne-Rhône-Alpes;03;3;01;043;Broût-Vernet;1189;75;1264
84;Auvergne-Rhône-Alpes;03;3;01;044;Brugheas;1516;36;1552
84;Auvergne-Rhône-Alpes;03;3;08;045;Busset;849;18;867
84;Auvergne-Rhône-Alpes;03;2;02;046;Buxières-les-Mines;1026;23;1049
84;Auvergne-Rhône-Alpes;03;1;11;047;La Celle;407;9;416
84;Auvergne-Rhône-Alpes;03;1;02;048;Cérilly;1305;24;1329
84;Auvergne-Rhône-Alpes;03;2;16;049;Cesset;428;10;438
84;Auvergne-Rhône-Alpes;03;3;08;050;La Chabanne;179;10;189
84;Auvergne-Rhône-Alpes;03;1;07;051;Chambérat;301;6;307
84;Auvergne-Rhône-Alpes;03;1;03;052;Chamblet;1093;29;1122
84;Auvergne-Rhône-Alpes;03;2;06;053;Chantelle;1102;25;1127
84;Auvergne-Rhône-Alpes;03;2;14;054;Chapeau;237;6;243
84;Auvergne-Rhône-Alpes;03;1;07;055;La Chapelaude;966;17;983
84;Auvergne-Rhône-Alpes;03;3;08;056;La Chapelle;382;7;389
84;Auvergne-Rhône-Alpes;03;2;05;057;La Chapelle-aux-Chasses;201;6;207
84;Auvergne-Rhône-Alpes;03;1;03;058;Chappes;238;6;244
84;Auvergne-Rhône-Alpes;03;2;06;059;Chareil-Cintrat;359;7;366
84;Auvergne-Rhône-Alpes;03;3;17;060;Charmeil;1030;17;1047
84;Auvergne-Rhône-Alpes;03;3;06;061;Charmes;394;6;400
84;Auvergne-Rhône-Alpes;03;2;06;062;Charroux;351;17;368
84;Auvergne-Rhône-Alpes;03;2;05;063;Chassenard;1028;20;1048
84;Auvergne-Rhône-Alpes;03;2;02;064;Château-sur-Allier;180;1;181
84;Auvergne-Rhône-Alpes;03;2;16;065;Châtel-de-Neuvre;544;9;553
84;Auvergne-Rhône-Alpes;03;3;08;066;Châtel-Montagne;324;5;329
84;Auvergne-Rhône-Alpes;03;3;14;067;Châtelperron;138;4;142
84;Auvergne-Rhône-Alpes;03;3;08;068;Châtelus;104;1;105
84;Auvergne-Rhône-Alpes;03;2;16;069;Châtillon;312;6;318
84;Auvergne-Rhône-Alpes;03;1;03;070;Chavenon;133;1;134
84;Auvergne-Rhône-Alpes;03;3;14;071;Chavroches;248;3;251
84;Auvergne-Rhône-Alpes;03;1;07;072;Chazemais;492;12;504
84;Auvergne-Rhône-Alpes;03;2;16;073;Chemilly;638;11;649
84;Auvergne-Rhône-Alpes;03;2;05;074;Chevagnes;656;15;671
84;Auvergne-Rhône-Alpes;03;3;06;075;Chezelle;168;2;170
84;Auvergne-Rhône-Alpes;03;2;05;076;Chézy;227;7;234
84;Auvergne-Rhône-Alpes;03;3;06;077;Chirat-l'Église;128;3;131
84;Auvergne-Rhône-Alpes;03;3;06;078;Chouvigny;231;8;239
84;Auvergne-Rhône-Alpes;03;3;14;079;Cindré;303;8;311
84;Auvergne-Rhône-Alpes;03;3;01;080;Cognat-Lyonne;691;11;702
84;Auvergne-Rhône-Alpes;03;1;03;081;Colombier;327;12;339
84;Auvergne-Rhône-Alpes;03;1;03;082;Commentry;6132;189;6321
84;Auvergne-Rhône-Alpes;03;2;16;083;Contigny;580;13;593
84;Auvergne-Rhône-Alpes;03;1;07;084;Cosne-d'Allier;2034;31;2065
84;Auvergne-Rhône-Alpes;03;2;13;085;Coulandon;646;55;701
84;Auvergne-Rhône-Alpes;03;2;05;086;Coulanges;321;8;329
84;Auvergne-Rhône-Alpes;03;2;02;087;Couleuvre;597;7;604
84;Auvergne-Rhône-Alpes;03;1;07;088;Courçais;320;2;322
84;Auvergne-Rhône-Alpes;03;3;06;089;Coutansouze;152;1;153
84;Auvergne-Rhône-Alpes;03;2;02;090;Couzon;305;8;313
84;Auvergne-Rhône-Alpes;03;3;15;091;Créchy;438;9;447
84;Auvergne-Rhône-Alpes;03;2;16;092;Cressanges;628;13;641
84;Auvergne-Rhône-Alpes;03;3;04;093;Creuzier-le-Neuf;1185;27;1212
84;Auvergne-Rhône-Alpes;03;3;04;094;Creuzier-le-Vieux;3297;102;3399
84;Auvergne-Rhône-Alpes;03;3;04;095;Cusset;12474;481;12955
84;Auvergne-Rhône-Alpes;03;2;06;096;Deneuille-lès-Chantelle;86;1;87
84;Auvergne-Rhône-Alpes;03;1;03;097;Deneuille-les-Mines;360;9;369
84;Auvergne-Rhône-Alpes;03;1;10;098;Désertines;4459;87;4546
84;Auvergne-Rhône-Alpes;03;2;16;099;Deux-Chaises;391;11;402
84;Auvergne-Rhône-Alpes;03;2;05;100;Diou;1381;35;1416
84;Auvergne-Rhône-Alpes;03;1;09;101;Domérat;8729;166;8895
84;Auvergne-Rhône-Alpes;03;2;05;102;Dompierre-sur-Besbre;3032;59;3091
84;Auvergne-Rhône-Alpes;03;3;05;103;Le Donjon;1065;25;1090
84;Auvergne-Rhône-Alpes;03;1;03;104;Doyet;1169;32;1201
84;Auvergne-Rhône-Alpes;03;3;08;105;Droiturier;357;7;364
84;Auvergne-Rhône-Alpes;03;1;11;106;Durdat-Larequille;1316;105;1421
84;Auvergne-Rhône-Alpes;03;3;06;107;Ébreuil;1270;27;1297
84;Auvergne-Rhône-Alpes;03;3;06;108;Échassières;376;6;382
84;Auvergne-Rhône-Alpes;03;3;01;109;Escurolles;781;32;813
84;Auvergne-Rhône-Alpes;03;3;01;110;Espinasse-Vozelle;968;26;994
84;Auvergne-Rhône-Alpes;03;1;07;111;Estivareilles;1112;24;1136
84;Auvergne-Rhône-Alpes;03;2;06;112;Étroussat;668;9;677
84;Auvergne-Rhône-Alpes;03;3;08;113;Ferrières-sur-Sichon;536;16;552
84;Auvergne-Rhône-Alpes;03;2;14;114;La Ferté-Hauterive;279;7;286
84;Auvergne-Rhône-Alpes;03;2;06;115;Fleuriel;341;7;348
84;Auvergne-Rhône-Alpes;03;2;06;116;Fourilles;191;5;196
84;Auvergne-Rhône-Alpes;03;2;02;117;Franchesse;475;12;487
84;Auvergne-Rhône-Alpes;03;3;06;118;Gannat;5830;197;6027
84;Auvergne-Rhône-Alpes;03;2;05;119;Gannay-sur-Loire;413;4;417
84;Auvergne-Rhône-Alpes;03;2;05;120;Garnat-sur-Engièvre;710;12;722
84;Auvergne-Rhône-Alpes;03;2;19;121;Gennetines;647;17;664
84;Auvergne-Rhône-Alpes;03;2;16;122;Gipcy;236;6;242
84;Auvergne-Rhône-Alpes;03;2;14;124;Gouise;219;3;222
84;Auvergne-Rhône-Alpes;03;3;08;125;La Guillermie;124;2;126
84;Auvergne-Rhône-Alpes;03;3;01;126;Hauterive;1167;13;1180
84;Auvergne-Rhône-Alpes;03;1;07;127;Hérisson;620;10;630
84;Auvergne-Rhône-Alpes;03;1;07;128;Huriel;2645;57;2702
84;Auvergne-Rhône-Alpes;03;1;03;129;Hyds;312;13;325
84;Auvergne-Rhône-Alpes;03;1;02;130;Isle-et-Bardais;279;6;285
84;Auvergne-Rhône-Alpes;03;3;08;131;Isserpent;550;13;563
84;Auvergne-Rhône-Alpes;03;3;14;132;Jaligny-sur-Besbre;559;15;574
84;Auvergne-Rhône-Alpes;03;3;06;133;Jenzat;519;10;529
84;Auvergne-Rhône-Alpes;03;2;16;134;Laféline;193;3;196
84;Auvergne-Rhône-Alpes;03;3;06;135;Lalizolle;407;9;416
84;Auvergne-Rhône-Alpes;03;1;12;136;Lamaids;235;5;240
84;Auvergne-Rhône-Alpes;03;3;15;137;Langy;271;6;277
84;Auvergne-Rhône-Alpes;03;3;08;138;Lapalisse;3144;73;3217
84;Auvergne-Rhône-Alpes;03;3;08;139;Laprugne;313;11;324
84;Auvergne-Rhône-Alpes;03;1;12;140;Lavault-Sainte-Anne;1154;33;1187
84;Auvergne-Rhône-Alpes;03;3;08;141;Lavoine;149;2;151
84;Auvergne-Rhône-Alpes;03;3;05;142;Lenax;242;5;247
84;Auvergne-Rhône-Alpes;03;1;02;143;Lételon;92;3;95
84;Auvergne-Rhône-Alpes;03;3;14;144;Liernolles;211;8;219
84;Auvergne-Rhône-Alpes;03;1;12;145;Lignerolles;736;13;749
84;Auvergne-Rhône-Alpes;03;2;02;146;Limoise;154;35;189
84;Auvergne-Rhône-Alpes;03;3;05;147;Loddes;167;2;169
84;Auvergne-Rhône-Alpes;03;2;15;148;Loriges;349;6;355
84;Auvergne-Rhône-Alpes;03;2;15;149;Louchy-Montfand;441;16;457
84;Auvergne-Rhône-Alpes;03;1;07;150;Louroux-Bourbonnais;203;7;210
84;Auvergne-Rhône-Alpes;03;1;03;151;Louroux-de-Beaune;159;3;162
84;Auvergne-Rhône-Alpes;03;3;06;152;Louroux-de-Bouble;231;7;238
84;Auvergne-Rhône-Alpes;03;3;05;154;Luneau;276;4;280
84;Auvergne-Rhône-Alpes;03;2;02;155;Lurcy-Lévis;1881;42;1923
84;Auvergne-Rhône-Alpes;03;2;05;156;Lusigny;1688;54;1742
84;Auvergne-Rhône-Alpes;03;3;15;157;Magnet;1020;23;1043
84;Auvergne-Rhône-Alpes;03;1;07;158;Haut-Bocage;871;19;890
84;Auvergne-Rhône-Alpes;03;1;03;159;Malicorne;780;15;795
84;Auvergne-Rhône-Alpes;03;2;15;160;Marcenat;410;4;414
84;Auvergne-Rhône-Alpes;03;1;11;161;Marcillat-en-Combraille;900;29;929
84;Auvergne-Rhône-Alpes;03;2;16;162;Marigny;202;6;208
84;Auvergne-Rhône-Alpes;03;3;08;163;Mariol;751;22;773
84;Auvergne-Rhône-Alpes;03;3;06;164;Le Mayet-d'École;273;2;275
84;Auvergne-Rhône-Alpes;03;3;08;165;Le Mayet-de-Montagne;1384;86;1470
84;Auvergne-Rhône-Alpes;03;3;06;166;Mazerier;306;5;311
84;Auvergne-Rhône-Alpes;03;1;11;167;Mazirat;286;4;290
84;Auvergne-Rhône-Alpes;03;1;02;168;Meaulne-Vitray;906;15;921
84;Auvergne-Rhône-Alpes;03;2;16;169;Meillard;331;6;337
84;Auvergne-Rhône-Alpes;03;2;16;170;Meillers;129;6;135
84;Auvergne-Rhône-Alpes;03;2;14;171;Mercy;249;6;255
84;Auvergne-Rhône-Alpes;03;1;07;172;Mesples;122;2;124
84;Auvergne-Rhône-Alpes;03;2;05;173;Molinet;1142;33;1175
84;Auvergne-Rhône-Alpes;03;3;08;174;Molles;914;25;939
84;Auvergne-Rhône-Alpes;03;3;06;175;Monestier;278;12;290
84;Auvergne-Rhône-Alpes;03;2;16;176;Monétay-sur-Allier;541;10;551
84;Auvergne-Rhône-Alpes;03;2;05;177;Monétay-sur-Loire;253;3;256
84;Auvergne-Rhône-Alpes;03;3;05;178;Montaiguët-en-Forez;298;6;304
84;Auvergne-Rhône-Alpes;03;3;15;179;Montaigu-le-Blin;297;10;307
84;Auvergne-Rhône-Alpes;03;2;14;180;Montbeugny;662;11;673
84;Auvergne-Rhône-Alpes;03;3;05;181;Montcombroux-les-Mines;296;3;299
84;Auvergne-Rhône-Alpes;03;3;06;182;Monteignet-sur-l'Andelot;263;1;264
84;Auvergne-Rhône-Alpes;03;2;16;183;Le Montet;469;4;473
84;Auvergne-Rhône-Alpes;03;2;13;184;Montilly;505;8;513
84;Auvergne-Rhône-Alpes;03;1;97;185;Montluçon;34361;1070;35431
84;Auvergne-Rhône-Alpes;03;1;03;186;Montmarault;1524;21;1545
84;Auvergne-Rhône-Alpes;03;3;15;187;Montoldre;630;9;639
84;Auvergne-Rhône-Alpes;03;2;15;188;Montord;219;1;220
84;Auvergne-Rhône-Alpes;03;1;03;189;Montvicq;715;24;739
84;Auvergne-Rhône-Alpes;03;2;98;190;Moulins;19246;542;19788
84;Auvergne-Rhône-Alpes;03;1;03;191;Murat;280;8;288
84;Auvergne-Rhône-Alpes;03;3;06;192;Nades;150;3;153
84;Auvergne-Rhône-Alpes;03;1;07;193;Nassigny;187;4;191
84;Auvergne-Rhône-Alpes;03;3;06;194;Naves;125;2;127
84;Auvergne-Rhône-Alpes;03;1;11;195;Néris-les-Bains;2570;94;2664
84;Auvergne-Rhône-Alpes;03;3;05;196;Neuilly-en-Donjon;221;3;224
84;Auvergne-Rhône-Alpes;03;2;14;197;Neuilly-le-Réal;1453;32;1485
84;Auvergne-Rhône-Alpes;03;2;02;198;Neure;187;0;187
84;Auvergne-Rhône-Alpes;03;2;13;200;Neuvy;1520;256;1776
84;Auvergne-Rhône-Alpes;03;3;08;201;Nizerolles;304;13;317
84;Auvergne-Rhône-Alpes;03;2;16;202;Noyant-d'Allier;603;15;618
84;Auvergne-Rhône-Alpes;03;2;05;203;Paray-le-Frésil;387;9;396
84;Auvergne-Rhône-Alpes;03;2;15;204;Paray-sous-Briailles;623;18;641
84;Auvergne-Rhône-Alpes;03;3;08;205;Périgny;440;11;451
84;Auvergne-Rhône-Alpes;03;1;11;206;La Petite-Marche;168;6;174
84;Auvergne-Rhône-Alpes;03;2;05;207;Pierrefitte-sur-Loire;512;13;525
84;Auvergne-Rhône-Alpes;03;3;05;208;Le Pin;423;9;432
84;Auvergne-Rhône-Alpes;03;3;06;209;Poëzat;151;3;154
84;Auvergne-Rhône-Alpes;03;2;02;210;Pouzy-Mésangy;399;10;409
84;Auvergne-Rhône-Alpes;03;1;12;211;Prémilhat;2507;49;2556
84;Auvergne-Rhône-Alpes;03;1;12;212;Quinssaines;1512;25;1537
84;Auvergne-Rhône-Alpes;03;1;07;213;Reugny;252;4;256
84;Auvergne-Rhône-Alpes;03;2;16;214;Rocles;382;3;385
84;Auvergne-Rhône-Alpes;03;3;15;215;Rongères;550;8;558
84;Auvergne-Rhône-Alpes;03;1;11;216;Ronnet;172;3;175
84;Auvergne-Rhône-Alpes;03;1;03;217;Saint-Angel;761;35;796
84;Auvergne-Rhône-Alpes;03;2;02;218;Saint-Aubin-le-Monial;272;8;280
84;Auvergne-Rhône-Alpes;03;1;03;219;Saint-Bonnet-de-Four;215;5;220
84;Auvergne-Rhône-Alpes;03;3;06;220;Saint-Bonnet-de-Rochefort;710;15;725
84;Auvergne-Rhône-Alpes;03;1;02;221;Saint-Bonnet-Tronçais;730;8;738
84;Auvergne-Rhône-Alpes;03;1;07;222;Saint-Caprais;90;5;95
84;Auvergne-Rhône-Alpes;03;3;08;223;Saint-Christophe;441;14;455
84;Auvergne-Rhône-Alpes;03;3;08;224;Saint-Clément;288;7;295
84;Auvergne-Rhône-Alpes;03;1;07;225;Saint-Désiré;444;10;454
84;Auvergne-Rhône-Alpes;03;3;05;226;Saint-Didier-en-Donjon;250;5;255
84;Auvergne-Rhône-Alpes;03;3;01;227;Saint-Didier-la-Forêt;373;8;381
84;Auvergne-Rhône-Alpes;03;1;07;228;Saint-Éloy-d'Allier;38;0;38
84;Auvergne-Rhône-Alpes;03;2;19;229;Saint-Ennemond;612;18;630
84;Auvergne-Rhône-Alpes;03;3;08;230;Saint-Étienne-de-Vicq;526;16;542
84;Auvergne-Rhône-Alpes;03;1;11;231;Saint-Fargeol;188;5;193
84;Auvergne-Rhône-Alpes;03;3;15;232;Saint-Félix;303;9;312
84;Auvergne-Rhône-Alpes;03;1;11;233;Saint-Genest;395;8;403
84;Auvergne-Rhône-Alpes;03;2;14;234;Saint-Gérand-de-Vaux;373;11;384
84;Auvergne-Rhône-Alpes;03;3;15;235;Saint-Gérand-le-Puy;969;10;979
84;Auvergne-Rhône-Alpes;03;3;17;236;Saint-Germain-des-Fossés;3654;70;3724
84;Auvergne-Rhône-Alpes;03;2;06;237;Saint-Germain-de-Salles;427;9;436
84;Auvergne-Rhône-Alpes;03;2;02;238;Saint-Hilaire;529;9;538
84;Auvergne-Rhône-Alpes;03;3;05;239;Saint-Léger-sur-Vouzance;265;9;274
84;Auvergne-Rhône-Alpes;03;3;14;240;Saint-Léon;543;11;554
84;Auvergne-Rhône-Alpes;03;2;02;241;Saint-Léopardin-d'Augy;368;46;414
84;Auvergne-Rhône-Alpes;03;3;15;242;Saint-Loup;568;14;582
84;Auvergne-Rhône-Alpes;03;1;03;243;Saint-Marcel-en-Murat;121;6;127
84;Auvergne-Rhône-Alpes;03;1;11;244;Saint-Marcel-en-Marcillat;128;2;130
84;Auvergne-Rhône-Alpes;03;2;05;245;Saint-Martin-des-Lais;124;1;125
84;Auvergne-Rhône-Alpes;03;1;07;246;Saint-Martinien;594;12;606
84;Auvergne-Rhône-Alpes;03;2;16;247;Saint-Menoux;1106;33;1139
84;Auvergne-Rhône-Alpes;03;3;08;248;Saint-Nicolas-des-Biefs;165;2;167
84;Auvergne-Rhône-Alpes;03;1;07;249;Saint-Palais;162;2;164
84;Auvergne-Rhône-Alpes;03;3;08;250;Saint-Pierre-Laval;349;6;355
84;Auvergne-Rhône-Alpes;03;2;02;251;Saint-Plaisir;376;9;385
84;Auvergne-Rhône-Alpes;03;3;01;252;Saint-Pont;677;15;692
84;Auvergne-Rhône-Alpes;03;2;05;253;Saint-Pourçain-sur-Besbre;379;10;389
84;Auvergne-Rhône-Alpes;03;2;15;254;Saint-Pourçain-sur-Sioule;5221;118;5339
84;Auvergne-Rhône-Alpes;03;3;06;255;Saint-Priest-d'Andelot;143;4;147
84;Auvergne-Rhône-Alpes;03;1;03;256;Saint-Priest-en-Murat;214;5;219
84;Auvergne-Rhône-Alpes;03;3;08;257;Saint-Prix;803;23;826
84;Auvergne-Rhône-Alpes;03;3;17;258;Saint-Rémy-en-Rollat;1737;26;1763
84;Auvergne-Rhône-Alpes;03;1;07;259;Saint-Sauvier;338;3;341
84;Auvergne-Rhône-Alpes;03;2;16;260;Saint-Sornin;224;5;229
84;Auvergne-Rhône-Alpes;03;1;11;261;Sainte-Thérence;178;7;185
84;Auvergne-Rhône-Alpes;03;1;09;262;Saint-Victor;2092;38;2130
84;Auvergne-Rhône-Alpes;03;2;14;263;Saint-Voir;194;8;202
84;Auvergne-Rhône-Alpes;03;3;18;264;Saint-Yorre;2570;53;2623
84;Auvergne-Rhône-Alpes;03;2;05;265;Saligny-sur-Roudon;671;78;749
84;Auvergne-Rhône-Alpes;03;3;15;266;Sanssat;272;8;280
84;Auvergne-Rhône-Alpes;03;2;15;267;Saulcet;664;24;688
84;Auvergne-Rhône-Alpes;03;3;06;268;Saulzet;386;3;389
84;Auvergne-Rhône-Alpes;03;1;07;269;Sauvagny;85;2;87
84;Auvergne-Rhône-Alpes;03;1;03;270;Sazeret;143;5;148
84;Auvergne-Rhône-Alpes;03;3;01;271;Serbannes;805;32;837
84;Auvergne-Rhône-Alpes;03;3;08;272;Servilly;282;7;289
84;Auvergne-Rhône-Alpes;03;3;15;273;Seuillet;492;15;507
84;Auvergne-Rhône-Alpes;03;3;14;274;Sorbier;318;6;324
84;Auvergne-Rhône-Alpes;03;2;16;275;Souvigny;1747;49;1796
84;Auvergne-Rhône-Alpes;03;3;06;276;Sussat;102;6;108
84;Auvergne-Rhône-Alpes;03;3;06;277;Target;254;5;259
84;Auvergne-Rhône-Alpes;03;2;06;278;Taxat-Senat;191;4;195
84;Auvergne-Rhône-Alpes;03;1;12;279;Teillet-Argenty;556;10;566
84;Auvergne-Rhône-Alpes;03;1;11;280;Terjat;182;9;191
84;Auvergne-Rhône-Alpes;03;2;16;281;Le Theil;391;3;394
84;Auvergne-Rhône-Alpes;03;1;02;282;Theneuille;372;13;385
84;Auvergne-Rhône-Alpes;03;2;05;283;Thiel-sur-Acolin;1065;18;1083
84;Auvergne-Rhône-Alpes;03;3;14;284;Thionne;290;9;299
84;Auvergne-Rhône-Alpes;03;1;07;285;Tortezais;178;8;186
84;Auvergne-Rhône-Alpes;03;2;14;286;Toulon-sur-Allier;1138;20;1158
84;Auvergne-Rhône-Alpes;03;2;16;287;Treban;379;9;388
84;Auvergne-Rhône-Alpes;03;1;07;288;Treignat;384;8;392
84;Auvergne-Rhône-Alpes;03;3;14;289;Treteau;514;12;526
84;Auvergne-Rhône-Alpes;03;2;19;290;Trévol;1630;59;1689
84;Auvergne-Rhône-Alpes;03;3;14;291;Trézelles;415;13;428
84;Auvergne-Rhône-Alpes;03;2;16;292;Tronget;879;12;891
84;Auvergne-Rhône-Alpes;03;1;02;293;Urçay;283;10;293
84;Auvergne-Rhône-Alpes;03;2;06;294;Ussel-d'Allier;168;1;169
84;Auvergne-Rhône-Alpes;03;3;06;295;Valignat;76;0;76
84;Auvergne-Rhône-Alpes;03;1;02;296;Valigny;376;12;388
84;Auvergne-Rhône-Alpes;03;1;07;297;Vallon-en-Sully;1538;26;1564
84;Auvergne-Rhône-Alpes;03;3;15;298;Varennes-sur-Allier;3618;73;3691
84;Auvergne-Rhône-Alpes;03;3;14;299;Varennes-sur-Tèche;229;8;237
84;Auvergne-Rhône-Alpes;03;2;05;300;Vaumas;537;9;546
84;Auvergne-Rhône-Alpes;03;1;09;301;Vaux;1166;26;1192
84;Auvergne-Rhône-Alpes;03;3;06;302;Veauce;39;1;40
84;Auvergne-Rhône-Alpes;03;1;07;303;Venas;236;10;246
84;Auvergne-Rhône-Alpes;03;3;01;304;Vendat;2249;59;2308
84;Auvergne-Rhône-Alpes;03;1;03;305;Verneix;593;15;608
84;Auvergne-Rhône-Alpes;03;3;08;306;Le Vernet;1918;52;1970
84;Auvergne-Rhône-Alpes;03;2;16;307;Verneuil-en-Bourbonnais;236;3;239
84;Auvergne-Rhône-Alpes;03;1;03;308;Vernusse;152;4;156
84;Auvergne-Rhône-Alpes;03;2;02;309;Le Veurdre;454;10;464
84;Auvergne-Rhône-Alpes;03;3;99;310;Vichy;24980;322;25302
84;Auvergne-Rhône-Alpes;03;3;06;311;Vicq;305;7;312
84;Auvergne-Rhône-Alpes;03;2;02;312;Vieure;274;10;284
84;Auvergne-Rhône-Alpes;03;1;02;313;Le Vilhain;275;9;284
84;Auvergne-Rhône-Alpes;03;1;11;314;Villebret;1322;36;1358
84;Auvergne-Rhône-Alpes;03;1;03;315;Villefranche-d'Allier;1283;37;1320
84;Auvergne-Rhône-Alpes;03;2;19;316;Villeneuve-sur-Allier;1073;16;1089
84;Auvergne-Rhône-Alpes;03;1;07;317;Viplaix;294;8;302
84;Auvergne-Rhône-Alpes;03;2;06;319;Voussac;484;10;494
84;Auvergne-Rhône-Alpes;03;2;02;320;Ygrande;776;17;793
84;Auvergne-Rhône-Alpes;03;2;19;321;Yzeure;12838;517;13355
93;Provence-Alpes-Côte d'Azur;04;3;05;001;Aiglun;1432;28;1460
93;Provence-Alpes-Côte d'Azur;04;4;15;004;Allemagne-en-Provence;546;30;576
93;Provence-Alpes-Côte d'Azur;04;2;02;005;Allons;133;2;135
93;Provence-Alpes-Côte d'Azur;04;2;02;006;Allos;824;8;832
93;Provence-Alpes-Côte d'Azur;04;2;02;007;Angles;67;0;67
93;Provence-Alpes-Côte d'Azur;04;2;02;008;Annot;1031;35;1066
93;Provence-Alpes-Côte d'Azur;04;3;13;009;Archail;14;0;14
93;Provence-Alpes-Côte d'Azur;04;4;11;012;Aubenas-les-Alpes;95;0;95
93;Provence-Alpes-Côte d'Azur;04;4;03;013;Aubignosc;605;15;620
93;Provence-Alpes-Côte d'Azur;04;4;14;016;Authon;63;0;63
93;Provence-Alpes-Côte d'Azur;04;3;13;017;Auzet;99;5;104
93;Provence-Alpes-Côte d'Azur;04;4;11;018;Banon;1028;15;1043
93;Provence-Alpes-Côte d'Azur;04;1;01;019;Barcelonnette;2564;198;2762
93;Provence-Alpes-Côte d'Azur;04;3;13;020;Barles;133;2;135
93;Provence-Alpes-Côte d'Azur;04;3;05;021;Barras;147;4;151
93;Provence-Alpes-Côte d'Azur;04;2;12;022;Barrême;417;8;425
93;Provence-Alpes-Côte d'Azur;04;4;13;023;Bayons;189;4;193
93;Provence-Alpes-Côte d'Azur;04;3;13;024;Beaujeu;127;3;130
93;Provence-Alpes-Côte d'Azur;04;2;02;025;Beauvezer;386;14;400
93;Provence-Alpes-Côte d'Azur;04;4;13;026;Bellaffaire;136;6;142
93;Provence-Alpes-Côte d'Azur;04;4;14;027;Bevons;252;56;308
93;Provence-Alpes-Côte d'Azur;04;3;12;028;Beynes;122;9;131
93;Provence-Alpes-Côte d'Azur;04;2;12;030;Blieux;57;0;57
93;Provence-Alpes-Côte d'Azur;04;3;12;031;Bras-d'Asse;557;10;567
93;Provence-Alpes-Côte d'Azur;04;2;02;032;Braux;127;0;127
93;Provence-Alpes-Côte d'Azur;04;1;01;033;Ubaye-Serre-Ponçon;766;19;785
93;Provence-Alpes-Côte d'Azur;04;4;06;034;La Brillanne;1124;15;1139
93;Provence-Alpes-Côte d'Azur;04;4;15;035;Brunet;290;6;296
93;Provence-Alpes-Côte d'Azur;04;3;13;036;Le Brusquet;960;28;988
93;Provence-Alpes-Côte d'Azur;04;4;13;037;Le Caire;73;2;75
93;Provence-Alpes-Côte d'Azur;04;2;02;039;Castellane;1470;39;1509
93;Provence-Alpes-Côte d'Azur;04;3;04;040;Le Castellard-Mélan;63;1;64
93;Provence-Alpes-Côte d'Azur;04;4;12;041;Le Castellet;299;6;305
93;Provence-Alpes-Côte d'Azur;04;2;02;042;Castellet-lès-Sausses;138;1;139
93;Provence-Alpes-Côte d'Azur;04;2;02;043;Val-de-Chalvagne;86;3;89
93;Provence-Alpes-Côte d'Azur;04;4;11;045;Céreste;1206;21;1227
93;Provence-Alpes-Côte d'Azur;04;3;12;046;Le Chaffaut-Saint-Jurson;687;107;794
93;Provence-Alpes-Côte d'Azur;04;3;05;047;Champtercier;848;20;868
93;Provence-Alpes-Côte d'Azur;04;3;03;049;Château-Arnoux-Saint-Auban;5089;108;5197
93;Provence-Alpes-Côte d'Azur;04;4;13;050;Châteaufort;27;0;27
93;Provence-Alpes-Côte d'Azur;04;4;14;051;Châteauneuf-Miravail;72;2;74
93;Provence-Alpes-Côte d'Azur;04;4;03;053;Châteauneuf-Val-Saint-Donat;492;20;512
93;Provence-Alpes-Côte d'Azur;04;3;12;054;Châteauredon;74;1;75
93;Provence-Alpes-Côte d'Azur;04;2;12;055;Chaudon-Norante;188;0;188
93;Provence-Alpes-Côte d'Azur;04;4;13;057;Clamensane;176;3;179
93;Provence-Alpes-Côte d'Azur;04;4;13;058;Claret;272;6;278
93;Provence-Alpes-Côte d'Azur;04;2;12;059;Clumanc;220;1;221
93;Provence-Alpes-Côte d'Azur;04;2;02;061;Colmars;482;5;487
93;Provence-Alpes-Côte d'Azur;04;1;01;062;La Condamine-Châtelard;149;4;153
93;Provence-Alpes-Côte d'Azur;04;4;09;063;Corbières-en-Provence;1219;32;1251
93;Provence-Alpes-Côte d'Azur;04;4;06;065;Cruis;633;6;639
93;Provence-Alpes-Côte d'Azur;04;4;13;066;Curbans;571;12;583
93;Provence-Alpes-Côte d'Azur;04;4;14;067;Curel;52;1;53
93;Provence-Alpes-Côte d'Azur;04;4;11;068;Dauphin;836;14;850
93;Provence-Alpes-Côte d'Azur;04;2;02;069;Demandolx;135;3;138
93;Provence-Alpes-Côte d'Azur;04;3;98;070;Digne-les-Bains;16482;922;17404
93;Provence-Alpes-Côte d'Azur;04;3;13;072;Draix;110;2;112
93;Provence-Alpes-Côte d'Azur;04;1;01;073;Enchastrayes;388;12;400
93;Provence-Alpes-Côte d'Azur;04;3;04;074;Entrages;102;2;104
93;Provence-Alpes-Côte d'Azur;04;4;14;075;Entrepierres;372;11;383
93;Provence-Alpes-Côte d'Azur;04;2;02;076;Entrevaux;816;21;837
93;Provence-Alpes-Côte d'Azur;04;4;12;077;Entrevennes;172;3;175
93;Provence-Alpes-Côte d'Azur;04;3;03;079;L'Escale;1371;37;1408
93;Provence-Alpes-Côte d'Azur;04;4;15;081;Esparron-de-Verdon;392;4;396
93;Provence-Alpes-Côte d'Azur;04;3;12;084;Estoublon;493;7;500
93;Provence-Alpes-Côte d'Azur;04;4;13;085;Faucon-du-Caire;59;2;61
93;Provence-Alpes-Côte d'Azur;04;1;01;086;Faucon-de-Barcelonnette;303;17;320
93;Provence-Alpes-Côte d'Azur;04;4;06;087;Fontienne;133;2;135
93;Provence-Alpes-Côte d'Azur;04;4;06;088;Forcalquier;5121;88;5209
93;Provence-Alpes-Côte d'Azur;04;2;02;090;Le Fugeret;207;4;211
93;Provence-Alpes-Côte d'Azur;04;3;03;091;Ganagobie;92;0;92
93;Provence-Alpes-Côte d'Azur;04;2;02;092;La Garde;118;4;122
93;Provence-Alpes-Côte d'Azur;04;4;13;093;Gigors;62;1;63
93;Provence-Alpes-Côte d'Azur;04;4;15;094;Gréoux-les-Bains;2639;48;2687
93;Provence-Alpes-Côte d'Azur;04;4;11;095;L'Hospitalet;90;0;90
93;Provence-Alpes-Côte d'Azur;04;1;01;096;Jausiers;1132;26;1158
93;Provence-Alpes-Côte d'Azur;04;3;13;097;La Javie;385;5;390
93;Provence-Alpes-Côte d'Azur;04;2;02;099;Lambruisse;88;5;93
93;Provence-Alpes-Côte d'Azur;04;4;06;101;Lardiers;133;3;136
93;Provence-Alpes-Côte d'Azur;04;1;01;102;Le Lauzet-Ubaye;179;3;182
93;Provence-Alpes-Côte d'Azur;04;4;06;104;Limans;385;11;396
93;Provence-Alpes-Côte d'Azur;04;4;06;106;Lurs;380;10;390
93;Provence-Alpes-Côte d'Azur;04;3;12;107;Majastres;4;0;4
93;Provence-Alpes-Côte d'Azur;04;3;05;108;Malijai;1975;30;2005
93;Provence-Alpes-Côte d'Azur;04;3;06;109;Mallefougasse-Augès;322;4;326
93;Provence-Alpes-Côte d'Azur;04;3;05;110;Mallemoisson;1011;28;1039
93;Provence-Alpes-Côte d'Azur;04;4;11;111;Mane;1347;28;1375
93;Provence-Alpes-Côte d'Azur;04;4;99;112;Manosque;22528;669;23197
93;Provence-Alpes-Côte d'Azur;04;3;04;113;Marcoux;451;14;465
93;Provence-Alpes-Côte d'Azur;04;2;02;115;Méailles;121;2;123
93;Provence-Alpes-Côte d'Azur;04;3;10;116;Les Mées;3751;45;3796
93;Provence-Alpes-Côte d'Azur;04;4;13;118;Melve;123;1;124
93;Provence-Alpes-Côte d'Azur;04;1;01;120;Val d'Oronaye;118;1;119
93;Provence-Alpes-Côte d'Azur;04;3;12;121;Mézel;639;11;650
93;Provence-Alpes-Côte d'Azur;04;3;05;122;Mirabeau;511;10;521
93;Provence-Alpes-Côte d'Azur;04;4;14;123;Mison;1121;29;1150
93;Provence-Alpes-Côte d'Azur;04;4;15;124;Montagnac-Montpezat;417;6;423
93;Provence-Alpes-Côte d'Azur;04;3;13;126;Montclar;406;15;421
93;Provence-Alpes-Côte d'Azur;04;4;03;127;Montfort;322;3;325
93;Provence-Alpes-Côte d'Azur;04;4;07;128;Montfuron;221;9;230
93;Provence-Alpes-Côte d'Azur;04;4;11;129;Montjustin;59;1;60
93;Provence-Alpes-Côte d'Azur;04;4;06;130;Montlaux;203;2;205
93;Provence-Alpes-Côte d'Azur;04;4;11;132;Montsalier;144;1;145
93;Provence-Alpes-Côte d'Azur;04;2;02;133;Moriez;237;1;238
93;Provence-Alpes-Côte d'Azur;04;4;13;134;La Motte-du-Caire;553;20;573
93;Provence-Alpes-Côte d'Azur;04;3;12;135;Moustiers-Sainte-Marie;720;15;735
93;Provence-Alpes-Côte d'Azur;04;2;02;136;La Mure-Argens;313;8;321
93;Provence-Alpes-Côte d'Azur;04;4;13;137;Nibles;42;0;42
93;Provence-Alpes-Côte d'Azur;04;4;06;138;Niozelles;281;6;287
93;Provence-Alpes-Côte d'Azur;04;4;14;139;Noyers-sur-Jabron;523;9;532
93;Provence-Alpes-Côte d'Azur;04;4;14;140;Les Omergues;127;3;130
93;Provence-Alpes-Côte d'Azur;04;4;06;141;Ongles;365;9;374
93;Provence-Alpes-Côte d'Azur;04;4;11;142;Oppedette;54;0;54
93;Provence-Alpes-Côte d'Azur;04;4;10;143;Oraison;5867;74;5941
93;Provence-Alpes-Côte d'Azur;04;2;12;144;La Palud-sur-Verdon;353;1;354
93;Provence-Alpes-Côte d'Azur;04;4;14;145;Peipin;1448;37;1485
93;Provence-Alpes-Côte d'Azur;04;2;02;148;Peyroules;253;9;262
93;Provence-Alpes-Côte d'Azur;04;3;03;149;Peyruis;2813;43;2856
93;Provence-Alpes-Côte d'Azur;04;4;13;150;Piégut;202;4;206
93;Provence-Alpes-Côte d'Azur;04;4;06;151;Pierrerue;520;13;533
93;Provence-Alpes-Côte d'Azur;04;4;07;152;Pierrevert;3905;126;4031
93;Provence-Alpes-Côte d'Azur;04;1;01;154;Pontis;92;1;93
93;Provence-Alpes-Côte d'Azur;04;3;13;155;Prads-Haute-Bléone;179;1;180
93;Provence-Alpes-Côte d'Azur;04;4;12;156;Puimichel;264;1;265
93;Provence-Alpes-Côte d'Azur;04;4;12;157;Puimoisson;691;8;699
93;Provence-Alpes-Côte d'Azur;04;4;15;158;Quinson;407;8;415
93;Provence-Alpes-Côte d'Azur;04;4;11;159;Redortiers;85;5;90
93;Provence-Alpes-Côte d'Azur;04;4;11;160;Reillanne;1680;37;1717
93;Provence-Alpes-Côte d'Azur;04;1;01;161;Méolans-Revel;329;8;337
93;Provence-Alpes-Côte d'Azur;04;4;11;162;Revest-des-Brousses;258;6;264
93;Provence-Alpes-Côte d'Azur;04;4;11;163;Revest-du-Bion;525;11;536
93;Provence-Alpes-Côte d'Azur;04;4;06;164;Revest-Saint-Martin;88;1;89
93;Provence-Alpes-Côte d'Azur;04;4;12;166;Riez;1726;39;1765
93;Provence-Alpes-Côte d'Azur;04;3;04;167;La Robine-sur-Galabre;288;5;293
93;Provence-Alpes-Côte d'Azur;04;4;11;169;La Rochegiron;104;3;107
93;Provence-Alpes-Côte d'Azur;04;2;02;170;La Rochette;75;0;75
93;Provence-Alpes-Côte d'Azur;04;2;02;171;Rougon;121;0;121
93;Provence-Alpes-Côte d'Azur;04;4;12;172;Roumoules;738;10;748
93;Provence-Alpes-Côte d'Azur;04;2;02;173;Saint-André-les-Alpes;1010;21;1031
93;Provence-Alpes-Côte d'Azur;04;2;02;174;Saint-Benoît;145;2;147
93;Provence-Alpes-Côte d'Azur;04;4;11;175;Sainte-Croix-à-Lauze;91;1;92
93;Provence-Alpes-Côte d'Azur;04;3;15;176;Sainte-Croix-du-Verdon;119;4;123
93;Provence-Alpes-Côte d'Azur;04;3;04;177;Hautes-Duyes;45;0;45
93;Provence-Alpes-Côte d'Azur;04;4;06;178;Saint-Étienne-les-Orgues;1319;35;1354
93;Provence-Alpes-Côte d'Azur;04;4;14;179;Saint-Geniez;105;2;107
93;Provence-Alpes-Côte d'Azur;04;2;12;180;Saint-Jacques;79;4;83
93;Provence-Alpes-Côte d'Azur;04;3;12;181;Saint-Jeannet;48;1;49
93;Provence-Alpes-Côte d'Azur;04;3;12;182;Saint-Julien-d'Asse;215;2;217
93;Provence-Alpes-Côte d'Azur;04;2;02;183;Saint-Julien-du-Verdon;142;3;145
93;Provence-Alpes-Côte d'Azur;04;3;12;184;Saint-Jurs;136;3;139
93;Provence-Alpes-Côte d'Azur;04;4;15;186;Saint-Laurent-du-Verdon;99;4;103
93;Provence-Alpes-Côte d'Azur;04;2;12;187;Saint-Lions;41;1;42
93;Provence-Alpes-Côte d'Azur;04;4;11;188;Saint-Maime;867;8;875
93;Provence-Alpes-Côte d'Azur;04;4;15;189;Saint-Martin-de-Brômes;627;14;641
93;Provence-Alpes-Côte d'Azur;04;4;08;190;Saint-Martin-les-Eaux;114;3;117
93;Provence-Alpes-Côte d'Azur;04;3;13;191;Saint-Martin-lès-Seyne;13;2;15
93;Provence-Alpes-Côte d'Azur;04;4;11;192;Saint-Michel-l'Observatoire;1235;24;1259
93;Provence-Alpes-Côte d'Azur;04;1;01;193;Saint-Paul-sur-Ubaye;180;7;187
93;Provence-Alpes-Côte d'Azur;04;2;02;194;Saint-Pierre;96;2;98
93;Provence-Alpes-Côte d'Azur;04;1;01;195;Saint-Pons;597;13;610
93;Provence-Alpes-Côte d'Azur;04;4;09;197;Sainte-Tulle;3442;78;3520
93;Provence-Alpes-Côte d'Azur;04;4;14;199;Saint-Vincent-sur-Jabron;177;4;181
93;Provence-Alpes-Côte d'Azur;04;4;14;200;Salignac;640;21;661
93;Provence-Alpes-Côte d'Azur;04;4;11;201;Saumane;122;3;125
93;Provence-Alpes-Côte d'Azur;04;2;02;202;Sausses;132;2;134
93;Provence-Alpes-Côte d'Azur;04;3;13;203;Selonnet;475;9;484
93;Provence-Alpes-Côte d'Azur;04;2;12;204;Senez;163;4;167
93;Provence-Alpes-Côte d'Azur;04;3;13;205;Seyne;1379;27;1406
93;Provence-Alpes-Côte d'Azur;04;4;06;206;Sigonce;425;8;433
93;Provence-Alpes-Côte d'Azur;04;4;13;207;Sigoyer;103;4;107
93;Provence-Alpes-Côte d'Azur;04;4;11;208;Simiane-la-Rotonde;602;16;618
93;Provence-Alpes-Côte d'Azur;04;4;14;209;Sisteron;7595;239;7834
93;Provence-Alpes-Côte d'Azur;04;2;02;210;Soleilhas;89;4;93
93;Provence-Alpes-Côte d'Azur;04;4;14;211;Sourribes;178;3;181
93;Provence-Alpes-Côte d'Azur;04;2;12;214;Tartonne;130;1;131
93;Provence-Alpes-Côte d'Azur;04;4;13;216;Thèze;234;5;239
93;Provence-Alpes-Côte d'Azur;04;3;04;217;Thoard;748;19;767
93;Provence-Alpes-Côte d'Azur;04;2;02;218;Thorame-Basse;231;3;234
93;Provence-Alpes-Côte d'Azur;04;2;02;219;Thorame-Haute;244;6;250
93;Provence-Alpes-Côte d'Azur;04;1;01;220;Les Thuiles;379;11;390
93;Provence-Alpes-Côte d'Azur;04;4;13;222;Turriers;335;8;343
93;Provence-Alpes-Côte d'Azur;04;2;02;224;Ubraye;100;1;101
93;Provence-Alpes-Côte d'Azur;04;1;01;226;Uvernet-Fours;594;14;608
93;Provence-Alpes-Côte d'Azur;04;4;11;227;Vachères;287;7;294
93;Provence-Alpes-Côte d'Azur;04;4;13;228;Valavoire;39;0;39
93;Provence-Alpes-Côte d'Azur;04;4;14;229;Valbelle;252;5;257
93;Provence-Alpes-Côte d'Azur;04;4;15;230;Valensole;3173;62;3235
93;Provence-Alpes-Côte d'Azur;04;4;13;231;Valernes;245;6;251
93;Provence-Alpes-Côte d'Azur;04;4;13;233;Vaumeilh;268;8;276
93;Provence-Alpes-Côte d'Azur;04;4;13;234;Venterol;226;2;228
93;Provence-Alpes-Côte d'Azur;04;3;13;235;Verdaches;61;1;62
93;Provence-Alpes-Côte d'Azur;04;2;02;236;Vergons;108;0;108
93;Provence-Alpes-Côte d'Azur;04;3;13;237;Le Vernet;126;3;129
93;Provence-Alpes-Côte d'Azur;04;2;02;240;Villars-Colmars;249;5;254
93;Provence-Alpes-Côte d'Azur;04;4;11;241;Villemus;192;5;197
93;Provence-Alpes-Côte d'Azur;04;4;10;242;Villeneuve;4323;78;4401
93;Provence-Alpes-Côte d'Azur;04;3;03;244;Volonne;1641;37;1678
93;Provence-Alpes-Côte d'Azur;04;4;08;245;Volx;3206;75;3281
93;Provence-Alpes-Côte d'Azur;05;1;10;001;Abriès-Ristolas;383;6;389
93;Provence-Alpes-Côte d'Azur;05;1;10;003;Aiguilles;397;11;408
93;Provence-Alpes-Côte d'Azur;05;2;12;004;Ancelle;917;15;932
93;Provence-Alpes-Côte d'Azur;05;1;01;006;L'Argentière-la-Bessée;2255;86;2341
93;Provence-Alpes-Côte d'Azur;05;1;10;007;Arvieux;358;8;366
93;Provence-Alpes-Côte d'Azur;05;2;13;008;Aspremont;369;5;374
93;Provence-Alpes-Côte d'Azur;05;2;12;009;Aspres-lès-Corps;99;3;102
93;Provence-Alpes-Côte d'Azur;05;2;13;010;Aspres-sur-Buëch;803;12;815
93;Provence-Alpes-Côte d'Azur;05;2;14;011;Avançon;419;9;428
93;Provence-Alpes-Côte d'Azur;05;2;05;012;Baratier;620;14;634
93;Provence-Alpes-Côte d'Azur;05;2;14;013;Barcillonnette;127;5;132
93;Provence-Alpes-Côte d'Azur;05;2;11;014;Barret-sur-Méouge;180;2;182
93;Provence-Alpes-Côte d'Azur;05;2;13;016;La Bâtie-Montsaléon;256;2;258
93;Provence-Alpes-Côte d'Azur;05;2;04;017;La Bâtie-Neuve;2562;57;2619
93;Provence-Alpes-Côte d'Azur;05;2;14;018;La Bâtie-Vieille;325;10;335
93;Provence-Alpes-Côte d'Azur;05;2;13;019;La Beaume;150;4;154
93;Provence-Alpes-Côte d'Azur;05;2;13;021;Le Bersac;142;1;143
93;Provence-Alpes-Côte d'Azur;05;2;04;022;Bréziers;239;3;242
93;Provence-Alpes-Côte d'Azur;05;1;98;023;Briançon;11339;320;11659
93;Provence-Alpes-Côte d'Azur;05;2;13;024;Valdoule;220;8;228
93;Provence-Alpes-Côte d'Azur;05;2;12;025;Buissard;215;7;222
93;Provence-Alpes-Côte d'Azur;05;1;10;026;Ceillac;285;3;288
93;Provence-Alpes-Côte d'Azur;05;1;02;027;Cervières;199;4;203
93;Provence-Alpes-Côte d'Azur;05;2;13;028;Chabestan;155;4;159
93;Provence-Alpes-Côte d'Azur;05;2;12;029;Chabottes;887;25;912
93;Provence-Alpes-Côte d'Azur;05;1;01;031;Champcella;188;1;189
93;Provence-Alpes-Côte d'Azur;05;2;12;032;Champoléon;136;3;139
93;Provence-Alpes-Côte d'Azur;05;2;13;033;Chanousse;40;0;40
93;Provence-Alpes-Côte d'Azur;05;2;15;035;Châteauneuf-d'Oze;30;3;33
93;Provence-Alpes-Côte d'Azur;05;2;05;036;Châteauroux-les-Alpes;1198;34;1232
93;Provence-Alpes-Côte d'Azur;05;2;14;037;Châteauvieux;506;20;526
93;Provence-Alpes-Côte d'Azur;05;1;10;038;Château-Ville-Vieille;319;17;336
93;Provence-Alpes-Côte d'Azur;05;2;12;039;Aubessagne;705;12;717
93;Provence-Alpes-Côte d'Azur;05;2;04;040;Chorges;3061;80;3141
93;Provence-Alpes-Côte d'Azur;05;2;05;044;Crévoux;127;3;130
93;Provence-Alpes-Côte d'Azur;05;2;05;045;Crots;1105;32;1137
93;Provence-Alpes-Côte d'Azur;05;2;05;046;Embrun;6335;378;6713
93;Provence-Alpes-Côte d'Azur;05;2;11;047;Éourres;125;4;129
93;Provence-Alpes-Côte d'Azur;05;2;13;048;L'Épine;203;6;209
93;Provence-Alpes-Côte d'Azur;05;2;14;049;Esparron;57;0;57
93;Provence-Alpes-Côte d'Azur;05;2;04;050;Espinasses;821;9;830
93;Provence-Alpes-Côte d'Azur;05;2;13;051;Étoile-Saint-Cyrice;29;1;30
93;Provence-Alpes-Côte d'Azur;05;1;10;052;Eygliers;805;12;817
93;Provence-Alpes-Côte d'Azur;05;2;13;053;Garde-Colombe;520;11;531
93;Provence-Alpes-Côte d'Azur;05;2;12;054;La Fare-en-Champsaur;433;4;437
93;Provence-Alpes-Côte d'Azur;05;2;13;055;La Faurie;328;4;332
93;Provence-Alpes-Côte d'Azur;05;2;12;056;Forest-Saint-Julien;334;11;345
93;Provence-Alpes-Côte d'Azur;05;2;14;057;Fouillouse;255;6;261
93;Provence-Alpes-Côte d'Azur;05;1;01;058;Freissinières;217;5;222
93;Provence-Alpes-Côte d'Azur;05;2;14;059;La Freissinouse;904;19;923
93;Provence-Alpes-Côte d'Azur;05;2;15;060;Furmeyer;179;8;187
93;Provence-Alpes-Côte d'Azur;05;2;99;061;Gap;40631;1545;42176
93;Provence-Alpes-Côte d'Azur;05;2;12;062;Le Glaizil;160;1;161
93;Provence-Alpes-Côte d'Azur;05;1;02;063;La Grave;479;10;489
93;Provence-Alpes-Côte d'Azur;05;2;12;064;La Chapelle-en-Valgaudémar;105;3;108
93;Provence-Alpes-Côte d'Azur;05;1;10;065;Guillestre;2312;85;2397
93;Provence-Alpes-Côte d'Azur;05;2;13;066;La Haute-Beaume;8;0;8
93;Provence-Alpes-Côte d'Azur;05;2;14;068;Jarjayes;460;13;473
93;Provence-Alpes-Côte d'Azur;05;2;11;070;Laragne-Montéglin;3543;51;3594
93;Provence-Alpes-Côte d'Azur;05;2;14;071;Lardier-et-Valença;338;19;357
93;Provence-Alpes-Côte d'Azur;05;2;12;072;Laye;243;7;250
93;Provence-Alpes-Côte d'Azur;05;2;11;073;Lazer;342;13;355
93;Provence-Alpes-Côte d'Azur;05;2;14;074;Lettret;191;0;191
93;Provence-Alpes-Côte d'Azur;05;2;15;075;Manteyer;427;7;434
93;Provence-Alpes-Côte d'Azur;05;2;13;076;Méreuil;86;3;89
93;Provence-Alpes-Côte d'Azur;05;1;10;077;Molines-en-Queyras;297;5;302
93;Provence-Alpes-Côte d'Azur;05;2;11;078;Monêtier-Allemont;284;10;294
93;Provence-Alpes-Côte d'Azur;05;1;02;079;Le Monêtier-les-Bains;1060;23;1083
93;Provence-Alpes-Côte d'Azur;05;2;13;080;Montbrand;58;0;58
93;Provence-Alpes-Côte d'Azur;05;2;13;081;Montclus;52;4;56
93;Provence-Alpes-Côte d'Azur;05;1;10;082;Mont-Dauphin;173;2;175
93;Provence-Alpes-Côte d'Azur;05;2;04;084;Montgardin;457;6;463
93;Provence-Alpes-Côte d'Azur;05;1;03;085;Montgenèvre;454;14;468
93;Provence-Alpes-Côte d'Azur;05;2;13;086;Montjay;104;2;106
93;Provence-Alpes-Côte d'Azur;05;2;15;087;Montmaur;529;14;543
93;Provence-Alpes-Côte d'Azur;05;2;13;089;Montrond;84;1;85
93;Provence-Alpes-Côte d'Azur;05;2;12;090;La Motte-en-Champsaur;212;8;220
93;Provence-Alpes-Côte d'Azur;05;2;13;091;Moydans;41;3;44
93;Provence-Alpes-Côte d'Azur;05;2;14;092;Neffes;763;15;778
93;Provence-Alpes-Côte d'Azur;05;1;03;093;Névache;359;10;369
93;Provence-Alpes-Côte d'Azur;05;2;13;094;Nossage-et-Bénévent;15;1;16
93;Provence-Alpes-Côte d'Azur;05;2;12;095;Le Noyer;301;2;303
93;Provence-Alpes-Côte d'Azur;05;2;12;096;Orcières;674;18;692
93;Provence-Alpes-Côte d'Azur;05;2;13;097;Orpierre;356;35;391
93;Provence-Alpes-Côte d'Azur;05;2;05;098;Les Orres;543;13;556
93;Provence-Alpes-Côte d'Azur;05;2;13;099;Oze;104;1;105
93;Provence-Alpes-Côte d'Azur;05;2;14;100;Pelleautier;763;29;792
93;Provence-Alpes-Côte d'Azur;05;1;01;101;Vallouise-Pelvoux;1154;40;1194
93;Provence-Alpes-Côte d'Azur;05;2;13;102;La Piarre;93;2;95
93;Provence-Alpes-Côte d'Azur;05;2;11;103;Le Poët;777;21;798
93;Provence-Alpes-Côte d'Azur;05;2;12;104;Poligny;323;16;339
93;Provence-Alpes-Côte d'Azur;05;2;04;106;Prunières;299;7;306
93;Provence-Alpes-Côte d'Azur;05;1;02;107;Puy-Saint-André;453;23;476
93;Provence-Alpes-Côte d'Azur;05;2;04;108;Puy-Saint-Eusèbe;167;5;172
93;Provence-Alpes-Côte d'Azur;05;1;02;109;Puy-Saint-Pierre;524;20;544
93;Provence-Alpes-Côte d'Azur;05;1;01;110;Puy-Saint-Vincent;301;5;306
93;Provence-Alpes-Côte d'Azur;05;2;04;111;Puy-Sanières;273;9;282
93;Provence-Alpes-Côte d'Azur;05;2;15;112;Rabou;87;0;87
93;Provence-Alpes-Côte d'Azur;05;2;14;113;Rambaud;378;17;395
93;Provence-Alpes-Côte d'Azur;05;2;04;114;Réallon;251;1;252
93;Provence-Alpes-Côte d'Azur;05;2;04;115;Remollon;453;9;462
93;Provence-Alpes-Côte d'Azur;05;1;10;116;Réotier;209;2;211
93;Provence-Alpes-Côte d'Azur;05;2;13;117;Ribeyret;114;0;114
93;Provence-Alpes-Côte d'Azur;05;2;11;118;Val Buëch-Méouge;1340;28;1368
93;Provence-Alpes-Côte d'Azur;05;1;10;119;Risoul;655;18;673
93;Provence-Alpes-Côte d'Azur;05;2;04;121;Rochebrune;175;4;179
93;Provence-Alpes-Côte d'Azur;05;1;01;122;La Roche-de-Rame;808;27;835
93;Provence-Alpes-Côte d'Azur;05;2;15;123;La Roche-des-Arnauds;1528;38;1566
93;Provence-Alpes-Côte d'Azur;05;2;04;124;La Rochette;474;9;483
93;Provence-Alpes-Côte d'Azur;05;2;13;126;Rosans;469;9;478
93;Provence-Alpes-Côte d'Azur;05;2;04;127;Rousset;181;7;188
93;Provence-Alpes-Côte d'Azur;05;2;05;128;Saint-André-d'Embrun;692;22;714
93;Provence-Alpes-Côte d'Azur;05;2;13;129;Saint-André-de-Rosans;152;2;154
93;Provence-Alpes-Côte d'Azur;05;2;04;130;Saint-Apollinaire;178;5;183
93;Provence-Alpes-Côte d'Azur;05;2;13;131;Saint-Auban-d'Oze;81;4;85
93;Provence-Alpes-Côte d'Azur;05;2;12;132;Saint-Bonnet-en-Champsaur;2063;75;2138
93;Provence-Alpes-Côte d'Azur;05;1;02;133;Saint-Chaffrey;1531;45;1576
93;Provence-Alpes-Côte d'Azur;05;1;10;134;Saint-Clément-sur-Durance;318;5;323
93;Provence-Alpes-Côte d'Azur;05;2;13;135;Sainte-Colombe;51;0;51
93;Provence-Alpes-Côte d'Azur;05;1;10;136;Saint-Crépin;737;15;752
93;Provence-Alpes-Côte d'Azur;05;2;15;139;Dévoluy;916;27;943
93;Provence-Alpes-Côte d'Azur;05;2;14;140;Saint-Étienne-le-Laus;286;7;293
93;Provence-Alpes-Côte d'Azur;05;2;12;142;Saint-Firmin;443;17;460
93;Provence-Alpes-Côte d'Azur;05;2;12;144;Saint-Jacques-en-Valgodemard;144;2;146
93;Provence-Alpes-Côte d'Azur;05;2;12;145;Saint-Jean-Saint-Nicolas;1075;93;1168
93;Provence-Alpes-Côte d'Azur;05;2;13;146;Saint-Julien-en-Beauchêne;136;1;137
93;Provence-Alpes-Côte d'Azur;05;2;12;147;Saint-Julien-en-Champsaur;365;5;370
93;Provence-Alpes-Côte d'Azur;05;2;12;148;Saint-Laurent-du-Cros;535;18;553
93;Provence-Alpes-Côte d'Azur;05;2;12;149;Saint-Léger-les-Mélèzes;362;11;373
93;Provence-Alpes-Côte d'Azur;05;1;01;151;Saint-Martin-de-Queyrières;1128;37;1165
93;Provence-Alpes-Côte d'Azur;05;2;12;152;Saint-Maurice-en-Valgodemard;126;4;130
93;Provence-Alpes-Côte d'Azur;05;2;12;153;Saint-Michel-de-Chaillol;352;13;365
93;Provence-Alpes-Côte d'Azur;05;2;13;154;Saint-Pierre-d'Argençon;162;0;162
93;Provence-Alpes-Côte d'Azur;05;2;11;155;Saint-Pierre-Avez;30;1;31
93;Provence-Alpes-Côte d'Azur;05;2;05;156;Saint-Sauveur;516;11;527
93;Provence-Alpes-Côte d'Azur;05;1;10;157;Saint-Véran;192;6;198
93;Provence-Alpes-Côte d'Azur;05;2;13;158;Le Saix;117;1;118
93;Provence-Alpes-Côte d'Azur;05;2;13;159;Saléon;87;3;90
93;Provence-Alpes-Côte d'Azur;05;2;11;160;Salérans;85;0;85
93;Provence-Alpes-Côte d'Azur;05;1;02;161;La Salle-les-Alpes;935;23;958
93;Provence-Alpes-Côte d'Azur;05;2;14;162;La Saulce;1443;36;1479
93;Provence-Alpes-Côte d'Azur;05;2;04;163;Le Sauze-du-Lac;144;4;148
93;Provence-Alpes-Côte d'Azur;05;2;04;164;Savines-le-Lac;1076;42;1118
93;Provence-Alpes-Côte d'Azur;05;2;13;165;Savournon;252;7;259
93;Provence-Alpes-Côte d'Azur;05;2;13;166;Serres;1285;27;1312
93;Provence-Alpes-Côte d'Azur;05;2;13;167;Sigottier;87;2;89
93;Provence-Alpes-Côte d'Azur;05;2;14;168;Sigoyer;708;21;729
93;Provence-Alpes-Côte d'Azur;05;2;13;169;Sorbiers;35;1;36
93;Provence-Alpes-Côte d'Azur;05;2;14;170;Tallard;2285;52;2337
93;Provence-Alpes-Côte d'Azur;05;2;04;171;Théus;214;4;218
93;Provence-Alpes-Côte d'Azur;05;2;13;172;Trescléoux;310;5;315
93;Provence-Alpes-Côte d'Azur;05;2;11;173;Upaix;457;10;467
93;Provence-Alpes-Côte d'Azur;05;1;03;174;Val-des-Prés;615;22;637
93;Provence-Alpes-Côte d'Azur;05;2;14;176;Valserres;267;4;271
93;Provence-Alpes-Côte d'Azur;05;1;10;177;Vars;528;9;537
93;Provence-Alpes-Côte d'Azur;05;2;11;178;Ventavon;584;40;624
93;Provence-Alpes-Côte d'Azur;05;2;15;179;Veynes;3216;144;3360
93;Provence-Alpes-Côte d'Azur;05;1;01;180;Les Vigneaux;542;14;556
93;Provence-Alpes-Côte d'Azur;05;1;02;181;Villar-d'Arêne;294;13;307
93;Provence-Alpes-Côte d'Azur;05;2;12;182;Villar-Loubière;42;3;45
93;Provence-Alpes-Côte d'Azur;05;1;02;183;Villar-Saint-Pancrace;1477;53;1530
93;Provence-Alpes-Côte d'Azur;05;2;14;184;Vitrolles;209;8;217
93;Provence-Alpes-Côte d'Azur;06;1;26;001;Aiglun;94;0;94
93;Provence-Alpes-Côte d'Azur;06;1;11;002;Amirat;54;0;54
93;Provence-Alpes-Côte d'Azur;06;1;11;003;Andon;648;5;653
93;Provence-Alpes-Côte d'Azur;06;1;94;004;Antibes;73438;1085;74523
93;Provence-Alpes-Côte d'Azur;06;2;26;005;Ascros;175;0;175
93;Provence-Alpes-Côte d'Azur;06;2;24;006;Aspremont;2272;32;2304
93;Provence-Alpes-Côte d'Azur;06;1;13;007;Auribeau-sur-Siagne;3200;68;3268
93;Provence-Alpes-Côte d'Azur;06;2;26;008;Auvare;31;2;33
93;Provence-Alpes-Côte d'Azur;06;2;26;009;Bairols;109;1;110
93;Provence-Alpes-Côte d'Azur;06;1;25;010;Le Bar-sur-Loup;2921;63;2984
93;Provence-Alpes-Côte d'Azur;06;2;04;011;Beaulieu-sur-Mer;3755;28;3783
93;Provence-Alpes-Côte d'Azur;06;2;04;012;Beausoleil;13358;130;13488
93;Provence-Alpes-Côte d'Azur;06;2;24;013;Belvédère;690;11;701
93;Provence-Alpes-Côte d'Azur;06;2;10;014;Bendejun;947;6;953
93;Provence-Alpes-Côte d'Azur;06;2;10;015;Berre-les-Alpes;1240;21;1261
93;Provence-Alpes-Côte d'Azur;06;2;26;016;Beuil;551;4;555
93;Provence-Alpes-Côte d'Azur;06;1;26;017;Bézaudun-les-Alpes;254;4;258
93;Provence-Alpes-Côte d'Azur;06;1;03;018;Biot;9668;351;10019
93;Provence-Alpes-Côte d'Azur;06;2;10;019;Blausasc;1657;19;1676
93;Provence-Alpes-Côte d'Azur;06;2;24;020;La Bollène-Vésubie;566;11;577
93;Provence-Alpes-Côte d'Azur;06;2;26;021;Bonson;731;4;735
93;Provence-Alpes-Côte d'Azur;06;1;26;022;Bouyon;554;6;560
93;Provence-Alpes-Côte d'Azur;06;2;10;023;Breil-sur-Roya;2137;52;2189
93;Provence-Alpes-Côte d'Azur;06;1;11;024;Briançonnet;217;2;219
93;Provence-Alpes-Côte d'Azur;06;1;17;025;Le Broc;1414;7;1421
93;Provence-Alpes-Côte d'Azur;06;1;11;026;Cabris;1380;27;1407
93;Provence-Alpes-Côte d'Azur;06;1;95;027;Cagnes-sur-Mer;52178;491;52669
93;Provence-Alpes-Côte d'Azur;06;1;11;028;Caille;411;4;415
93;Provence-Alpes-Côte d'Azur;06;1;96;029;Cannes;74545;802;75347
93;Provence-Alpes-Côte d'Azur;06;1;97;030;Le Cannet;41887;359;42246
93;Provence-Alpes-Côte d'Azur;06;2;10;031;Cantaron;1300;11;1311
93;Provence-Alpes-Côte d'Azur;06;2;04;032;Cap-d'Ail;4523;68;4591
93;Provence-Alpes-Côte d'Azur;06;1;17;033;Carros;12550;136;12686
93;Provence-Alpes-Côte d'Azur;06;2;24;034;Castagniers;1656;15;1671
93;Provence-Alpes-Côte d'Azur;06;2;14;035;Castellar;1126;9;1135
93;Provence-Alpes-Côte d'Azur;06;2;14;036;Castillon;400;4;404
93;Provence-Alpes-Côte d'Azur;06;1;25;037;Caussols;298;3;301
93;Provence-Alpes-Côte d'Azur;06;1;25;038;Châteauneuf-Grasse;3664;59;3723
93;Provence-Alpes-Côte d'Azur;06;2;10;039;Châteauneuf-Villevieille;942;8;950
93;Provence-Alpes-Côte d'Azur;06;2;26;040;Châteauneuf-d'Entraunes;63;0;63
93;Provence-Alpes-Côte d'Azur;06;1;25;041;Cipières;401;6;407
93;Provence-Alpes-Côte d'Azur;06;2;24;042;Clans;665;12;677
93;Provence-Alpes-Côte d'Azur;06;2;10;043;Coaraze;822;4;826
93;Provence-Alpes-Côte d'Azur;06;1;27;044;La Colle-sur-Loup;7898;157;8055
93;Provence-Alpes-Côte d'Azur;06;1;11;045;Collongues;73;2;75
93;Provence-Alpes-Côte d'Azur;06;2;24;046;Colomars;3482;41;3523
93;Provence-Alpes-Côte d'Azur;06;1;26;047;Conségudes;95;1;96
93;Provence-Alpes-Côte d'Azur;06;2;10;048;Contes;7437;81;7518
93;Provence-Alpes-Côte d'Azur;06;1;25;049;Courmes;110;2;112
93;Provence-Alpes-Côte d'Azur;06;1;26;050;Coursegoules;531;6;537
93;Provence-Alpes-Côte d'Azur;06;2;26;051;La Croix-sur-Roudoule;98;2;100
93;Provence-Alpes-Côte d'Azur;06;2;26;052;Cuébris;179;2;181
93;Provence-Alpes-Côte d'Azur;06;2;26;053;Daluis;143;1;144
93;Provence-Alpes-Côte d'Azur;06;2;10;054;Drap;5117;40;5157
93;Provence-Alpes-Côte d'Azur;06;2;24;055;Duranus;150;3;153
93;Provence-Alpes-Côte d'Azur;06;2;26;056;Entraunes;142;2;144
93;Provence-Alpes-Côte d'Azur;06;2;10;057;L'Escarène;2554;18;2572
93;Provence-Alpes-Côte d'Azur;06;1;11;058;Escragnolles;611;15;626
93;Provence-Alpes-Côte d'Azur;06;2;04;059;Èze;2256;60;2316
93;Provence-Alpes-Côte d'Azur;06;2;24;060;Falicon;1994;34;2028
93;Provence-Alpes-Côte d'Azur;06;1;26;061;Les Ferres;96;3;99
93;Provence-Alpes-Côte d'Azur;06;2;10;062;Fontan;317;1;318
93;Provence-Alpes-Côte d'Azur;06;1;11;063;Gars;73;0;73
93;Provence-Alpes-Côte d'Azur;06;1;17;064;Gattières;4173;56;4229
93;Provence-Alpes-Côte d'Azur;06;1;06;065;La Gaude;7010;105;7115
93;Provence-Alpes-Côte d'Azur;06;2;26;066;Gilette;1599;11;1610
93;Provence-Alpes-Côte d'Azur;06;2;14;067;Gorbio;1493;13;1506
93;Provence-Alpes-Côte d'Azur;06;1;25;068;Gourdon;373;10;383
93;Provence-Alpes-Côte d'Azur;06;1;98;069;Grasse;48870;922;49792
93;Provence-Alpes-Côte d'Azur;06;1;25;070;Gréolières;570;13;583
93;Provence-Alpes-Côte d'Azur;06;2;26;071;Guillaumes;600;7;607
93;Provence-Alpes-Côte d'Azur;06;2;24;072;Ilonse;162;1;163
93;Provence-Alpes-Côte d'Azur;06;2;24;073;Isola;653;12;665
93;Provence-Alpes-Côte d'Azur;06;2;24;074;Lantosque;1241;10;1251
93;Provence-Alpes-Côte d'Azur;06;2;24;075;Levens;4761;46;4807
93;Provence-Alpes-Côte d'Azur;06;2;26;076;Lieuche;47;3;50
93;Provence-Alpes-Côte d'Azur;06;2;10;077;Lucéram;1294;12;1306
93;Provence-Alpes-Côte d'Azur;06;2;26;078;Malaussène;321;7;328
93;Provence-Alpes-Côte d'Azur;06;1;13;079;Mandelieu-la-Napoule;21998;283;22281
93;Provence-Alpes-Côte d'Azur;06;2;24;080;Marie;106;4;110
93;Provence-Alpes-Côte d'Azur;06;1;11;081;Le Mas;118;2;120
93;Provence-Alpes-Côte d'Azur;06;2;26;082;Massoins;103;1;104
93;Provence-Alpes-Côte d'Azur;06;2;14;083;Menton;30525;456;30981
93;Provence-Alpes-Côte d'Azur;06;1;12;084;Mouans-Sartoux;9887;282;10169
93;Provence-Alpes-Côte d'Azur;06;1;09;085;Mougins;19982;439;20421
93;Provence-Alpes-Côte d'Azur;06;2;10;086;Moulinet;251;2;253
93;Provence-Alpes-Côte d'Azur;06;1;11;087;Les Mujouls;44;0;44
93;Provence-Alpes-Côte d'Azur;06;2;99;088;Nice;342669;2859;345528
93;Provence-Alpes-Côte d'Azur;06;1;25;089;Opio;2295;74;2369
93;Provence-Alpes-Côte d'Azur;06;1;13;090;Pégomas;7996;89;8085
93;Provence-Alpes-Côte d'Azur;06;2;10;091;Peille;2370;18;2388
93;Provence-Alpes-Côte d'Azur;06;2;10;092;Peillon;1465;13;1478
93;Provence-Alpes-Côte d'Azur;06;2;26;093;La Penne;206;1;207
93;Provence-Alpes-Côte d'Azur;06;2;26;094;Péone;783;9;792
93;Provence-Alpes-Côte d'Azur;06;1;11;095;Peymeinade;8192;187;8379
93;Provence-Alpes-Côte d'Azur;06;2;26;096;Pierlas;105;0;105
93;Provence-Alpes-Côte d'Azur;06;2;26;097;Pierrefeu;335;0;335
93;Provence-Alpes-Côte d'Azur;06;2;26;098;Puget-Rostang;126;1;127
93;Provence-Alpes-Côte d'Azur;06;2;26;099;Puget-Théniers;1840;81;1921
93;Provence-Alpes-Côte d'Azur;06;2;26;100;Revest-les-Roches;231;0;231
93;Provence-Alpes-Côte d'Azur;06;2;26;101;Rigaud;184;2;186
93;Provence-Alpes-Côte d'Azur;06;2;24;102;Rimplas;91;5;96
93;Provence-Alpes-Côte d'Azur;06;2;24;103;Roquebillière;1833;49;1882
93;Provence-Alpes-Côte d'Azur;06;2;14;104;Roquebrune-Cap-Martin;12839;202;13041
93;Provence-Alpes-Côte d'Azur;06;1;27;105;Roquefort-les-Pins;7183;195;7378
93;Provence-Alpes-Côte d'Azur;06;2;26;106;Roquestéron;577;8;585
93;Provence-Alpes-Côte d'Azur;06;1;26;107;La Roque-en-Provence;68;1;69
93;Provence-Alpes-Côte d'Azur;06;1;13;108;La Roquette-sur-Siagne;5385;94;5479
93;Provence-Alpes-Côte d'Azur;06;2;24;109;La Roquette-sur-Var;950;4;954
93;Provence-Alpes-Côte d'Azur;06;2;24;110;Roubion;120;3;123
93;Provence-Alpes-Côte d'Azur;06;2;24;111;Roure;119;4;123
93;Provence-Alpes-Côte d'Azur;06;1;25;112;Le Rouret;4072;122;4194
93;Provence-Alpes-Côte d'Azur;06;2;14;113;Sainte-Agnès;1338;22;1360
93;Provence-Alpes-Côte d'Azur;06;2;21;114;Saint-André-de-la-Roche;5695;29;5724
93;Provence-Alpes-Côte d'Azur;06;2;26;115;Saint-Antonin;87;0;87
93;Provence-Alpes-Côte d'Azur;06;1;11;116;Saint-Auban;215;3;218
93;Provence-Alpes-Côte d'Azur;06;2;24;117;Saint-Blaise;1240;9;1249
93;Provence-Alpes-Côte d'Azur;06;1;11;118;Saint-Cézaire-sur-Siagne;3903;100;4003
93;Provence-Alpes-Côte d'Azur;06;2;24;119;Saint-Dalmas-le-Selvage;108;2;110
93;Provence-Alpes-Côte d'Azur;06;2;24;120;Saint-Étienne-de-Tinée;1494;160;1654
93;Provence-Alpes-Côte d'Azur;06;2;04;121;Saint-Jean-Cap-Ferrat;1492;8;1500
93;Provence-Alpes-Côte d'Azur;06;1;26;122;Saint-Jeannet;4246;110;4356
93;Provence-Alpes-Côte d'Azur;06;1;06;123;Saint-Laurent-du-Var;29169;183;29352
93;Provence-Alpes-Côte d'Azur;06;2;26;124;Saint-Léger;49;0;49
93;Provence-Alpes-Côte d'Azur;06;2;26;125;Saint-Martin-d'Entraunes;152;7;159
93;Provence-Alpes-Côte d'Azur;06;2;24;126;Saint-Martin-du-Var;3095;19;3114
93;Provence-Alpes-Côte d'Azur;06;2;24;127;Saint-Martin-Vésubie;1444;12;1456
93;Provence-Alpes-Côte d'Azur;06;1;27;128;Saint-Paul-de-Vence;3252;70;3322
93;Provence-Alpes-Côte d'Azur;06;2;24;129;Saint-Sauveur-sur-Tinée;306;82;388
93;Provence-Alpes-Côte d'Azur;06;1;11;130;Saint-Vallier-de-Thiey;3654;104;3758
93;Provence-Alpes-Côte d'Azur;06;1;26;131;Sallagriffon;48;2;50
93;Provence-Alpes-Côte d'Azur;06;2;10;132;Saorge;458;10;468
93;Provence-Alpes-Côte d'Azur;06;2;26;133;Sauze;71;1;72
93;Provence-Alpes-Côte d'Azur;06;1;11;134;Séranon;540;8;548
93;Provence-Alpes-Côte d'Azur;06;2;26;135;Sigale;197;2;199
93;Provence-Alpes-Côte d'Azur;06;2;10;136;Sospel;3805;85;3890
93;Provence-Alpes-Côte d'Azur;06;1;11;137;Spéracèdes;1161;24;1185
93;Provence-Alpes-Côte d'Azur;06;1;13;138;Théoule-sur-Mer;1362;14;1376
93;Provence-Alpes-Côte d'Azur;06;2;26;139;Thiéry;110;3;113
93;Provence-Alpes-Côte d'Azur;06;1;11;140;Le Tignet;3066;53;3119
93;Provence-Alpes-Côte d'Azur;06;2;26;141;Toudon;347;1;348
93;Provence-Alpes-Côte d'Azur;06;2;10;142;Touët-de-l'Escarène;299;2;301
93;Provence-Alpes-Côte d'Azur;06;2;26;143;Touët-sur-Var;664;11;675
93;Provence-Alpes-Côte d'Azur;06;2;26;144;La Tour;553;4;557
93;Provence-Alpes-Côte d'Azur;06;2;26;145;Tourette-du-Château;133;1;134
93;Provence-Alpes-Côte d'Azur;06;2;26;146;Tournefort;155;1;156
93;Provence-Alpes-Côte d'Azur;06;2;24;147;Tourrette-Levens;5013;46;5059
93;Provence-Alpes-Côte d'Azur;06;1;25;148;Tourrettes-sur-Loup;4041;100;4141
93;Provence-Alpes-Côte d'Azur;06;2;21;149;La Trinité;10115;65;10180
93;Provence-Alpes-Côte d'Azur;06;2;04;150;La Turbie;2981;55;3036
93;Provence-Alpes-Côte d'Azur;06;2;24;151;Utelle;867;1;868
93;Provence-Alpes-Côte d'Azur;06;1;25;152;Valbonne;13486;554;14040
93;Provence-Alpes-Côte d'Azur;06;2;24;153;Valdeblore;835;285;1120
93;Provence-Alpes-Côte d'Azur;06;1;11;154;Valderoure;464;8;472
93;Provence-Alpes-Côte d'Azur;06;1;01;155;Vallauris;27364;179;27543
93;Provence-Alpes-Côte d'Azur;06;2;24;156;Venanson;161;1;162
93;Provence-Alpes-Côte d'Azur;06;1;26;157;Vence;18940;302;19242
93;Provence-Alpes-Côte d'Azur;06;2;26;158;Villars-sur-Var;776;3;779
93;Provence-Alpes-Côte d'Azur;06;2;04;159;Villefranche-sur-Mer;5033;35;5068
93;Provence-Alpes-Côte d'Azur;06;2;26;160;Villeneuve-d'Entraunes;89;2;91
93;Provence-Alpes-Côte d'Azur;06;1;27;161;Villeneuve-Loubet;16285;236;16521
93;Provence-Alpes-Côte d'Azur;06;2;10;162;La Brigue;696;10;706
93;Provence-Alpes-Côte d'Azur;06;2;10;163;Tende;2166;49;2215
84;Auvergne-Rhône-Alpes;07;3;06;001;Accons;376;12;388
84;Auvergne-Rhône-Alpes;07;1;04;002;Ailhon;551;18;569
84;Auvergne-Rhône-Alpes;07;1;03;003;Aizac;170;1;171
84;Auvergne-Rhône-Alpes;07;2;10;004;Ajoux;81;1;82
84;Auvergne-Rhône-Alpes;07;2;12;005;Alba-la-Romaine;1464;35;1499
84;Auvergne-Rhône-Alpes;07;3;06;006;Albon-d'Ardèche;158;6;164
84;Auvergne-Rhône-Alpes;07;3;08;007;Alboussière;989;14;1003
84;Auvergne-Rhône-Alpes;07;2;10;008;Alissas;1458;52;1510
84;Auvergne-Rhône-Alpes;07;3;11;009;Andance;1205;23;1228
84;Auvergne-Rhône-Alpes;07;3;98;010;Annonay;16297;623;16920
84;Auvergne-Rhône-Alpes;07;1;03;011;Vallées-d'Antraigues-Asperjoc;894;18;912
84;Auvergne-Rhône-Alpes;07;3;06;012;Arcens;377;9;386
84;Auvergne-Rhône-Alpes;07;3;08;013;Ardoix;1253;22;1275
84;Auvergne-Rhône-Alpes;07;3;08;014;Arlebosc;326;7;333
84;Auvergne-Rhône-Alpes;07;3;11;015;Arras-sur-Rhône;535;23;558
84;Auvergne-Rhône-Alpes;07;1;16;017;Les Assions;763;16;779
84;Auvergne-Rhône-Alpes;07;1;13;018;Astet;44;0;44
84;Auvergne-Rhône-Alpes;07;1;99;019;Aubenas;12479;776;13255
84;Auvergne-Rhône-Alpes;07;2;12;020;Aubignas;468;11;479
84;Auvergne-Rhône-Alpes;07;2;09;022;Baix;1254;26;1280
84;Auvergne-Rhône-Alpes;07;1;15;023;Balazuc;374;6;380
84;Auvergne-Rhône-Alpes;07;1;16;024;Banne;661;22;683
84;Auvergne-Rhône-Alpes;07;1;13;025;Barnas;206;2;208
84;Auvergne-Rhône-Alpes;07;1;13;026;Le Béage;254;8;262
84;Auvergne-Rhône-Alpes;07;2;17;027;Beauchastel;1844;30;1874
84;Auvergne-Rhône-Alpes;07;1;16;028;Beaulieu;516;10;526
84;Auvergne-Rhône-Alpes;07;1;16;029;Beaumont;251;3;254
84;Auvergne-Rhône-Alpes;07;2;06;030;Beauvène;207;5;212
84;Auvergne-Rhône-Alpes;07;1;16;031;Berrias-et-Casteljau;761;18;779
84;Auvergne-Rhône-Alpes;07;1;12;032;Berzème;164;1;165
84;Auvergne-Rhône-Alpes;07;1;15;033;Bessas;220;4;224
84;Auvergne-Rhône-Alpes;07;2;05;034;Bidon;251;3;254
84;Auvergne-Rhône-Alpes;07;3;17;035;Boffres;614;19;633
84;Auvergne-Rhône-Alpes;07;3;11;036;Bogy;444;11;455
84;Auvergne-Rhône-Alpes;07;1;06;037;Borée;146;3;149
84;Auvergne-Rhône-Alpes;07;1;13;038;Borne;49;0;49
84;Auvergne-Rhône-Alpes;07;3;08;039;Bozas;252;7;259
84;Auvergne-Rhône-Alpes;07;3;14;040;Boucieu-le-Roi;259;5;264
84;Auvergne-Rhône-Alpes;07;3;01;041;Boulieu-lès-Annonay;2376;65;2441
84;Auvergne-Rhône-Alpes;07;2;05;042;Bourg-Saint-Andéol;7187;165;7352
84;Auvergne-Rhône-Alpes;07;3;11;044;Brossainc;260;8;268
84;Auvergne-Rhône-Alpes;07;1;13;045;Burzet;522;7;529
84;Auvergne-Rhône-Alpes;07;1;13;047;Cellier-du-Luc;84;0;84
84;Auvergne-Rhône-Alpes;07;2;06;048;Chalencon;336;7;343
84;Auvergne-Rhône-Alpes;07;3;06;049;Le Chambon;54;3;57
84;Auvergne-Rhône-Alpes;07;1;16;050;Chambonas;941;16;957
84;Auvergne-Rhône-Alpes;07;3;11;051;Champagne;581;20;601
84;Auvergne-Rhône-Alpes;07;3;08;052;Champis;616;10;626
84;Auvergne-Rhône-Alpes;07;1;16;053;Chandolas;523;3;526
84;Auvergne-Rhône-Alpes;07;3;06;054;Chanéac;254;9;263
84;Auvergne-Rhône-Alpes;07;3;17;055;Charmes-sur-Rhône;2979;74;3053
84;Auvergne-Rhône-Alpes;07;3;11;056;Charnas;913;18;931
84;Auvergne-Rhône-Alpes;07;1;15;058;Chassiers;1039;35;1074
84;Auvergne-Rhône-Alpes;07;3;07;059;Châteaubourg;240;7;247
84;Auvergne-Rhône-Alpes;07;2;17;060;Châteauneuf-de-Vernoux;263;5;268
84;Auvergne-Rhône-Alpes;07;1;15;061;Chauzon;415;12;427
84;Auvergne-Rhône-Alpes;07;1;15;062;Chazeaux;150;3;153
84;Auvergne-Rhône-Alpes;07;3;14;063;Cheminas;397;9;406
84;Auvergne-Rhône-Alpes;07;3;06;064;Le Cheylard;2877;156;3033
84;Auvergne-Rhône-Alpes;07;1;13;065;Chirols;236;3;239
84;Auvergne-Rhône-Alpes;07;2;10;066;Chomérac;3015;173;3188
84;Auvergne-Rhône-Alpes;07;3;11;067;Colombier-le-Cardinal;318;4;322
84;Auvergne-Rhône-Alpes;07;3;14;068;Colombier-le-Jeune;572;6;578
84;Auvergne-Rhône-Alpes;07;3;08;069;Colombier-le-Vieux;657;22;679
84;Auvergne-Rhône-Alpes;07;3;07;070;Cornas;2311;49;2360
84;Auvergne-Rhône-Alpes;07;1;13;071;Coucouron;790;13;803
84;Auvergne-Rhône-Alpes;07;2;10;072;Coux;1662;42;1704
84;Auvergne-Rhône-Alpes;07;3;08;073;Le Crestet;520;11;531
84;Auvergne-Rhône-Alpes;07;2;10;074;Creysseilles;151;4;155
84;Auvergne-Rhône-Alpes;07;1;13;075;Cros-de-Géorand;149;4;153
84;Auvergne-Rhône-Alpes;07;2;09;076;Cruas;3063;66;3129
84;Auvergne-Rhône-Alpes;07;1;12;077;Darbres;254;2;256
84;Auvergne-Rhône-Alpes;07;3;01;078;Davézieux;3168;87;3255
84;Auvergne-Rhône-Alpes;07;3;08;079;Désaignes;1162;21;1183
84;Auvergne-Rhône-Alpes;07;3;06;080;Devesset;297;7;304
84;Auvergne-Rhône-Alpes;07;1;16;081;Dompnac;58;1;59
84;Auvergne-Rhône-Alpes;07;3;06;082;Dornas;205;12;217
84;Auvergne-Rhône-Alpes;07;2;06;083;Dunière-sur-Eyrieux;434;10;444
84;Auvergne-Rhône-Alpes;07;3;11;084;Eclassan;1028;37;1065
84;Auvergne-Rhône-Alpes;07;3;08;085;Empurany;619;14;633
84;Auvergne-Rhône-Alpes;07;3;14;086;Étables;931;19;950
84;Auvergne-Rhône-Alpes;07;1;13;087;Fabras;433;8;441
84;Auvergne-Rhône-Alpes;07;1;16;088;Faugères;97;2;99
84;Auvergne-Rhône-Alpes;07;3;11;089;Félines;1713;48;1761
84;Auvergne-Rhône-Alpes;07;2;10;090;Flaviac;1224;17;1241
84;Auvergne-Rhône-Alpes;07;1;04;091;Fons;333;12;345
84;Auvergne-Rhône-Alpes;07;2;10;092;Freyssenet;46;1;47
84;Auvergne-Rhône-Alpes;07;1;03;093;Genestelle;275;8;283
84;Auvergne-Rhône-Alpes;07;2;17;094;Gilhac-et-Bruzac;178;3;181
84;Auvergne-Rhône-Alpes;07;3;08;095;Gilhoc-sur-Ormèze;460;3;463
84;Auvergne-Rhône-Alpes;07;2;06;096;Gluiras;371;3;374
84;Auvergne-Rhône-Alpes;07;3;14;097;Glun;693;18;711
84;Auvergne-Rhône-Alpes;07;2;10;098;Gourdon;81;4;85
84;Auvergne-Rhône-Alpes;07;2;05;099;Gras;633;18;651
84;Auvergne-Rhône-Alpes;07;1;16;100;Gravières;499;19;518
84;Auvergne-Rhône-Alpes;07;1;15;101;Grospierres;911;21;932
84;Auvergne-Rhône-Alpes;07;3;07;102;Guilherand-Granges;10756;221;10977
84;Auvergne-Rhône-Alpes;07;3;06;103;Saint-Julien-d'Intres;310;3;313
84;Auvergne-Rhône-Alpes;07;3;06;104;Issamoulenc;87;2;89
84;Auvergne-Rhône-Alpes;07;1;13;105;Issanlas;99;3;102
84;Auvergne-Rhône-Alpes;07;1;13;106;Issarlès;132;1;133
84;Auvergne-Rhône-Alpes;07;1;13;107;Jaujac;1273;23;1296
84;Auvergne-Rhône-Alpes;07;3;06;108;Jaunac;119;8;127
84;Auvergne-Rhône-Alpes;07;1;15;109;Joannas;297;6;303
84;Auvergne-Rhône-Alpes;07;1;16;110;Joyeuse;1752;28;1780
84;Auvergne-Rhône-Alpes;07;1;03;111;Juvinas;169;5;174
84;Auvergne-Rhône-Alpes;07;1;03;112;Labastide-sur-Bésorgues;248;7;255
84;Auvergne-Rhône-Alpes;07;1;15;113;Labastide-de-Virac;308;7;315
84;Auvergne-Rhône-Alpes;07;3;08;114;Labatie-d'Andaure;201;2;203
84;Auvergne-Rhône-Alpes;07;1;15;115;Labeaume;671;11;682
84;Auvergne-Rhône-Alpes;07;1;03;116;Labégude;1358;22;1380
84;Auvergne-Rhône-Alpes;07;1;16;117;Lablachère;2206;35;2241
84;Auvergne-Rhône-Alpes;07;1;16;118;Laboule;145;6;151
84;Auvergne-Rhône-Alpes;07;1;13;119;Le Lac-d'Issarlès;255;5;260
84;Auvergne-Rhône-Alpes;07;1;03;120;Lachamp-Raphaël;61;0;61
84;Auvergne-Rhône-Alpes;07;1;13;121;Lachapelle-Graillouse;192;0;192
84;Auvergne-Rhône-Alpes;07;1;04;122;Lachapelle-sous-Aubenas;1657;46;1703
84;Auvergne-Rhône-Alpes;07;3;06;123;Lachapelle-sous-Chanéac;165;3;168
84;Auvergne-Rhône-Alpes;07;3;08;124;Lafarre;38;1;39
84;Auvergne-Rhône-Alpes;07;1;15;126;Lagorce;1171;24;1195
84;Auvergne-Rhône-Alpes;07;1;13;127;Lalevade-d'Ardèche;1118;13;1131
84;Auvergne-Rhône-Alpes;07;3;08;128;Lalouvesc;379;5;384
84;Auvergne-Rhône-Alpes;07;3;08;129;Lamastre;2349;44;2393
84;Auvergne-Rhône-Alpes;07;1;13;130;Lanarce;205;5;210
84;Auvergne-Rhône-Alpes;07;1;04;131;Lanas;452;42;494
84;Auvergne-Rhône-Alpes;07;1;15;132;Largentière;1587;50;1637
84;Auvergne-Rhône-Alpes;07;2;05;133;Larnas;243;3;246
84;Auvergne-Rhône-Alpes;07;1;15;134;Laurac-en-Vivarais;1019;27;1046
84;Auvergne-Rhône-Alpes;07;1;13;136;Laveyrune;104;1;105
84;Auvergne-Rhône-Alpes;07;1;13;137;Lavillatte;44;0;44
84;Auvergne-Rhône-Alpes;07;1;12;138;Lavilledieu;2226;46;2272
84;Auvergne-Rhône-Alpes;07;1;03;139;Laviolle;105;0;105
84;Auvergne-Rhône-Alpes;07;3;14;140;Lemps;797;24;821
84;Auvergne-Rhône-Alpes;07;1;04;141;Lentillères;232;7;239
84;Auvergne-Rhône-Alpes;07;1;13;142;Lespéron;318;8;326
84;Auvergne-Rhône-Alpes;07;3;11;143;Limony;773;18;791
84;Auvergne-Rhône-Alpes;07;1;16;144;Loubaresse;47;2;49
84;Auvergne-Rhône-Alpes;07;1;12;145;Lussas;1160;21;1181
84;Auvergne-Rhône-Alpes;07;2;10;146;Lyas;601;16;617
84;Auvergne-Rhône-Alpes;07;1;16;147;Malarce-sur-la-Thines;242;5;247
84;Auvergne-Rhône-Alpes;07;1;16;148;Malbosc;146;8;154
84;Auvergne-Rhône-Alpes;07;2;06;149;Marcols-les-Eaux;284;5;289
84;Auvergne-Rhône-Alpes;07;3;06;150;Mariac;556;20;576
84;Auvergne-Rhône-Alpes;07;3;06;151;Mars;257;11;268
84;Auvergne-Rhône-Alpes;07;3;14;152;Mauves;1183;26;1209
84;Auvergne-Rhône-Alpes;07;1;13;153;Mayres;264;7;271
84;Auvergne-Rhône-Alpes;07;1;13;154;Mazan-l'Abbaye;121;1;122
84;Auvergne-Rhône-Alpes;07;1;04;155;Mercuer;1210;46;1256
84;Auvergne-Rhône-Alpes;07;1;13;156;Meyras;931;29;960
84;Auvergne-Rhône-Alpes;07;2;09;157;Meysse;1345;13;1358
84;Auvergne-Rhône-Alpes;07;1;03;158;Mézilhac;99;0;99
84;Auvergne-Rhône-Alpes;07;1;12;159;Mirabel;715;10;725
84;Auvergne-Rhône-Alpes;07;3;02;160;Monestier;64;1;65
84;Auvergne-Rhône-Alpes;07;1;13;161;Montpezat-sous-Bauzon;739;23;762
84;Auvergne-Rhône-Alpes;07;1;15;162;Montréal;581;19;600
84;Auvergne-Rhône-Alpes;07;1;16;163;Montselgues;81;7;88
84;Auvergne-Rhône-Alpes;07;3;06;165;Belsentes;552;22;574
84;Auvergne-Rhône-Alpes;07;3;08;166;Nozières;250;2;252
84;Auvergne-Rhône-Alpes;07;2;06;167;Les Ollières-sur-Eyrieux;1006;19;1025
84;Auvergne-Rhône-Alpes;07;1;15;168;Orgnac-l'Aven;597;17;614
84;Auvergne-Rhône-Alpes;07;3;11;169;Ozon;381;1;382
84;Auvergne-Rhône-Alpes;07;3;08;170;Pailharès;243;6;249
84;Auvergne-Rhône-Alpes;07;1;16;171;Payzac;537;8;545
84;Auvergne-Rhône-Alpes;07;3;11;172;Peaugres;2276;51;2327
84;Auvergne-Rhône-Alpes;07;1;13;173;Péreyres;50;0;50
84;Auvergne-Rhône-Alpes;07;3;11;174;Peyraud;482;6;488
84;Auvergne-Rhône-Alpes;07;1;13;175;Le Plagnal;83;1;84
84;Auvergne-Rhône-Alpes;07;1;16;176;Planzolles;153;2;155
84;Auvergne-Rhône-Alpes;07;3;14;177;Plats;847;19;866
84;Auvergne-Rhône-Alpes;07;1;13;178;Pont-de-Labeaume;588;12;600
84;Auvergne-Rhône-Alpes;07;2;10;179;Pourchères;134;2;136
84;Auvergne-Rhône-Alpes;07;2;09;181;Le Pouzin;2879;39;2918
84;Auvergne-Rhône-Alpes;07;1;13;182;Prades;1186;31;1217
84;Auvergne-Rhône-Alpes;07;1;15;183;Pradons;473;12;485
84;Auvergne-Rhône-Alpes;07;2;10;184;Pranles;511;13;524
84;Auvergne-Rhône-Alpes;07;3;08;185;Préaux;703;9;712
84;Auvergne-Rhône-Alpes;07;2;10;186;Privas;8465;282;8747
84;Auvergne-Rhône-Alpes;07;1;15;187;Prunet;135;4;139
84;Auvergne-Rhône-Alpes;07;3;08;188;Quintenas;1686;38;1724
84;Auvergne-Rhône-Alpes;07;1;16;189;Ribes;315;7;322
84;Auvergne-Rhône-Alpes;07;1;15;190;Rochecolombe;216;7;223
84;Auvergne-Rhône-Alpes;07;2;09;191;Rochemaure;2292;52;2344
84;Auvergne-Rhône-Alpes;07;3;06;192;Rochepaule;242;8;250
84;Auvergne-Rhône-Alpes;07;1;15;193;Rocher;276;4;280
84;Auvergne-Rhône-Alpes;07;2;10;194;Rochessauve;457;9;466
84;Auvergne-Rhône-Alpes;07;1;06;195;La Rochette;62;2;64
84;Auvergne-Rhône-Alpes;07;1;16;196;Rocles;258;4;262
84;Auvergne-Rhône-Alpes;07;3;02;197;Roiffieux;2746;84;2830
84;Auvergne-Rhône-Alpes;07;2;09;198;Rompon;1126;30;1156
84;Auvergne-Rhône-Alpes;07;1;16;199;Rosières;1249;25;1274
84;Auvergne-Rhône-Alpes;07;1;13;200;Le Roux;59;1;60
84;Auvergne-Rhône-Alpes;07;1;15;201;Ruoms;2276;29;2305
84;Auvergne-Rhône-Alpes;07;1;16;202;Sablières;177;4;181
84;Auvergne-Rhône-Alpes;07;1;13;203;Sagnes-et-Goudoulet;116;3;119
84;Auvergne-Rhône-Alpes;07;3;06;204;Saint-Agrève;2377;63;2440
84;Auvergne-Rhône-Alpes;07;3;08;205;Saint-Alban-d'Ay;1419;23;1442
84;Auvergne-Rhône-Alpes;07;1;13;206;Saint-Alban-en-Montagne;77;3;80
84;Auvergne-Rhône-Alpes;07;1;15;207;Saint-Alban-Auriolles;1084;17;1101
84;Auvergne-Rhône-Alpes;07;1;12;208;Saint-Andéol-de-Berg;123;3;126
84;Auvergne-Rhône-Alpes;07;3;06;209;Saint-Andéol-de-Fourchades;54;2;56
84;Auvergne-Rhône-Alpes;07;1;03;210;Saint-Andéol-de-Vals;519;11;530
84;Auvergne-Rhône-Alpes;07;1;16;211;Saint-André-de-Cruzières;461;14;475
84;Auvergne-Rhône-Alpes;07;3;06;212;Saint-André-en-Vivarais;210;3;213
84;Auvergne-Rhône-Alpes;07;1;16;213;Saint-André-Lachamp;149;1;150
84;Auvergne-Rhône-Alpes;07;2;17;214;Saint-Apollinaire-de-Rias;206;2;208
84;Auvergne-Rhône-Alpes;07;3;06;215;Saint-Barthélemy-le-Meil;199;6;205
84;Auvergne-Rhône-Alpes;07;3;08;216;Saint-Barthélemy-Grozon;497;21;518
84;Auvergne-Rhône-Alpes;07;3;14;217;Saint-Barthélemy-le-Plain;833;21;854
84;Auvergne-Rhône-Alpes;07;3;08;218;Saint-Basile;346;10;356
84;Auvergne-Rhône-Alpes;07;2;09;219;Saint-Bauzile;320;6;326
84;Auvergne-Rhône-Alpes;07;3;06;220;Saint-Christol;107;0;107
84;Auvergne-Rhône-Alpes;07;2;17;221;Saint-Cierge-la-Serre;248;9;257
84;Auvergne-Rhône-Alpes;07;3;06;222;Saint-Cierge-sous-le-Cheylard;209;5;214
84;Auvergne-Rhône-Alpes;07;1;13;223;Saint-Cirgues-de-Prades;139;2;141
84;Auvergne-Rhône-Alpes;07;1;13;224;Saint-Cirgues-en-Montagne;217;13;230
84;Auvergne-Rhône-Alpes;07;3;01;225;Saint-Clair;1187;45;1232
84;Auvergne-Rhône-Alpes;07;3;06;226;Saint-Clément;88;0;88
84;Auvergne-Rhône-Alpes;07;3;01;227;Saint-Cyr;1392;47;1439
84;Auvergne-Rhône-Alpes;07;3;11;228;Saint-Désirat;844;23;867
84;Auvergne-Rhône-Alpes;07;1;04;229;Saint-Didier-sous-Aubenas;926;25;951
84;Auvergne-Rhône-Alpes;07;1;04;230;Saint-Étienne-de-Boulogne;413;14;427
84;Auvergne-Rhône-Alpes;07;1;04;231;Saint-Étienne-de-Fontbellon;2833;83;2916
84;Auvergne-Rhône-Alpes;07;1;13;232;Saint-Étienne-de-Lugdarès;413;9;422
84;Auvergne-Rhône-Alpes;07;2;06;233;Saint-Étienne-de-Serre;211;4;215
84;Auvergne-Rhône-Alpes;07;3;11;234;Saint-Étienne-de-Valoux;297;3;300
84;Auvergne-Rhône-Alpes;07;1;13;235;Sainte-Eulalie;216;3;219
84;Auvergne-Rhône-Alpes;07;3;08;236;Saint-Félicien;1147;19;1166
84;Auvergne-Rhône-Alpes;07;2;17;237;Saint-Fortunat-sur-Eyrieux;777;13;790
84;Auvergne-Rhône-Alpes;07;1;16;238;Saint-Genest-de-Beauzon;332;7;339
84;Auvergne-Rhône-Alpes;07;3;06;239;Saint-Genest-Lachamp;110;2;112
84;Auvergne-Rhône-Alpes;07;3;17;240;Saint-Georges-les-Bains;2405;45;2450
84;Auvergne-Rhône-Alpes;07;1;12;241;Saint-Germain;711;17;728
84;Auvergne-Rhône-Alpes;07;1;12;242;Saint-Gineys-en-Coiron;112;4;116
84;Auvergne-Rhône-Alpes;07;3;11;243;Saint-Jacques-d'Atticieux;290;5;295
84;Auvergne-Rhône-Alpes;07;2;17;244;Saint-Jean-Chambre;256;5;261
84;Auvergne-Rhône-Alpes;07;3;14;245;Saint-Jean-de-Muzols;2508;69;2577
84;Auvergne-Rhône-Alpes;07;1;12;247;Saint-Jean-le-Centenier;845;9;854
84;Auvergne-Rhône-Alpes;07;3;06;248;Saint-Jean-Roure;247;11;258
84;Auvergne-Rhône-Alpes;07;3;06;249;Saint-Jeure-d'Andaure;95;2;97
84;Auvergne-Rhône-Alpes;07;3;08;250;Saint-Jeure-d'Ay;486;10;496
84;Auvergne-Rhône-Alpes;07;1;03;251;Saint-Joseph-des-Bancs;173;3;176
84;Auvergne-Rhône-Alpes;07;2;06;253;Saint-Julien-du-Gua;175;3;178
84;Auvergne-Rhône-Alpes;07;1;03;254;Saint-Julien-du-Serre;872;19;891
84;Auvergne-Rhône-Alpes;07;2;09;255;Saint-Julien-en-Saint-Alban;1461;38;1499
84;Auvergne-Rhône-Alpes;07;2;17;257;Saint-Julien-le-Roux;114;3;117
84;Auvergne-Rhône-Alpes;07;3;02;258;Saint-Julien-Vocance;223;2;225
84;Auvergne-Rhône-Alpes;07;2;05;259;Saint-Just-d'Ardèche;1688;37;1725
84;Auvergne-Rhône-Alpes;07;2;09;260;Saint-Lager-Bressac;950;17;967
84;Auvergne-Rhône-Alpes;07;2;17;261;Saint-Laurent-du-Pape;1589;35;1624
84;Auvergne-Rhône-Alpes;07;1;13;262;Saint-Laurent-les-Bains-Laval-d'Aurelle;172;2;174
84;Auvergne-Rhône-Alpes;07;1;12;263;Saint-Laurent-sous-Coiron;111;3;114
84;Auvergne-Rhône-Alpes;07;2;05;264;Saint-Marcel-d'Ardèche;2380;69;2449
84;Auvergne-Rhône-Alpes;07;3;01;265;Saint-Marcel-lès-Annonay;1384;35;1419
84;Auvergne-Rhône-Alpes;07;1;16;266;Sainte-Marguerite-Lafigère;113;2;115
84;Auvergne-Rhône-Alpes;07;1;06;267;Saint-Martial;267;4;271
84;Auvergne-Rhône-Alpes;07;2;05;268;Saint-Martin-d'Ardèche;949;12;961
84;Auvergne-Rhône-Alpes;07;3;06;269;Saint-Martin-de-Valamas;1096;38;1134
84;Auvergne-Rhône-Alpes;07;2;09;270;Saint-Martin-sur-Lavezon;432;12;444
84;Auvergne-Rhône-Alpes;07;1;15;272;Saint-Maurice-d'Ardèche;313;13;326
84;Auvergne-Rhône-Alpes;07;1;12;273;Saint-Maurice-d'Ibie;217;3;220
84;Auvergne-Rhône-Alpes;07;2;06;274;Saint-Maurice-en-Chalencon;208;5;213
84;Auvergne-Rhône-Alpes;07;1;16;275;Saint-Mélany;103;3;106
84;Auvergne-Rhône-Alpes;07;3;06;276;Saint-Michel-d'Aurance;266;20;286
84;Auvergne-Rhône-Alpes;07;1;04;277;Saint-Michel-de-Boulogne;149;5;154
84;Auvergne-Rhône-Alpes;07;2;06;278;Saint-Michel-de-Chabrillanoux;389;9;398
84;Auvergne-Rhône-Alpes;07;2;05;279;Saint-Montan;1897;43;1940
84;Auvergne-Rhône-Alpes;07;1;16;280;Saint-Paul-le-Jeune;958;21;979
84;Auvergne-Rhône-Alpes;07;3;07;281;Saint-Péray;7580;219;7799
84;Auvergne-Rhône-Alpes;07;1;13;282;Saint-Pierre-de-Colombier;430;25;455
84;Auvergne-Rhône-Alpes;07;2;09;283;Saint-Pierre-la-Roche;63;1;64
84;Auvergne-Rhône-Alpes;07;1;16;284;Saint-Pierre-Saint-Jean;169;4;173
84;Auvergne-Rhône-Alpes;07;3;08;285;Saint-Pierre-sur-Doux;109;1;110
84;Auvergne-Rhône-Alpes;07;3;06;286;Saint-Pierreville;526;2;528
84;Auvergne-Rhône-Alpes;07;1;12;287;Saint-Pons;296;15;311
84;Auvergne-Rhône-Alpes;07;2;10;288;Saint-Priest;1280;44;1324
84;Auvergne-Rhône-Alpes;07;1;04;289;Saint-Privat;1688;58;1746
84;Auvergne-Rhône-Alpes;07;3;08;290;Saint-Prix;269;7;276
84;Auvergne-Rhône-Alpes;07;1;15;291;Saint-Remèze;858;23;881
84;Auvergne-Rhône-Alpes;07;3;08;292;Saint-Romain-d'Ay;1248;36;1284
84;Auvergne-Rhône-Alpes;07;3;07;293;Saint-Romain-de-Lerps;900;18;918
84;Auvergne-Rhône-Alpes;07;1;16;294;Saint-Sauveur-de-Cruzières;533;15;548
84;Auvergne-Rhône-Alpes;07;2;06;295;Saint-Sauveur-de-Montagut;1106;24;1130
84;Auvergne-Rhône-Alpes;07;1;04;296;Saint-Sernin;1748;48;1796
84;Auvergne-Rhône-Alpes;07;3;08;297;Saint-Sylvestre;508;7;515
84;Auvergne-Rhône-Alpes;07;2;09;298;Saint-Symphorien-sous-Chomérac;777;31;808
84;Auvergne-Rhône-Alpes;07;3;08;299;Saint-Symphorien-de-Mahun;120;4;124
84;Auvergne-Rhône-Alpes;07;2;12;300;Saint-Thomé;461;16;477
84;Auvergne-Rhône-Alpes;07;3;08;301;Saint-Victor;950;15;965
84;Auvergne-Rhône-Alpes;07;2;09;302;Saint-Vincent-de-Barrès;837;22;859
84;Auvergne-Rhône-Alpes;07;2;06;303;Saint-Vincent-de-Durfort;254;4;258
84;Auvergne-Rhône-Alpes;07;1;15;304;Salavas;704;12;716
84;Auvergne-Rhône-Alpes;07;1;16;305;Les Salelles;372;8;380
84;Auvergne-Rhône-Alpes;07;1;15;306;Sampzon;232;7;239
84;Auvergne-Rhône-Alpes;07;1;15;307;Sanilhac;447;9;456
84;Auvergne-Rhône-Alpes;07;3;11;308;Sarras;2228;35;2263
84;Auvergne-Rhône-Alpes;07;3;08;309;Satillieu;1503;30;1533
84;Auvergne-Rhône-Alpes;07;3;01;310;Savas;903;24;927
84;Auvergne-Rhône-Alpes;07;1;12;311;Sceautres;146;7;153
84;Auvergne-Rhône-Alpes;07;3;14;312;Sécheras;534;16;550
84;Auvergne-Rhône-Alpes;07;3;11;313;Serrières;1137;17;1154
84;Auvergne-Rhône-Alpes;07;2;17;314;Silhac;380;12;392
84;Auvergne-Rhône-Alpes;07;1;13;315;La Souche;372;13;385
84;Auvergne-Rhône-Alpes;07;3;17;316;Soyons;2284;49;2333
84;Auvergne-Rhône-Alpes;07;3;02;317;Talencieux;1085;31;1116
84;Auvergne-Rhône-Alpes;07;1;15;318;Tauriers;200;5;205
84;Auvergne-Rhône-Alpes;07;2;12;319;Le Teil;8832;211;9043
84;Auvergne-Rhône-Alpes;07;3;02;321;Thorrenc;239;6;245
84;Auvergne-Rhône-Alpes;07;1;13;322;Thueyts;1216;25;1241
84;Auvergne-Rhône-Alpes;07;3;17;323;Toulaud;1708;53;1761
84;Auvergne-Rhône-Alpes;07;3;14;324;Tournon-sur-Rhône;10622;515;11137
84;Auvergne-Rhône-Alpes;07;1;03;325;Ucel;2062;72;2134
84;Auvergne-Rhône-Alpes;07;1;13;326;Usclades-et-Rieutord;117;0;117
84;Auvergne-Rhône-Alpes;07;1;15;327;Uzer;412;12;424
84;Auvergne-Rhône-Alpes;07;1;15;328;Vagnas;583;18;601
84;Auvergne-Rhône-Alpes;07;1;16;329;Valgorge;417;8;425
84;Auvergne-Rhône-Alpes;07;1;15;330;Vallon-Pont-d'Arc;2412;39;2451
84;Auvergne-Rhône-Alpes;07;1;03;331;Vals-les-Bains;3530;65;3595
84;Auvergne-Rhône-Alpes;07;2;12;332;Valvignères;447;13;460
84;Auvergne-Rhône-Alpes;07;3;02;333;Vanosc;935;13;948
84;Auvergne-Rhône-Alpes;07;1;16;334;Les Vans;2655;58;2713
84;Auvergne-Rhône-Alpes;07;3;08;335;Vaudevant;207;2;209
84;Auvergne-Rhône-Alpes;07;1;16;336;Vernon;225;7;232
84;Auvergne-Rhône-Alpes;07;3;02;337;Vernosc-lès-Annonay;2614;85;2699
84;Auvergne-Rhône-Alpes;07;2;17;338;Vernoux-en-Vivarais;1962;31;1993
84;Auvergne-Rhône-Alpes;07;1;04;339;Vesseaux;1990;62;2052
84;Auvergne-Rhône-Alpes;07;2;10;340;Veyras;1514;48;1562
84;Auvergne-Rhône-Alpes;07;1;12;341;Villeneuve-de-Berg;3001;115;3116
84;Auvergne-Rhône-Alpes;07;3;02;342;Villevocance;1184;28;1212
84;Auvergne-Rhône-Alpes;07;1;04;343;Vinezac;1401;40;1441
84;Auvergne-Rhône-Alpes;07;3;11;344;Vinzieux;466;3;469
84;Auvergne-Rhône-Alpes;07;3;14;345;Vion;944;19;963
84;Auvergne-Rhône-Alpes;07;2;05;346;Viviers;3689;66;3755
84;Auvergne-Rhône-Alpes;07;3;02;347;Vocance;628;2;630
84;Auvergne-Rhône-Alpes;07;1;15;348;Vogüé;1097;25;1122
84;Auvergne-Rhône-Alpes;07;2;17;349;La Voulte-sur-Rhône;4848;58;4906
44;Grand Est;08;2;11;001;Acy-Romance;467;3;470
44;Grand Est;08;1;18;003;Aiglemont;1637;35;1672
44;Grand Est;08;2;08;004;Aire;236;1;237
44;Grand Est;08;2;08;005;Alincourt;158;2;160
44;Grand Est;08;4;01;006;Alland'Huy-et-Sausseuil;242;4;246
44;Grand Est;08;2;11;008;Amagne;711;6;717
44;Grand Est;08;2;11;010;Ambly-Fleury;133;5;138
44;Grand Est;08;1;12;011;Anchamps;210;4;214
44;Grand Est;08;3;19;013;Angecourt;390;3;393
44;Grand Est;08;2;08;014;Annelles;140;6;146
44;Grand Est;08;1;17;015;Antheny;101;5;106
44;Grand Est;08;1;17;016;Aouste;205;2;207
44;Grand Est;08;4;01;017;Apremont;117;3;120
44;Grand Est;08;4;01;018;Ardeuil-et-Montfauxelles;73;2;75
44;Grand Est;08;4;19;019;Les Grandes-Armoises;61;0;61
44;Grand Est;08;4;19;020;Les Petites-Armoises;61;0;61
44;Grand Est;08;2;11;021;Arnicourt;155;3;158
44;Grand Est;08;1;05;022;Arreux;320;12;332
44;Grand Est;08;3;19;023;Artaise-le-Vivier;65;1;66
44;Grand Est;08;2;08;024;Asfeld;1088;19;1107
44;Grand Est;08;4;01;025;Attigny;1119;28;1147
44;Grand Est;08;1;17;026;Aubigny-les-Pothées;310;8;318
44;Grand Est;08;2;17;027;Auboncourt-Vauzelles;97;3;100
44;Grand Est;08;1;09;028;Aubrives;982;20;1002
44;Grand Est;08;3;03;029;Auflance;87;3;90
44;Grand Est;08;1;13;030;Auge;58;0;58
44;Grand Est;08;4;01;031;Aure;43;4;47
44;Grand Est;08;2;08;032;Aussonce;218;3;221
44;Grand Est;08;4;19;033;Authe;90;4;94
44;Grand Est;08;3;03;034;Autrecourt-et-Pourron;340;6;346
44;Grand Est;08;4;19;035;Autruche;59;2;61
44;Grand Est;08;4;01;036;Autry;114;8;122
44;Grand Est;08;1;13;037;Auvillers-les-Forges;879;10;889
44;Grand Est;08;2;08;038;Avançon;328;9;337
44;Grand Est;08;2;08;039;Avaux;465;13;478
44;Grand Est;08;1;10;040;Les Ayvelles;886;12;898
44;Grand Est;08;1;10;041;Baâlons;206;8;214
44;Grand Est;08;3;16;043;Balan;1622;30;1652
44;Grand Est;08;2;08;044;Balham;163;1;164
44;Grand Est;08;4;19;045;Ballay;268;11;279
44;Grand Est;08;2;08;046;Banogne-Recouvrance;159;3;162
44;Grand Est;08;1;17;047;Barbaise;106;0;106
44;Grand Est;08;2;11;048;Barby;416;4;420
44;Grand Est;08;4;19;049;Bar-lès-Buzancy;128;3;131
44;Grand Est;08;4;19;052;Bayonville;82;5;87
44;Grand Est;08;3;16;053;Bazeilles;2423;219;2642
44;Grand Est;08;3;03;055;Beaumont-en-Argonne;428;7;435
44;Grand Est;08;4;01;056;Beffu-et-le-Morthomme;45;0;45
44;Grand Est;08;4;19;057;Belleville-et-Châtillon-sur-Bar;260;24;284
44;Grand Est;08;1;04;058;Belval;222;6;228
44;Grand Est;08;4;19;059;Belval-Bois-des-Dames;30;1;31
44;Grand Est;08;2;08;060;Bergnicourt;293;1;294
44;Grand Est;08;4;19;061;La Berlière;38;1;39
44;Grand Est;08;2;11;062;Bertoncourt;126;6;132
44;Grand Est;08;3;19;063;La Besace;136;1;137
44;Grand Est;08;2;11;064;Biermes;307;5;312
44;Grand Est;08;3;03;065;Bièvres;46;1;47
44;Grand Est;08;2;08;066;Bignicourt;68;1;69
44;Grand Est;08;3;03;067;Blagny;1121;17;1138
44;Grand Est;08;1;17;069;Blanchefosse-et-Bay;145;2;147
44;Grand Est;08;2;08;070;Blanzy-la-Salonnaise;369;6;375
44;Grand Est;08;1;13;071;Blombay;138;2;140
44;Grand Est;08;1;17;073;Bossus-lès-Rumigny;96;2;98
44;Grand Est;08;4;01;074;Bouconville;56;3;59
44;Grand Est;08;4;19;075;Boult-aux-Bois;137;3;140
44;Grand Est;08;1;10;076;Boulzicourt;966;19;985
44;Grand Est;08;4;01;077;Bourcq;51;1;52
44;Grand Est;08;1;13;078;Bourg-Fidèle;853;15;868
44;Grand Est;08;1;10;080;Bouvellemont;129;0;129
44;Grand Est;08;1;02;081;Bogny-sur-Meuse;5018;74;5092
44;Grand Est;08;4;01;082;Brécy-Brières;81;2;83
44;Grand Est;08;3;03;083;Brévilly;353;7;360
44;Grand Est;08;2;08;084;Brienne-sur-Aisne;271;2;273
44;Grand Est;08;4;19;085;Brieulles-sur-Bar;226;7;233
44;Grand Est;08;4;19;086;Briquenay;92;7;99
44;Grand Est;08;1;13;087;Brognon;146;2;148
44;Grand Est;08;3;19;088;Bulson;134;4;138
44;Grand Est;08;4;19;089;Buzancy;370;9;379
44;Grand Est;08;3;03;090;Carignan;2879;44;2923
44;Grand Est;08;4;01;092;Cauroy;190;8;198
44;Grand Est;08;1;17;094;Cernion;57;3;60
44;Grand Est;08;1;10;095;Chagny;182;6;188
44;Grand Est;08;1;10;096;Chalandry-Elaire;709;15;724
44;Grand Est;08;4;01;097;Challerange;444;7;451
44;Grand Est;08;4;01;098;Champigneulle;54;2;56
44;Grand Est;08;1;10;099;Champigneul-sur-Vence;123;4;127
44;Grand Est;08;1;17;100;Champlin;72;1;73
44;Grand Est;08;3;15;101;La Chapelle;167;5;172
44;Grand Est;08;2;17;102;Chappes;92;5;97
44;Grand Est;08;4;01;103;Charbogne;222;3;225
44;Grand Est;08;4;01;104;Chardeny;60;1;61
44;Grand Est;08;1;98;105;Charleville-Mézières;46436;1090;47526
44;Grand Est;08;1;09;106;Charnois;73;0;73
44;Grand Est;08;2;08;107;Château-Porcien;1331;18;1349
44;Grand Est;08;4;01;109;Chatel-Chéhéry;140;3;143
44;Grand Est;08;1;13;110;Le Châtelet-sur-Sormonne;165;1;166
44;Grand Est;08;2;08;111;Le Châtelet-sur-Retourne;782;2;784
44;Grand Est;08;2;17;113;Chaumont-Porcien;497;11;508
44;Grand Est;08;3;19;115;Chémery-Chéhéry;545;4;549
44;Grand Est;08;4;19;116;Bairon et ses environs;1021;17;1038
44;Grand Est;08;2;17;117;Chesnois-Auboncourt;159;0;159
44;Grand Est;08;3;14;119;Cheveuges;455;7;462
44;Grand Est;08;4;01;120;Chevières;45;2;47
44;Grand Est;08;1;13;121;Chilly;138;5;143
44;Grand Est;08;1;09;122;Chooz;754;15;769
44;Grand Est;08;4;01;123;Chuffilly-Roche;72;1;73
44;Grand Est;08;1;17;124;Clavy-Warby;345;9;354
44;Grand Est;08;1;04;125;Cliron;402;9;411
44;Grand Est;08;2;08;126;Condé-lès-Herpy;221;4;225
44;Grand Est;08;4;01;128;Condé-lès-Autry;65;2;67
44;Grand Est;08;4;01;130;Contreuve;83;3;86
44;Grand Est;08;4;01;131;Cornay;64;3;67
44;Grand Est;08;2;11;132;Corny-Machéroménil;189;2;191
44;Grand Est;08;2;11;133;Coucy;508;5;513
44;Grand Est;08;4;01;134;Coulommes-et-Marqueny;77;1;78
44;Grand Est;08;4;19;135;La Croix-aux-Bois;151;3;154
44;Grand Est;08;3;16;136;Daigny;349;8;357
44;Grand Est;08;1;05;137;Damouzy;458;13;471
44;Grand Est;08;3;03;138;Les Deux-Villes;255;3;258
44;Grand Est;08;1;02;139;Deville;1041;10;1051
44;Grand Est;08;1;10;140;Dom-le-Mesnil;1083;20;1103
44;Grand Est;08;1;17;141;Dommery;181;4;185
44;Grand Est;08;3;14;142;Donchery;2018;27;2045
44;Grand Est;08;2;17;143;Doumely-Bégny;73;0;73
44;Grand Est;08;2;11;144;Doux;102;1;103
44;Grand Est;08;3;03;145;Douzy;2199;60;2259
44;Grand Est;08;2;17;146;Draize;95;2;97
44;Grand Est;08;4;01;147;Dricourt;84;9;93
44;Grand Est;08;2;08;148;L'Écaille;279;7;286
44;Grand Est;08;1;17;149;L'Échelle;142;5;147
44;Grand Est;08;2;08;150;Écly;170;5;175
44;Grand Est;08;4;01;151;Écordal;306;12;318
44;Grand Est;08;3;03;153;Escombres-et-le-Chesnois;347;5;352
44;Grand Est;08;1;17;154;Estrebay;81;3;84
44;Grand Est;08;1;13;155;Étalle;101;5;106
44;Grand Est;08;1;13;156;Éteignières;508;3;511
44;Grand Est;08;1;10;158;Étrépigny;299;8;307
44;Grand Est;08;3;03;159;Euilly-et-Lombut;110;4;114
44;Grand Est;08;1;10;160;Évigny;188;4;192
44;Grand Est;08;4;01;161;Exermont;38;1;39
44;Grand Est;08;1;04;162;Fagnon;350;6;356
44;Grand Est;08;2;17;163;Faissault;255;4;259
44;Grand Est;08;4;01;164;Falaise;336;9;345
44;Grand Est;08;2;17;165;Faux;58;1;59
44;Grand Est;08;1;12;166;Fépin;268;2;270
44;Grand Est;08;1;17;167;La Férée;74;2;76
44;Grand Est;08;3;03;168;La Ferté-sur-Chiers;174;4;178
44;Grand Est;08;1;17;169;Flaignes-Havys;104;8;112
44;Grand Est;08;3;15;170;Fleigneux;215;3;218
44;Grand Est;08;4;01;171;Fléville;95;4;99
44;Grand Est;08;1;13;172;Fligny;188;1;189
44;Grand Est;08;1;10;173;Flize;1722;52;1774
44;Grand Est;08;3;15;174;Floing;2313;56;2369
44;Grand Est;08;1;09;175;Foisches;238;8;246
44;Grand Est;08;4;19;176;Fossé;53;1;54
44;Grand Est;08;2;17;178;Fraillicourt;186;5;191
44;Grand Est;08;3;16;179;Francheval;597;13;610
44;Grand Est;08;1;07;180;La Francheville;1671;41;1712
44;Grand Est;08;1;17;182;Le Fréty;54;0;54
44;Grand Est;08;1;09;183;Fromelennes;1043;24;1067
44;Grand Est;08;3;03;184;Fromy;82;2;84
44;Grand Est;08;1;12;185;Fumay;3280;48;3328
44;Grand Est;08;4;19;186;Germont;49;0;49
44;Grand Est;08;1;18;187;Gernelle;311;8;319
44;Grand Est;08;1;18;188;Gespunsart;1016;24;1040
44;Grand Est;08;1;17;189;Girondelle;162;2;164
44;Grand Est;08;1;09;190;Givet;6476;148;6624
44;Grand Est;08;3;15;191;Givonne;1052;25;1077
44;Grand Est;08;2;17;192;Givron;86;1;87
44;Grand Est;08;4;01;193;Givry;271;6;277
44;Grand Est;08;3;15;194;Glaire;845;13;858
44;Grand Est;08;2;08;195;Gomont;326;3;329
44;Grand Est;08;2;17;196;Grandchamp;104;0;104
44;Grand Est;08;4;01;197;Grandham;38;2;40
44;Grand Est;08;4;01;198;Grandpré;520;16;536
44;Grand Est;08;1;18;199;La Grandville;796;17;813
44;Grand Est;08;4;01;200;Grivy-Loisy;184;6;190
44;Grand Est;08;1;17;201;Gruyères;100;2;102
44;Grand Est;08;1;13;202;Gué-d'Hossus;517;10;527
44;Grand Est;08;1;10;203;Guignicourt-sur-Vence;280;6;286
44;Grand Est;08;4;01;204;Guincourt;82;1;83
44;Grand Est;08;2;17;205;Hagnicourt;73;0;73
44;Grand Est;08;1;13;206;Ham-les-Moines;371;5;376
44;Grand Est;08;1;09;207;Ham-sur-Meuse;231;4;235
44;Grand Est;08;1;17;208;Hannappes;137;1;138
44;Grand Est;08;1;10;209;Hannogne-Saint-Martin;475;5;480
44;Grand Est;08;2;08;210;Hannogne-Saint-Rémy;112;4;116
44;Grand Est;08;3;19;211;Haraucourt;721;4;725
44;Grand Est;08;1;13;212;Harcy;504;10;514
44;Grand Est;08;1;12;214;Hargnies;488;3;491
44;Grand Est;08;4;19;215;Harricourt;43;2;45
44;Grand Est;08;1;04;216;Haudrecy;314;13;327
44;Grand Est;08;1;02;217;Haulmé;88;0;88
44;Grand Est;08;1;02;218;Les Hautes-Rivières;1446;24;1470
44;Grand Est;08;2;08;219;Hauteville;117;1;118
44;Grand Est;08;4;01;220;Hauviné;334;8;342
44;Grand Est;08;1;12;222;Haybes;1847;47;1894
44;Grand Est;08;3;03;223;Herbeuval;122;2;124
44;Grand Est;08;2;08;225;Herpy-l'Arlésienne;205;6;211
44;Grand Est;08;1;09;226;Hierges;170;4;174
44;Grand Est;08;1;10;228;La Horgne;168;5;173
44;Grand Est;08;2;08;229;Houdilcourt;131;7;138
44;Grand Est;08;1;05;230;Houldizy;390;6;396
44;Grand Est;08;3;15;232;Illy;412;9;421
44;Grand Est;08;4;19;233;Imécourt;46;1;47
44;Grand Est;08;2;08;234;Inaumont;104;0;104
44;Grand Est;08;1;18;235;Issancourt-et-Rumel;374;12;386
44;Grand Est;08;1;17;236;Jandun;297;10;307
44;Grand Est;08;1;02;237;Joigny-sur-Meuse;655;20;675
44;Grand Est;08;4;01;238;Jonval;102;1;103
44;Grand Est;08;2;08;239;Juniville;1233;30;1263
44;Grand Est;08;2;17;240;Justine-Herbigny;171;4;175
44;Grand Est;08;1;02;242;Laifour;428;8;436
44;Grand Est;08;1;17;243;Lalobbe;165;3;168
44;Grand Est;08;4;01;244;Lametz;72;3;75
44;Grand Est;08;4;01;245;Lançon;31;2;33
44;Grand Est;08;4;19;246;Landres-et-Saint-Georges;74;1;75
44;Grand Est;08;1;09;247;Landrichamps;131;2;133
44;Grand Est;08;1;17;248;Launois-sur-Vence;686;9;695
44;Grand Est;08;1;13;249;Laval-Morency;240;10;250
44;Grand Est;08;4;01;250;Leffincourt;188;5;193
44;Grand Est;08;1;17;251;Lépron-les-Vallées;75;2;77
44;Grand Est;08;3;03;252;Létanne;118;2;120
44;Grand Est;08;1;17;254;Liart;616;10;626
44;Grand Est;08;3;03;255;Linay;224;3;227
44;Grand Est;08;4;01;256;Liry;86;1;87
44;Grand Est;08;1;17;257;Logny-Bogny;155;3;158
44;Grand Est;08;4;01;259;Longwé;72;2;74
44;Grand Est;08;1;13;260;Lonny;627;8;635
44;Grand Est;08;2;17;262;Lucquy;572;34;606
44;Grand Est;08;1;18;263;Lumes;1126;26;1152
44;Grand Est;08;4;01;264;Machault;515;11;526
44;Grand Est;08;3;19;268;Maisoncelle-et-Villers;69;4;73
44;Grand Est;08;3;03;269;Malandry;79;1;80
44;Grand Est;08;4;01;271;Manre;100;6;106
44;Grand Est;08;1;17;272;Maranwez;57;0;57
44;Grand Est;08;1;17;273;Marby;72;1;73
44;Grand Est;08;4;01;274;Marcq;99;1;100
44;Grand Est;08;3;03;275;Margny;207;4;211
44;Grand Est;08;3;03;276;Margut;740;13;753
44;Grand Est;08;1;17;277;Marlemont;131;4;135
44;Grand Est;08;4;01;278;Marquigny;81;0;81
44;Grand Est;08;4;01;279;Mars-sous-Bourcq;58;2;60
44;Grand Est;08;4;01;280;Marvaux-Vieux;75;2;77
44;Grand Est;08;3;03;281;Matton-et-Clémency;469;9;478
44;Grand Est;08;1;13;282;Maubert-Fontaine;1033;72;1105
44;Grand Est;08;1;10;283;Mazerny;127;1;128
44;Grand Est;08;1;02;284;Les Mazures;885;23;908
44;Grand Est;08;2;08;286;Ménil-Annelles;113;5;118
44;Grand Est;08;2;08;287;Ménil-Lépinois;133;2;135
44;Grand Est;08;2;17;288;Mesmont;90;1;91
44;Grand Est;08;3;03;289;Messincourt;604;8;612
44;Grand Est;08;3;03;291;Mogues;245;5;250
44;Grand Est;08;3;03;293;Moiry;143;5;148
44;Grand Est;08;3;16;294;La Moncelle;135;4;139
44;Grand Est;08;1;10;295;Mondigny;185;4;189
44;Grand Est;08;4;01;296;Montcheutin;115;7;122
44;Grand Est;08;1;02;297;Montcornet;299;8;307
44;Grand Est;08;1;06;298;Montcy-Notre-Dame;1578;45;1623
44;Grand Est;08;3;19;300;Le Mont-Dieu;15;0;15
44;Grand Est;08;4;19;301;Montgon;69;4;73
44;Grand Est;08;1;02;302;Monthermé;2237;84;2321
44;Grand Est;08;4;01;303;Monthois;385;10;395
44;Grand Est;08;1;12;304;Montigny-sur-Meuse;81;2;83
44;Grand Est;08;1;10;305;Montigny-sur-Vence;255;5;260
44;Grand Est;08;2;11;306;Mont-Laurent;56;3;59
44;Grand Est;08;2;17;307;Montmeillant;82;1;83
44;Grand Est;08;4;01;308;Mont-Saint-Martin;87;0;87
44;Grand Est;08;4;01;309;Mont-Saint-Remy;57;1;58
44;Grand Est;08;4;01;310;Mouron;69;5;74
44;Grand Est;08;3;03;311;Mouzon;2226;40;2266
44;Grand Est;08;1;13;312;Murtin-et-Bogny;186;7;193
44;Grand Est;08;2;11;313;Nanteuil-sur-Aisne;145;4;149
44;Grand Est;08;2;08;314;Neuflize;800;23;823
44;Grand Est;08;1;17;315;Neufmaison;74;2;76
44;Grand Est;08;1;18;316;Neufmanil;1006;15;1021
44;Grand Est;08;3;19;317;La Neuville-à-Maire;115;4;119
44;Grand Est;08;1;13;318;La Neuville-aux-Joûtes;357;8;365
44;Grand Est;08;1;13;319;Neuville-lez-Beaulieu;333;8;341
44;Grand Est;08;2;08;320;La Neuville-en-Tourne-à-Fuy;555;16;571
44;Grand Est;08;4;01;321;Neuville-Day;168;4;172
44;Grand Est;08;1;13;322;Neuville-lès-This;373;14;387
44;Grand Est;08;2;17;323;La Neuville-lès-Wasigny;160;1;161
44;Grand Est;08;2;17;324;Neuvizy;114;2;116
44;Grand Est;08;4;19;325;Noirval;26;1;27
44;Grand Est;08;4;19;326;Nouart;121;2;123
44;Grand Est;08;1;10;327;Nouvion-sur-Meuse;2241;37;2278
44;Grand Est;08;1;05;328;Nouzonville;5689;109;5798
44;Grand Est;08;2;17;329;Novion-Porcien;497;11;508
44;Grand Est;08;2;11;330;Novy-Chevrières;765;9;774
44;Grand Est;08;3;14;331;Noyers-Pont-Maugis;669;14;683
44;Grand Est;08;4;19;332;Oches;44;4;48
44;Grand Est;08;4;01;333;Olizy-Primat;237;9;246
44;Grand Est;08;1;10;334;Omicourt;38;2;40
44;Grand Est;08;1;10;335;Omont;81;1;82
44;Grand Est;08;3;03;336;Osnes;230;3;233
44;Grand Est;08;4;01;338;Pauvres;188;3;191
44;Grand Est;08;2;08;339;Perthes;307;4;311
44;Grand Est;08;2;08;340;Poilcourt-Sydney;176;4;180
44;Grand Est;08;1;10;341;Poix-Terron;864;40;904
44;Grand Est;08;3;16;342;Pouru-aux-Bois;245;5;250
44;Grand Est;08;3;16;343;Pouru-Saint-Remy;1144;23;1167
44;Grand Est;08;1;17;344;Prez;134;2;136
44;Grand Est;08;1;04;346;Prix-lès-Mézières;1350;36;1386
44;Grand Est;08;3;03;347;Puilly-et-Charbeaux;220;5;225
44;Grand Est;08;2;17;348;Puiseux;113;3;116
44;Grand Est;08;3;03;349;Pure;576;6;582
44;Grand Est;08;4;19;350;Quatre-Champs;237;3;240
44;Grand Est;08;4;01;351;Quilly;84;0;84
44;Grand Est;08;1;17;352;Raillicourt;199;4;203
44;Grand Est;08;1;09;353;Rancennes;723;22;745
44;Grand Est;08;3;19;354;Raucourt-et-Flaba;824;13;837
44;Grand Est;08;1;13;355;Regniowez;387;7;394
44;Grand Est;08;2;17;356;Remaucourt;177;1;178
44;Grand Est;08;3;19;357;Remilly-Aillicourt;784;15;799
44;Grand Est;08;1;13;358;Remilly-les-Pothées;251;4;255
44;Grand Est;08;2;17;360;Renneville;199;5;204
44;Grand Est;08;1;02;361;Renwez;1652;58;1710
44;Grand Est;08;2;11;362;Rethel;7467;297;7764
44;Grand Est;08;1;12;363;Revin;5836;124;5960
44;Grand Est;08;4;01;364;Rilly-sur-Aisne;132;2;134
44;Grand Est;08;1;13;365;Rimogne;1342;21;1363
44;Grand Est;08;2;17;366;Rocquigny;682;11;693
44;Grand Est;08;1;13;367;Rocroi;2283;29;2312
44;Grand Est;08;2;08;368;Roizy;220;3;223
44;Grand Est;08;2;17;369;La Romagne;131;3;134
44;Grand Est;08;1;17;370;Rouvroy-sur-Audry;572;6;578
44;Grand Est;08;2;17;372;Rubigny;67;0;67
44;Grand Est;08;1;17;373;Rumigny;293;4;297
44;Grand Est;08;4;01;374;La Sabotterie;121;0;121
44;Grand Est;08;3;03;375;Sachy;178;5;183
44;Grand Est;08;3;03;376;Sailly;251;5;256
44;Grand Est;08;3;14;377;Saint-Aignan;156;2;158
44;Grand Est;08;4;01;378;Saint-Clément-à-Arnes;108;1;109
44;Grand Est;08;4;01;379;Saint-Étienne-à-Arnes;243;10;253
44;Grand Est;08;2;08;380;Saint-Fergeux;216;4;220
44;Grand Est;08;2;08;381;Saint-Germainmont;821;12;833
44;Grand Est;08;2;17;382;Saint-Jean-aux-Bois;99;3;102
44;Grand Est;08;4;01;383;Saint-Juvin;102;4;106
44;Grand Est;08;4;01;384;Saint-Lambert-et-Mont-de-Jeux;144;3;147
44;Grand Est;08;1;18;385;Saint-Laurent;1071;171;1242
44;Grand Est;08;2;08;386;Saint-Loup-en-Champagne;344;7;351
44;Grand Est;08;4;01;387;Saint-Loup-Terrier;182;6;188
44;Grand Est;08;1;10;388;Saint-Marceau;344;11;355
44;Grand Est;08;1;13;389;Saint-Marcel;335;7;342
44;Grand Est;08;4;01;390;Sainte-Marie;79;4;83
44;Grand Est;08;3;15;391;Saint-Menges;947;16;963
44;Grand Est;08;4;01;392;Saint-Morel;197;11;208
44;Grand Est;08;4;01;393;Saint-Pierre-à-Arnes;66;1;67
44;Grand Est;08;4;19;394;Saint-Pierremont;72;3;75
44;Grand Est;08;1;10;395;Saint-Pierre-sur-Vence;136;4;140
44;Grand Est;08;2;08;396;Saint-Quentin-le-Petit;122;0;122
44;Grand Est;08;2;08;397;Saint-Remy-le-Petit;50;0;50
44;Grand Est;08;4;01;398;Sainte-Vaubourg;89;2;91
44;Grand Est;08;3;03;399;Sapogne-sur-Marche;139;3;142
44;Grand Est;08;1;10;400;Sapogne-et-Feuchères;515;10;525
44;Grand Est;08;4;01;401;Saulces-Champenoises;231;3;234
44;Grand Est;08;2;17;402;Saulces-Monclin;831;9;840
44;Grand Est;08;2;11;403;Sault-lès-Rethel;1916;16;1932
44;Grand Est;08;2;08;404;Sault-Saint-Remy;218;3;221
44;Grand Est;08;4;19;405;Sauville;235;8;243
44;Grand Est;08;4;01;406;Savigny-sur-Aisne;373;12;385
44;Grand Est;08;4;01;407;Séchault;59;0;59
44;Grand Est;08;1;05;408;Sécheval;561;10;571
44;Grand Est;08;3;99;409;Sedan;16092;337;16429
44;Grand Est;08;4;01;410;Semide;178;15;193
44;Grand Est;08;4;01;411;Semuy;89;0;89
44;Grand Est;08;4;01;412;Senuc;159;4;163
44;Grand Est;08;2;08;413;Seraincourt;264;3;267
44;Grand Est;08;2;17;415;Sery;338;12;350
44;Grand Est;08;2;11;416;Seuil;170;6;176
44;Grand Est;08;1;13;417;Sévigny-la-Forêt;278;8;286
44;Grand Est;08;2;08;418;Sévigny-Waleppe;224;3;227
44;Grand Est;08;1;17;419;Signy-l'Abbaye;1354;28;1382
44;Grand Est;08;1;13;420;Signy-le-Petit;1194;22;1216
44;Grand Est;08;3;03;421;Signy-Montlibert;94;0;94
44;Grand Est;08;1;10;422;Singly;135;4;139
44;Grand Est;08;4;19;424;Sommauthe;123;2;125
44;Grand Est;08;4;01;425;Sommerance;43;1;44
44;Grand Est;08;2;08;426;Son;98;0;98
44;Grand Est;08;2;11;427;Sorbon;205;1;206
44;Grand Est;08;2;17;428;Sorcy-Bauthémont;146;2;148
44;Grand Est;08;1;13;429;Sormonne;536;14;550
44;Grand Est;08;3;19;430;Stonne;39;2;41
44;Grand Est;08;4;01;431;Sugny;100;6;106
44;Grand Est;08;1;13;432;Sury;110;4;114
44;Grand Est;08;4;01;433;Suzanne;61;2;63
44;Grand Est;08;4;19;434;Sy;52;2;54
44;Grand Est;08;2;08;435;Tagnon;879;13;892
44;Grand Est;08;1;13;436;Taillette;407;7;414
44;Grand Est;08;4;19;437;Tailly;174;6;180
44;Grand Est;08;2;08;438;Taizy;104;2;106
44;Grand Est;08;4;19;439;Tannay;150;9;159
44;Grand Est;08;1;13;440;Tarzy;130;2;132
44;Grand Est;08;3;03;444;Tétaigne;129;4;133
44;Grand Est;08;3;14;445;Thelonne;419;2;421
44;Grand Est;08;4;19;446;Thénorgues;79;0;79
44;Grand Est;08;1;02;448;Thilay;1043;12;1055
44;Grand Est;08;1;17;449;Thin-le-Moutier;640;15;655
44;Grand Est;08;1;13;450;This;225;9;234
44;Grand Est;08;2;08;451;Le Thour;378;8;386
44;Grand Est;08;2;11;452;Thugny-Trugny;273;0;273
44;Grand Est;08;4;19;453;Toges;103;3;106
44;Grand Est;08;1;10;454;Touligny;86;2;88
44;Grand Est;08;4;01;455;Tourcelles-Chaumont;92;1;93
44;Grand Est;08;1;02;456;Tournavaux;232;4;236
44;Grand Est;08;1;04;457;Tournes;1067;27;1094
44;Grand Est;08;4;01;458;Tourteron;180;4;184
44;Grand Est;08;3;03;459;Tremblois-lès-Carignan;149;3;152
44;Grand Est;08;1;13;460;Tremblois-lès-Rocroi;153;0;153
44;Grand Est;08;4;19;461;Vandy;206;1;207
44;Grand Est;08;4;01;462;Vaux-Champagne;128;4;132
44;Grand Est;08;4;19;463;Vaux-en-Dieulet;55;1;56
44;Grand Est;08;4;01;464;Vaux-lès-Mouron;80;3;83
44;Grand Est;08;2;17;465;Vaux-lès-Rubigny;44;3;47
44;Grand Est;08;3;03;466;Vaux-lès-Mouzon;70;2;72
44;Grand Est;08;2;17;467;Vaux-Montreuil;108;0;108
44;Grand Est;08;1;17;468;Vaux-Villaine;193;0;193
44;Grand Est;08;1;10;469;Vendresse;478;12;490
44;Grand Est;08;4;19;470;Verpel;66;1;67
44;Grand Est;08;4;19;471;Verrières;31;2;33
44;Grand Est;08;2;17;472;Viel-Saint-Remy;297;2;299
44;Grand Est;08;2;08;473;Vieux-lès-Asfeld;305;7;312
44;Grand Est;08;2;08;476;Villers-devant-le-Thour;418;7;425
44;Grand Est;08;3;03;477;Villers-devant-Mouzon;108;0;108
44;Grand Est;08;1;10;478;Villers-le-Tilleul;237;3;240
44;Grand Est;08;2;17;479;Villers-le-Tourneur;196;2;198
44;Grand Est;08;1;18;480;Villers-Semeuse;3568;71;3639
44;Grand Est;08;3;14;481;Villers-sur-Bar;253;5;258
44;Grand Est;08;1;10;482;Villers-sur-le-Mont;105;3;108
44;Grand Est;08;1;18;483;Ville-sur-Lumes;524;13;537
44;Grand Est;08;2;08;484;Ville-sur-Retourne;82;1;83
44;Grand Est;08;3;03;485;Villy;204;11;215
44;Grand Est;08;1;09;486;Vireux-Molhain;1467;31;1498
44;Grand Est;08;1;09;487;Vireux-Wallerand;1954;55;2009
44;Grand Est;08;1;18;488;Vivier-au-Court;2918;83;3001
44;Grand Est;08;4;01;489;Voncq;218;3;221
44;Grand Est;08;4;19;490;Vouziers;4320;150;4470
44;Grand Est;08;3;14;491;Vrigne aux Bois;3572;76;3648
44;Grand Est;08;1;10;492;Vrigne-Meuse;319;8;327
44;Grand Est;08;3;14;494;Wadelincourt;459;5;464
44;Grand Est;08;2;17;496;Wagnon;131;1;132
44;Grand Est;08;1;04;497;Warcq;1197;25;1222
44;Grand Est;08;1;10;498;Warnécourt;385;16;401
44;Grand Est;08;2;17;499;Wasigny;321;3;324
44;Grand Est;08;2;17;500;Wignicourt;57;1;58
44;Grand Est;08;3;03;501;Williers;41;3;44
44;Grand Est;08;3;03;502;Yoncq;93;3;96
44;Grand Est;08;1;10;503;Yvernaumont;127;1;128
76;Occitanie;09;3;03;001;Aigues-Juntes;60;1;61
76;Occitanie;09;2;06;002;Aigues-Vives;645;20;665
76;Occitanie;09;2;09;003;L'Aiguillon;397;9;406
76;Occitanie;09;1;01;004;Albiès;121;7;128
76;Occitanie;09;3;03;005;Aleu;131;2;133
76;Occitanie;09;1;12;006;Alliat;54;0;54
76;Occitanie;09;3;03;007;Allières;72;0;72
76;Occitanie;09;3;03;008;Alos;122;2;124
76;Occitanie;09;3;03;009;Alzen;267;13;280
76;Occitanie;09;3;04;011;Antras;71;1;72
76;Occitanie;09;1;01;012;Appy;27;1;28
76;Occitanie;09;1;13;013;Arabaux;81;2;83
76;Occitanie;09;3;04;014;Argein;192;7;199
76;Occitanie;09;1;12;015;Arignac;692;8;700
76;Occitanie;09;1;12;016;Arnave;218;8;226
76;Occitanie;09;3;04;017;Arrien-en-Bethmale;111;2;113
76;Occitanie;09;3;04;018;Arrout;90;4;94
76;Occitanie;09;3;02;019;Artigat;562;10;572
76;Occitanie;09;1;01;020;Artigues;42;0;42
76;Occitanie;09;1;07;021;Artix;121;3;124
76;Occitanie;09;2;08;022;Arvigna;215;0;215
76;Occitanie;09;1;01;023;Ascou;120;1;121
76;Occitanie;09;1;01;024;Aston;207;5;212
76;Occitanie;09;3;04;025;Aucazein;55;3;58
76;Occitanie;09;3;04;026;Audressein;147;1;148
76;Occitanie;09;3;04;027;Augirein;79;2;81
76;Occitanie;09;3;03;029;Aulus-les-Bains;160;6;166
76;Occitanie;09;1;12;030;Auzat;469;10;479
76;Occitanie;09;1;01;031;Axiat;42;1;43
76;Occitanie;09;1;01;032;Ax-les-Thermes;1288;66;1354
76;Occitanie;09;3;11;033;Bagert;37;1;38
76;Occitanie;09;3;04;034;Balacet;34;2;36
76;Occitanie;09;3;04;035;Balaguères;196;2;198
76;Occitanie;09;3;11;037;Barjac;42;0;42
76;Occitanie;09;3;02;038;La Bastide-de-Besplas;383;7;390
76;Occitanie;09;2;06;039;La Bastide-de-Bousignac;340;13;353
76;Occitanie;09;2;10;040;La Bastide-de-Lordat;287;7;294
76;Occitanie;09;3;11;041;La Bastide-du-Salat;203;7;210
76;Occitanie;09;3;03;042;La Bastide-de-Sérou;980;14;994
76;Occitanie;09;2;06;043;La Bastide-sur-l'Hers;670;13;683
76;Occitanie;09;1;13;044;Baulou;169;3;172
76;Occitanie;09;1;12;045;Bédeilhac-et-Aynat;199;1;200
76;Occitanie;09;3;11;046;Bédeille;67;3;70
76;Occitanie;09;2;09;047;Bélesta;1072;19;1091
76;Occitanie;09;2;06;048;Belloc;80;1;81
76;Occitanie;09;1;13;049;Bénac;179;3;182
76;Occitanie;09;2;07;050;Benagues;527;7;534
76;Occitanie;09;2;09;051;Bénaix;152;4;156
76;Occitanie;09;2;06;052;Besset;162;8;170
76;Occitanie;09;1;01;053;Bestiac;19;3;22
76;Occitanie;09;3;11;054;Betchat;350;5;355
76;Occitanie;09;3;04;055;Bethmale;93;0;93
76;Occitanie;09;2;07;056;Bézac;394;10;404
76;Occitanie;09;3;03;057;Biert;317;5;322
76;Occitanie;09;1;12;058;Bompas;192;5;197
76;Occitanie;09;3;04;059;Bonac-Irazein;121;4;125
76;Occitanie;09;2;10;060;Bonnac;751;10;761
76;Occitanie;09;3;02;061;Les Bordes-sur-Arize;505;6;511
76;Occitanie;09;3;04;062;Bordes-Uchentein;199;5;204
76;Occitanie;09;1;13;063;Le Bosc;109;2;111
76;Occitanie;09;1;01;064;Bouan;39;0;39
76;Occitanie;09;3;03;065;Boussenac;213;1;214
76;Occitanie;09;1;13;066;Brassac;620;10;630
76;Occitanie;09;2;10;067;Brie;214;3;217
76;Occitanie;09;1;13;068;Burret;42;0;42
76;Occitanie;09;3;04;069;Buzan;26;0;26
76;Occitanie;09;1;01;070;Les Cabannes;337;8;345
76;Occitanie;09;3;03;071;Cadarcet;223;8;231
76;Occitanie;09;1;13;072;Calzan;34;0;34
76;Occitanie;09;3;02;073;Camarade;194;1;195
76;Occitanie;09;2;06;074;Camon;147;1;148
76;Occitanie;09;3;02;075;Campagne-sur-Arize;285;8;293
76;Occitanie;09;2;10;076;Canté;204;7;211
76;Occitanie;09;1;12;077;Capoulet-et-Junac;183;1;184
76;Occitanie;09;1;01;078;Carcanières;75;2;77
76;Occitanie;09;3;02;079;Carla-Bayle;796;14;810
76;Occitanie;09;2;09;080;Carla-de-Roquefort;176;2;178
76;Occitanie;09;2;08;081;Le Carlaret;275;11;286
76;Occitanie;09;3;03;082;Castelnau-Durban;453;8;461
76;Occitanie;09;3;02;083;Castéras;22;0;22
76;Occitanie;09;3;02;084;Castex;93;1;94
76;Occitanie;09;3;04;085;Castillon-en-Couserans;401;5;406
76;Occitanie;09;3;11;086;Caumont;332;5;337
76;Occitanie;09;1;01;087;Caussou;47;0;47
76;Occitanie;09;1;01;088;Caychax;15;0;15
76;Occitanie;09;2;06;089;Cazals-des-Baylès;57;2;59
76;Occitanie;09;1;13;090;Cazaux;37;6;43
76;Occitanie;09;3;11;091;Cazavet;204;3;207
76;Occitanie;09;1;12;092;Cazenave-Serres-et-Allens;60;3;63
76;Occitanie;09;1;12;093;Celles;157;0;157
76;Occitanie;09;3;11;094;Cérizols;137;9;146
76;Occitanie;09;3;04;095;Cescau;148;1;149
76;Occitanie;09;1;01;096;Château-Verdun;42;3;45
76;Occitanie;09;3;03;097;Clermont;115;0;115
76;Occitanie;09;3;11;098;Contrazy;68;2;70
76;Occitanie;09;1;05;099;Cos;394;19;413
76;Occitanie;09;3;03;100;Couflens;90;1;91
76;Occitanie;09;1;13;101;Coussa;282;3;285
76;Occitanie;09;2;06;102;Coutens;171;2;173
76;Occitanie;09;1;13;103;Crampagna;864;17;881
76;Occitanie;09;1;13;104;Dalou;770;19;789
76;Occitanie;09;3;02;105;Daumazan-sur-Arize;708;11;719
76;Occitanie;09;2;09;106;Dreuilhe;358;16;374
76;Occitanie;09;2;06;107;Dun;619;15;634
76;Occitanie;09;3;03;108;Durban-sur-Arize;178;4;182
76;Occitanie;09;3;02;109;Durfort;171;3;174
76;Occitanie;09;3;03;110;Encourtiech;90;4;94
76;Occitanie;09;3;04;111;Engomer;304;4;308
76;Occitanie;09;3;03;113;Ercé;562;3;565
76;Occitanie;09;3;03;114;Erp;130;2;132
76;Occitanie;09;2;06;115;Esclagne;133;2;135
76;Occitanie;09;2;07;116;Escosse;386;3;389
76;Occitanie;09;2;10;117;Esplas;107;6;113
76;Occitanie;09;3;03;118;Esplas-de-Sérou;184;4;188
76;Occitanie;09;3;04;119;Eycheil;546;6;552
76;Occitanie;09;3;11;120;Fabas;349;4;353
76;Occitanie;09;1;05;121;Ferrières-sur-Ariège;753;100;853
76;Occitanie;09;1;05;122;Foix;9493;325;9818
76;Occitanie;09;3;02;123;Fornex;113;1;114
76;Occitanie;09;3;02;124;Le Fossat;1046;14;1060
76;Occitanie;09;2;09;125;Fougax-et-Barrineuf;432;5;437
76;Occitanie;09;2;09;126;Freychenet;85;3;88
76;Occitanie;09;3;02;127;Gabre;125;4;129
76;Occitanie;09;3;11;128;Gajan;308;10;318
76;Occitanie;09;3;04;129;Galey;115;0;115
76;Occitanie;09;1;05;130;Ganac;726;9;735
76;Occitanie;09;1;01;131;Garanou;147;0;147
76;Occitanie;09;2;10;132;Gaudiès;250;3;253
76;Occitanie;09;1;12;133;Génat;22;1;23
76;Occitanie;09;1;12;134;Gestiès;32;1;33
76;Occitanie;09;1;12;136;Gourbit;74;3;77
76;Occitanie;09;1;13;137;Gudas;202;4;206
76;Occitanie;09;1;13;138;L'Herm;196;26;222
76;Occitanie;09;1;01;139;L'Hospitalet-près-l'Andorre;102;0;102
76;Occitanie;09;1;01;140;Ignaux;119;6;125
76;Occitanie;09;3;04;141;Illartein;73;0;73
76;Occitanie;09;2;09;142;Ilhat;120;0;120
76;Occitanie;09;1;12;143;Illier-et-Laramade;33;0;33
76;Occitanie;09;2;08;145;Les Issards;243;9;252
76;Occitanie;09;2;10;146;Justiniac;57;0;57
76;Occitanie;09;2;10;147;Labatut;176;1;177
76;Occitanie;09;3;11;148;Lacave;124;5;129
76;Occitanie;09;3;03;149;Lacourt;193;4;197
76;Occitanie;09;2;06;150;Lagarde;201;6;207
76;Occitanie;09;3;02;151;Lanoux;51;1;52
76;Occitanie;09;1;12;152;Lapège;23;1;24
76;Occitanie;09;2;06;153;Lapenne;120;4;124
76;Occitanie;09;3;03;154;Larbont;59;2;61
76;Occitanie;09;1;01;155;Larcat;47;0;47
76;Occitanie;09;1;01;156;Larnat;20;0;20
76;Occitanie;09;2;06;157;Laroque-d'Olmes;2405;53;2458
76;Occitanie;09;3;11;158;Lasserre;251;7;258
76;Occitanie;09;1;01;159;Lassur;97;0;97
76;Occitanie;09;2;09;160;Lavelanet;6031;165;6196
76;Occitanie;09;2;06;161;Léran;610;15;625
76;Occitanie;09;1;12;162;Lercoul;16;0;16
76;Occitanie;09;2;07;163;Lescousse;79;0;79
76;Occitanie;09;3;03;164;Lescure;493;23;516
76;Occitanie;09;2;09;165;Lesparrou;233;1;234
76;Occitanie;09;2;09;166;Leychert;99;6;105
76;Occitanie;09;3;02;167;Lézat-sur-Lèze;2348;40;2388
76;Occitanie;09;2;09;168;Lieurac;185;9;194
76;Occitanie;09;2;06;169;Limbrassac;125;3;128
76;Occitanie;09;2;10;170;Lissac;255;6;261
76;Occitanie;09;1;01;171;Lordat;70;0;70
76;Occitanie;09;3;02;172;Loubaut;26;0;26
76;Occitanie;09;1;13;173;Loubens;281;5;286
76;Occitanie;09;1;13;174;Loubières;355;13;368
76;Occitanie;09;2;08;175;Ludiès;94;4;98
76;Occitanie;09;1;01;176;Luzenac;521;9;530
76;Occitanie;09;2;07;177;Madière;241;6;247
76;Occitanie;09;2;06;178;Malegoude;45;4;49
76;Occitanie;09;1;13;179;Malléon;78;1;79
76;Occitanie;09;2;06;180;Manses;120;1;121
76;Occitanie;09;3;02;181;Le Mas-d'Azil;1145;9;1154
76;Occitanie;09;3;03;182;Massat;709;10;719
76;Occitanie;09;3;11;183;Mauvezin-de-Prat;102;4;106
76;Occitanie;09;3;11;184;Mauvezin-de-Sainte-Croix;45;1;46
76;Occitanie;09;2;10;185;Mazères;3873;83;3956
76;Occitanie;09;3;02;186;Méras;104;0;104
76;Occitanie;09;3;11;187;Mercenac;355;10;365
76;Occitanie;09;1;12;188;Mercus-Garrabet;1203;24;1227
76;Occitanie;09;1;01;189;Mérens-les-Vals;168;4;172
76;Occitanie;09;3;11;190;Mérigon;114;1;115
76;Occitanie;09;1;12;192;Miglos;114;3;117
76;Occitanie;09;1;01;193;Mijanès;61;0;61
76;Occitanie;09;2;06;194;Mirepoix;3102;124;3226
76;Occitanie;09;3;02;195;Monesple;30;0;30
76;Occitanie;09;3;03;196;Montagagne;80;1;81
76;Occitanie;09;1;01;197;Montaillou;17;0;17
76;Occitanie;09;3;11;198;Montardit;207;4;211
76;Occitanie;09;2;10;199;Montaut;696;18;714
76;Occitanie;09;2;06;200;Montbel;99;2;101
76;Occitanie;09;3;04;201;Montégut-en-Couserans;78;1;79
76;Occitanie;09;1;13;202;Montégut-Plantaurel;335;9;344
76;Occitanie;09;3;03;203;Montels;156;9;165
76;Occitanie;09;3;11;204;Montesquieu-Avantès;250;10;260
76;Occitanie;09;3;02;205;Montfa;81;2;83
76;Occitanie;09;2;09;206;Montferrier;534;13;547
76;Occitanie;09;1;05;207;Montgaillard;1484;31;1515
76;Occitanie;09;3;11;208;Montgauch;125;0;125
76;Occitanie;09;3;11;209;Montjoie-en-Couserans;1034;21;1055
76;Occitanie;09;1;12;210;Montoulieu;408;7;415
76;Occitanie;09;2;09;211;Montségur;117;2;119
76;Occitanie;09;3;03;212;Montseron;103;1;104
76;Occitanie;09;2;06;213;Moulin-Neuf;243;3;246
76;Occitanie;09;3;04;214;Moulis;757;12;769
76;Occitanie;09;2;09;215;Nalzen;122;4;126
76;Occitanie;09;3;03;216;Nescus;62;1;63
76;Occitanie;09;1;12;217;Niaux;154;2;156
76;Occitanie;09;1;01;218;Orgeix;88;1;89
76;Occitanie;09;3;04;219;Orgibet;195;4;199
76;Occitanie;09;1;01;220;Orlu;164;3;167
76;Occitanie;09;1;01;221;Ornolac-Ussat-les-Bains;243;3;246
76;Occitanie;09;1;12;222;Orus;26;0;26
76;Occitanie;09;3;03;223;Oust;555;7;562
76;Occitanie;09;3;02;224;Pailhès;474;8;482
76;Occitanie;09;2;99;225;Pamiers;15659;478;16137
76;Occitanie;09;1;01;226;Pech;37;0;37
76;Occitanie;09;2;09;227;Péreille;199;3;202
76;Occitanie;09;1;01;228;Perles-et-Castelet;224;5;229
76;Occitanie;09;2;06;229;Le Peyrat;465;8;473
76;Occitanie;09;1;01;230;Le Pla;60;0;60
76;Occitanie;09;3;03;231;Le Port;164;1;165
76;Occitanie;09;1;01;232;Prades;32;0;32
76;Occitanie;09;2;06;233;Pradettes;47;1;48
76;Occitanie;09;1;13;234;Pradières;119;3;122
76;Occitanie;09;3;11;235;Prat-Bonrepaux;864;16;880
76;Occitanie;09;1;12;236;Prayols;368;16;384
76;Occitanie;09;1;01;237;Le Puch;30;1;31
76;Occitanie;09;2;08;238;Les Pujols;831;17;848
76;Occitanie;09;1;01;239;Quérigut;136;1;137
76;Occitanie;09;1;12;240;Quié;297;3;300
76;Occitanie;09;1;12;241;Rabat-les-Trois-Seigneurs;366;5;371
76;Occitanie;09;2;09;242;Raissac;53;1;54
76;Occitanie;09;2;06;243;Régat;84;3;87
76;Occitanie;09;2;06;244;Rieucros;712;12;724
76;Occitanie;09;1;07;245;Rieux-de-Pelleport;1284;35;1319
76;Occitanie;09;3;03;246;Rimont;529;20;549
76;Occitanie;09;3;03;247;Rivèrenert;163;9;172
76;Occitanie;09;2;09;249;Roquefixade;147;4;151
76;Occitanie;09;2;09;250;Roquefort-les-Cascades;93;2;95
76;Occitanie;09;2;06;251;Roumengoux;166;8;174
76;Occitanie;09;1;01;252;Rouze;88;0;88
76;Occitanie;09;3;02;253;Sabarat;384;6;390
76;Occitanie;09;2;08;254;Saint-Amadou;241;6;247
76;Occitanie;09;2;07;255;Saint-Amans;43;0;43
76;Occitanie;09;1;07;256;Saint-Bauzeil;58;0;58
76;Occitanie;09;3;11;257;Sainte-Croix-Volvestre;620;16;636
76;Occitanie;09;1;13;258;Saint-Félix-de-Rieutord;464;9;473
76;Occitanie;09;2;06;259;Saint-Félix-de-Tournegat;152;4;156
76;Occitanie;09;2;06;260;Sainte-Foi;29;0;29
76;Occitanie;09;3;04;261;Saint-Girons;6418;401;6819
76;Occitanie;09;2;09;262;Saint-Jean-d'Aigues-Vives;382;6;388
76;Occitanie;09;3;04;263;Saint-Jean-du-Castillonnais;22;1;23
76;Occitanie;09;1;13;264;Saint-Jean-de-Verges;1275;18;1293
76;Occitanie;09;2;07;265;Saint-Jean-du-Falga;2859;63;2922
76;Occitanie;09;2;06;266;Saint-Julien-de-Gras-Capou;66;2;68
76;Occitanie;09;3;04;267;Saint-Lary;127;2;129
76;Occitanie;09;3;11;268;Saint-Lizier;1365;31;1396
76;Occitanie;09;1;13;269;Saint-Martin-de-Caralp;363;11;374
76;Occitanie;09;2;07;270;Saint-Martin-d'Oydes;220;5;225
76;Occitanie;09;2;07;271;Saint-Michel;81;2;83
76;Occitanie;09;1;12;272;Saint-Paul-de-Jarrat;1330;27;1357
76;Occitanie;09;1;05;273;Saint-Pierre-de-Rivière;665;23;688
76;Occitanie;09;2;06;274;Saint-Quentin-la-Tour;337;6;343
76;Occitanie;09;2;10;275;Saint-Quirc;371;8;379
76;Occitanie;09;2;07;276;Saint-Victor-Rouzaud;220;10;230
76;Occitanie;09;3;02;277;Saint-Ybars;690;11;701
76;Occitanie;09;3;04;279;Salsein;47;2;49
76;Occitanie;09;1;12;280;Saurat;641;9;650
76;Occitanie;09;2;09;281;Sautel;121;2;123
76;Occitanie;09;2;10;282;Saverdun;4828;158;4986
76;Occitanie;09;1;01;283;Savignac-les-Ormeaux;389;15;404
76;Occitanie;09;1;13;284;Ségura;187;6;193
76;Occitanie;09;3;03;285;Seix;708;14;722
76;Occitanie;09;1;01;287;Senconac;13;0;13
76;Occitanie;09;3;11;289;Lorp-Sentaraille;1491;35;1526
76;Occitanie;09;3;04;290;Sentein;155;3;158
76;Occitanie;09;3;03;291;Sentenac-d'Oust;105;3;108
76;Occitanie;09;3;03;292;Sentenac-de-Sérou;56;0;56
76;Occitanie;09;1;13;293;Serres-sur-Arget;680;10;690
76;Occitanie;09;3;02;294;Sieuras;103;1;104
76;Occitanie;09;1;12;295;Siguer;95;0;95
76;Occitanie;09;1;01;296;Aulos-Sinsat;152;2;154
76;Occitanie;09;3;04;297;Sor;28;0;28
76;Occitanie;09;1;01;298;Sorgeat;80;2;82
76;Occitanie;09;3;03;299;Soueix-Rogalle;426;7;433
76;Occitanie;09;1;09;300;Soula;174;7;181
76;Occitanie;09;3;03;301;Soulan;376;2;378
76;Occitanie;09;1;12;303;Surba;322;8;330
76;Occitanie;09;3;03;304;Suzan;14;1;15
76;Occitanie;09;2;06;305;Tabre;354;8;362
76;Occitanie;09;1;12;306;Tarascon-sur-Ariège;3024;32;3056
76;Occitanie;09;3;11;307;Taurignan-Castet;158;2;160
76;Occitanie;09;3;11;308;Taurignan-Vieux;208;8;216
76;Occitanie;09;2;06;309;Teilhet;152;2;154
76;Occitanie;09;3;02;310;Thouars-sur-Arize;47;2;49
76;Occitanie;09;1;01;311;Tignac;22;0;22
76;Occitanie;09;2;08;312;La Tour-du-Crieu;3218;68;3286
76;Occitanie;09;3;11;313;Tourtouse;155;7;162
76;Occitanie;09;2;06;314;Tourtrol;274;15;289
76;Occitanie;09;2;10;315;Trémoulet;129;0;129
76;Occitanie;09;2;06;316;Troye-d'Ariège;101;1;102
76;Occitanie;09;1;01;318;Unac;125;1;126
76;Occitanie;09;2;07;319;Unzent;117;4;121
76;Occitanie;09;1;01;320;Urs;29;1;30
76;Occitanie;09;1;01;321;Ussat;317;4;321
76;Occitanie;09;3;03;322;Ustou;272;10;282
76;Occitanie;09;2;06;323;Vals;92;1;93
76;Occitanie;09;1;13;324;Varilhes;3495;55;3550
76;Occitanie;09;1;01;325;Vaychis;29;0;29
76;Occitanie;09;1;01;326;Vèbre;124;1;125
76;Occitanie;09;1;13;327;Ventenac;234;2;236
76;Occitanie;09;1;01;328;Verdun;216;9;225
76;Occitanie;09;1;13;329;Vernajoul;673;21;694
76;Occitanie;09;1;01;330;Vernaux;28;0;28
76;Occitanie;09;2;10;331;Le Vernet;718;6;724
76;Occitanie;09;1;13;332;Verniolle;2252;68;2320
76;Occitanie;09;1;12;334;Val-de-Sos;561;64;625
76;Occitanie;09;3;04;335;Villeneuve;39;0;39
76;Occitanie;09;2;09;336;Villeneuve-d'Olmes;965;19;984
76;Occitanie;09;3;02;338;Villeneuve-du-Latou;155;4;159
76;Occitanie;09;2;10;339;Villeneuve-du-Paréage;769;15;784
76;Occitanie;09;1;13;340;Vira;156;4;160
76;Occitanie;09;2;06;341;Viviès;146;0;146
76;Occitanie;09;3;02;342;Sainte-Suzanne;239;2;241
44;Grand Est;10;1;03;002;Ailleville;237;5;242
44;Grand Est;10;3;01;003;Aix-Villemaur-Pâlis;3546;38;3584
44;Grand Est;10;3;02;004;Allibaudières;207;2;209
44;Grand Est;10;1;17;005;Amance;255;12;267
44;Grand Est;10;3;02;006;Arcis-sur-Aube;2803;81;2884
44;Grand Est;10;1;03;007;Arconville;104;2;106
44;Grand Est;10;1;17;008;Argançon;113;1;114
44;Grand Est;10;3;08;009;Arrelles;87;2;89
44;Grand Est;10;1;05;010;Arrembécourt;47;2;49
44;Grand Est;10;1;03;011;Arrentières;210;1;211
44;Grand Est;10;1;03;012;Arsonval;306;5;311
44;Grand Est;10;3;08;013;Assenay;145;2;147
44;Grand Est;10;3;05;014;Assencières;181;1;182
44;Grand Est;10;3;02;015;Aubeterre;376;6;382
44;Grand Est;10;1;05;017;Aulnay;130;3;133
44;Grand Est;10;3;01;018;Auxon;1023;10;1033
44;Grand Est;10;3;05;019;Val-d'Auzon;379;5;384
44;Grand Est;10;2;11;020;Avant-lès-Marcilly;505;10;515
44;Grand Est;10;3;02;021;Avant-lès-Ramerupt;157;4;161
44;Grand Est;10;3;08;022;Avirey-Lingey;200;12;212
44;Grand Est;10;2;11;023;Avon-la-Pèze;187;7;194
44;Grand Est;10;3;08;024;Avreuil;169;3;172
44;Grand Est;10;3;08;025;Bagneux-la-Fosse;171;4;175
44;Grand Est;10;1;05;026;Bailly-le-Franc;36;0;36
44;Grand Est;10;1;05;027;Balignicourt;60;5;65
44;Grand Est;10;3;08;028;Balnot-la-Grange;120;0;120
44;Grand Est;10;3;08;029;Balnot-sur-Laignes;155;2;157
44;Grand Est;10;3;11;030;Barberey-Saint-Sulpice;1530;30;1560
44;Grand Est;10;2;07;031;Barbuise;471;8;479
44;Grand Est;10;1;03;032;Baroville;302;9;311
44;Grand Est;10;1;03;033;Bar-sur-Aube;4787;193;4980
44;Grand Est;10;3;04;034;Bar-sur-Seine;2961;196;3157
44;Grand Est;10;1;03;035;Bayel;751;9;760
44;Grand Est;10;3;01;037;Bercenay-en-Othe;447;10;457
44;Grand Est;10;2;11;038;Bercenay-le-Hayer;194;2;196
44;Grand Est;10;1;03;039;Bergères;117;5;122
44;Grand Est;10;3;08;040;Bernon;164;8;172
44;Grand Est;10;3;04;041;Bertignolles;50;1;51
44;Grand Est;10;3;01;042;Bérulle;206;4;210
44;Grand Est;10;2;06;043;Bessy;127;3;130
44;Grand Est;10;1;05;044;Bétignicourt;34;0;34
44;Grand Est;10;1;17;045;Beurey;182;9;191
44;Grand Est;10;1;05;046;Blaincourt-sur-Aube;114;2;116
44;Grand Est;10;1;05;047;Blignicourt;41;1;42
44;Grand Est;10;1;03;048;Bligny;161;4;165
44;Grand Est;10;3;08;049;Les Bordes-Aumont;531;9;540
44;Grand Est;10;1;17;050;Bossancourt;198;3;201
44;Grand Est;10;3;08;051;Bouilly;1087;47;1134
44;Grand Est;10;2;06;052;Boulages;216;4;220
44;Grand Est;10;3;17;053;Bouranton;594;9;603
44;Grand Est;10;2;11;054;Bourdenay;113;1;114
44;Grand Est;10;3;04;055;Bourguignons;266;12;278
44;Grand Est;10;3;05;056;Bouy-Luxembourg;240;1;241
44;Grand Est;10;2;07;057;Bouy-sur-Orvin;53;1;54
44;Grand Est;10;3;08;058;Bragelogne-Beauvoir;242;9;251
44;Grand Est;10;1;05;059;Braux;112;5;117
44;Grand Est;10;3;17;060;Bréviandes;2851;56;2907
44;Grand Est;10;3;05;061;Brévonnes;673;12;685
44;Grand Est;10;3;04;062;Briel-sur-Barse;201;2;203
44;Grand Est;10;1;05;063;Brienne-la-Vieille;411;13;424
44;Grand Est;10;1;05;064;Brienne-le-Château;2772;26;2798
44;Grand Est;10;3;02;065;Brillecourt;85;1;86
44;Grand Est;10;3;01;066;Bucey-en-Othe;436;10;446
44;Grand Est;10;3;17;067;Buchères;1827;28;1855
44;Grand Est;10;3;04;068;Buxeuil;125;6;131
44;Grand Est;10;3;04;069;Buxières-sur-Arce;116;0;116
44;Grand Est;10;3;04;070;Celles-sur-Ource;490;19;509
44;Grand Est;10;3;04;071;Chacenay;51;2;53
44;Grand Est;10;1;03;072;La Chaise;34;0;34
44;Grand Est;10;1;05;073;Chalette-sur-Voire;127;2;129
44;Grand Est;10;3;01;074;Chamoy;507;8;515
44;Grand Est;10;2;06;075;Champfleury;96;6;102
44;Grand Est;10;1;03;076;Champignol-lez-Mondeville;264;7;271
44;Grand Est;10;3;02;077;Champigny-sur-Aube;110;2;112
44;Grand Est;10;1;17;078;Champ-sur-Barse;27;0;27
44;Grand Est;10;3;08;079;Channes;129;2;131
44;Grand Est;10;3;08;080;Chaource;1038;10;1048
44;Grand Est;10;3;14;081;La Chapelle-Saint-Luc;11741;92;11833
44;Grand Est;10;2;06;082;Chapelle-Vallon;245;4;249
44;Grand Est;10;3;04;083;Chappes;338;6;344
44;Grand Est;10;3;02;084;Charmont-sous-Barbuise;1019;28;1047
44;Grand Est;10;2;11;085;Charmoy;65;0;65
44;Grand Est;10;2;06;086;Charny-le-Bachot;264;8;272
44;Grand Est;10;3;08;087;Chaserey;53;1;54
44;Grand Est;10;2;06;089;Châtres;698;13;711
44;Grand Est;10;2;06;090;Chauchigny;232;2;234
44;Grand Est;10;3;02;091;Chaudrey;141;4;145
44;Grand Est;10;3;04;092;Chauffour-lès-Bailly;128;0;128
44;Grand Est;10;1;03;093;Chaumesnil;103;2;105
44;Grand Est;10;1;05;094;Chavanges;588;12;600
44;Grand Est;10;3;02;095;Le Chêne;289;5;294
44;Grand Est;10;3;01;096;Chennegy;433;8;441
44;Grand Est;10;3;04;097;Chervey;161;4;165
44;Grand Est;10;3;08;098;Chesley;322;9;331
44;Grand Est;10;3;01;099;Chessy-les-Prés;519;14;533
44;Grand Est;10;3;17;100;Clérey;1127;23;1150
44;Grand Est;10;3;02;101;Coclois;173;3;176
44;Grand Est;10;1;03;102;Colombé-la-Fosse;189;4;193
44;Grand Est;10;1;03;103;Colombé-le-Sec;153;1;154
44;Grand Est;10;3;08;104;Cormost;306;3;309
44;Grand Est;10;1;05;105;Courcelles-sur-Voire;26;1;27
44;Grand Est;10;2;07;106;Courceroy;136;5;141
44;Grand Est;10;3;01;107;Coursan-en-Othe;104;0;104
44;Grand Est;10;3;01;108;Courtaoult;82;0;82
44;Grand Est;10;3;04;109;Courtenot;232;8;240
44;Grand Est;10;3;17;110;Courteranges;559;11;570
44;Grand Est;10;3;04;111;Courteron;105;5;110
44;Grand Est;10;3;08;112;Coussegrey;177;2;179
44;Grand Est;10;1;03;113;Couvignon;199;6;205
44;Grand Est;10;2;09;114;Crancey;706;14;720
44;Grand Est;10;3;06;115;Creney-près-Troyes;1982;34;2016
44;Grand Est;10;3;08;116;Crésantignes;316;4;320
44;Grand Est;10;1;03;117;Crespy-le-Neuf;158;7;165
44;Grand Est;10;3;01;118;Les Croûtes;93;4;97
44;Grand Est;10;3;04;119;Cunfin;174;4;178
44;Grand Est;10;3;08;120;Cussangy;213;2;215
44;Grand Est;10;3;02;121;Dampierre;322;8;330
44;Grand Est;10;3;01;122;Davrey;225;4;229
44;Grand Est;10;1;05;123;Dienville;873;16;889
44;Grand Est;10;2;11;124;Dierrey-Saint-Julien;262;13;275
44;Grand Est;10;3;11;125;Dierrey-Saint-Pierre;307;5;312
44;Grand Est;10;1;17;126;Dolancourt;133;4;137
44;Grand Est;10;3;02;127;Dommartin-le-Coq;58;0;58
44;Grand Est;10;1;05;128;Donnement;73;1;74
44;Grand Est;10;3;05;129;Dosches;299;9;308
44;Grand Est;10;3;02;130;Dosnon;101;6;107
44;Grand Est;10;2;06;131;Droupt-Saint-Basle;360;4;364
44;Grand Est;10;2;06;132;Droupt-Sainte-Marie;234;5;239
44;Grand Est;10;3;01;133;Eaux-Puiseaux;260;11;271
44;Grand Est;10;2;11;134;Échemines;88;6;94
44;Grand Est;10;1;03;135;Éclance;101;3;104
44;Grand Est;10;3;04;136;Éguilly-sous-Bois;117;1;118
44;Grand Est;10;1;03;137;Engente;33;0;33
44;Grand Est;10;1;05;138;Épagne;142;2;144
44;Grand Est;10;1;03;139;Épothémont;166;4;170
44;Grand Est;10;3;01;140;Ervy-le-Châtel;1142;9;1151
44;Grand Est;10;3;04;141;Essoyes;721;12;733
44;Grand Est;10;3;01;142;Estissac;1851;19;1870
44;Grand Est;10;3;08;143;Étourvy;169;5;174
44;Grand Est;10;2;06;144;Étrelles-sur-Aube;154;3;157
44;Grand Est;10;2;11;145;Faux-Villecerf;212;7;219
44;Grand Est;10;2;11;146;Fay-lès-Marcilly;90;3;93
44;Grand Est;10;3;08;147;Fays-la-Chapelle;126;4;130
44;Grand Est;10;2;07;148;Ferreux-Quincey;410;10;420
44;Grand Est;10;3;02;149;Feuges;333;4;337
44;Grand Est;10;1;03;150;Fontaine;253;5;258
44;Grand Est;10;2;06;151;Fontaine-les-Grès;877;9;886
44;Grand Est;10;2;07;153;Fontaine-Mâcon;621;14;635
44;Grand Est;10;2;07;154;Fontenay-de-Bossery;71;1;72
44;Grand Est;10;3;04;155;Fontette;190;6;196
44;Grand Est;10;3;01;156;Fontvannes;706;8;714
44;Grand Est;10;2;11;157;La Fosse-Corduan;215;6;221
44;Grand Est;10;3;04;158;Fouchères;535;16;551
44;Grand Est;10;3;04;159;Fralignes;88;1;89
44;Grand Est;10;1;03;160;Fravaux;37;1;38
44;Grand Est;10;1;03;161;Fresnay;49;3;52
44;Grand Est;10;3;17;162;Fresnoy-le-Château;287;6;293
44;Grand Est;10;1;03;163;Fuligny;43;2;45
44;Grand Est;10;2;09;164;Gélannes;735;10;745
44;Grand Est;10;3;05;165;Géraudot;337;6;343
44;Grand Est;10;2;06;166;Les Grandes-Chapelles;398;6;404
44;Grand Est;10;3;02;167;Grandville;91;0;91
44;Grand Est;10;3;08;168;Les Granges;79;1;80
44;Grand Est;10;2;07;169;Gumery;220;8;228
44;Grand Est;10;3;04;170;Gyé-sur-Seine;490;9;499
44;Grand Est;10;1;05;171;Hampigny;231;9;240
44;Grand Est;10;3;02;172;Herbisse;155;1;156
44;Grand Est;10;3;17;173;Isle-Aumont;462;8;470
44;Grand Est;10;3;02;174;Isle-Aubigny;169;3;172
44;Grand Est;10;1;05;175;Jasseines;177;3;180
44;Grand Est;10;1;03;176;Jaucourt;164;7;171
44;Grand Est;10;3;08;177;Javernant;148;7;155
44;Grand Est;10;1;17;178;Jessains;263;6;269
44;Grand Est;10;3;08;179;Jeugny;472;10;482
44;Grand Est;10;1;05;180;Joncreuil;96;4;100
44;Grand Est;10;3;04;181;Jully-sur-Sarce;221;12;233
44;Grand Est;10;1;03;182;Juvancourt;119;1;120
44;Grand Est;10;1;05;183;Juvanzé;35;1;36
44;Grand Est;10;1;03;184;Juzanvigny;128;1;129
44;Grand Est;10;3;08;185;Lagesse;209;4;213
44;Grand Est;10;3;08;186;Laines-aux-Bois;529;16;545
44;Grand Est;10;3;04;187;Landreville;400;10;410
44;Grand Est;10;3;08;188;Lantages;215;7;222
44;Grand Est;10;1;05;189;Lassicourt;59;0;59
44;Grand Est;10;3;17;190;Laubressel;569;6;575
44;Grand Est;10;3;06;191;Lavau;910;10;920
44;Grand Est;10;1;05;192;Lentilles;127;1;128
44;Grand Est;10;1;05;193;Lesmont;303;7;310
44;Grand Est;10;1;03;194;Lévigny;95;2;97
44;Grand Est;10;3;02;195;Lhuître;296;4;300
44;Grand Est;10;3;08;196;Lignières;209;1;210
44;Grand Est;10;1;03;197;Lignol-le-Château;180;11;191
44;Grand Est;10;3;08;198;Lirey;99;3;102
44;Grand Est;10;3;04;199;Loches-sur-Ource;349;6;355
44;Grand Est;10;1;17;200;La Loge-aux-Chèvres;91;3;94
44;Grand Est;10;3;08;201;La Loge-Pomblin;69;0;69
44;Grand Est;10;3;08;202;Les Loges-Margueron;218;80;298
44;Grand Est;10;1;03;203;Longchamp-sur-Aujon;390;14;404
44;Grand Est;10;3;08;204;Longeville-sur-Mogne;147;3;150
44;Grand Est;10;1;17;205;Longpré-le-Sec;93;2;95
44;Grand Est;10;3;02;206;Longsols;126;1;127
44;Grand Est;10;2;06;207;Longueville-sur-Aube;128;1;129
44;Grand Est;10;2;07;208;La Louptière-Thénard;290;12;302
44;Grand Est;10;3;17;209;Lusigny-sur-Barse;2207;54;2261
44;Grand Est;10;3;02;210;Luyères;455;13;468
44;Grand Est;10;3;11;211;Macey;971;15;986
44;Grand Est;10;3;08;212;Machy;116;4;120
44;Grand Est;10;3;04;213;Magnant;160;3;163
44;Grand Est;10;1;05;214;Magnicourt;87;1;88
44;Grand Est;10;1;17;215;Magny-Fouchard;261;4;265
44;Grand Est;10;3;02;216;Mailly-le-Camp;1933;25;1958
44;Grand Est;10;1;17;217;Maison-des-Champs;32;0;32
44;Grand Est;10;3;08;218;Maisons-lès-Chaource;164;1;165
44;Grand Est;10;1;03;219;Maisons-lès-Soulaines;67;3;70
44;Grand Est;10;2;09;220;Maizières-la-Grande-Paroisse;1498;43;1541
44;Grand Est;10;1;05;221;Maizières-lès-Brienne;162;0;162
44;Grand Est;10;3;01;222;Maraye-en-Othe;438;7;445
44;Grand Est;10;2;11;223;Marcilly-le-Hayer;727;9;736
44;Grand Est;10;2;11;224;Marigny-le-Châtel;1757;33;1790
44;Grand Est;10;2;07;225;Marnay-sur-Seine;234;7;241
44;Grand Est;10;3;04;226;Marolles-lès-Bailly;112;2;114
44;Grand Est;10;3;01;227;Marolles-sous-Lignières;329;5;334
44;Grand Est;10;1;05;228;Mathaux;198;2;200
44;Grand Est;10;3;08;229;Maupas;105;2;107
44;Grand Est;10;3;06;230;Mergey;680;10;690
44;Grand Est;10;2;07;231;Le Mériot;621;10;631
44;Grand Est;10;3;04;232;Merrey-sur-Arce;325;5;330
44;Grand Est;10;2;06;233;Méry-sur-Seine;1511;49;1560
44;Grand Est;10;2;06;234;Mesgrigny;277;1;278
44;Grand Est;10;3;02;235;Mesnil-la-Comtesse;47;0;47
44;Grand Est;10;3;02;236;Mesnil-Lettre;57;1;58
44;Grand Est;10;2;11;237;Mesnil-Saint-Loup;591;29;620
44;Grand Est;10;3;17;238;Mesnil-Saint-Père;458;9;467
44;Grand Est;10;3;05;239;Mesnil-Sellières;587;24;611
44;Grand Est;10;3;01;240;Messon;466;11;477
44;Grand Est;10;3;08;241;Metz-Robert;64;0;64
44;Grand Est;10;1;03;242;Meurville;160;3;163
44;Grand Est;10;1;05;243;Molins-sur-Aube;105;5;110
44;Grand Est;10;3;17;245;Montaulin;809;28;837
44;Grand Est;10;3;08;246;Montceaux-lès-Vaudes;264;16;280
44;Grand Est;10;3;01;247;Montfey;124;4;128
44;Grand Est;10;3;11;248;Montgueux;388;11;399
44;Grand Est;10;3;17;249;Montiéramey;403;7;410
44;Grand Est;10;1;03;250;Montier-en-l'Isle;224;6;230
44;Grand Est;10;3;01;251;Montigny-les-Monts;253;9;262
44;Grand Est;10;1;17;252;Montmartin-le-Haut;60;2;62
44;Grand Est;10;1;05;253;Montmorency-Beaufort;141;1;142
44;Grand Est;10;2;07;254;Montpothier;328;9;337
44;Grand Est;10;3;17;255;Montreuil-sur-Barse;291;5;296
44;Grand Est;10;3;02;256;Montsuzain;407;4;411
44;Grand Est;10;3;02;257;Morembert;30;0;30
44;Grand Est;10;1;03;258;Morvilliers;283;7;290
44;Grand Est;10;2;07;259;La Motte-Tilly;364;3;367
44;Grand Est;10;3;17;260;Moussey;643;16;659
44;Grand Est;10;3;04;261;Mussy-sur-Seine;1017;15;1032
44;Grand Est;10;3;04;262;Neuville-sur-Seine;415;8;423
44;Grand Est;10;3;01;263;Neuville-sur-Vanne;435;5;440
44;Grand Est;10;3;04;264;Noé-les-Mallets;117;2;119
44;Grand Est;10;3;13;265;Les Noës-près-Troyes;3280;33;3313
44;Grand Est;10;3;01;266;Nogent-en-Othe;47;3;50
44;Grand Est;10;3;02;267;Nogent-sur-Aube;312;4;316
44;Grand Est;10;2;07;268;Nogent-sur-Seine;5966;118;6084
44;Grand Est;10;3;02;269;Nozay;150;4;154
44;Grand Est;10;3;05;270;Onjon;258;6;264
44;Grand Est;10;2;11;271;Origny-le-Sec;595;11;606
44;Grand Est;10;3;02;272;Ormes;180;3;183
44;Grand Est;10;3;02;273;Ortillon;24;0;24
44;Grand Est;10;2;11;274;Orvilliers-Saint-Julien;312;4;316
44;Grand Est;10;2;11;275;Ossey-les-Trois-Maisons;594;7;601
44;Grand Est;10;3;01;276;Paisy-Cosdon;334;6;340
44;Grand Est;10;3;08;278;Pargues;137;4;141
44;Grand Est;10;1;05;279;Pars-lès-Chavanges;53;1;54
44;Grand Est;10;2;09;280;Pars-lès-Romilly;817;9;826
44;Grand Est;10;3;11;281;Le Pavillon-Sainte-Julie;291;8;299
44;Grand Est;10;3;11;282;Payns;1374;19;1393
44;Grand Est;10;1;05;283;Pel-et-Der;130;2;132
44;Grand Est;10;2;07;284;Périgny-la-Rose;148;3;151
44;Grand Est;10;1;05;285;Perthes-lès-Brienne;73;0;73
44;Grand Est;10;1;03;286;Petit-Mesnil;206;7;213
44;Grand Est;10;3;05;287;Piney;1483;16;1499
44;Grand Est;10;3;04;288;Plaines-Saint-Lange;263;4;267
44;Grand Est;10;2;06;289;Plancy-l'Abbaye;968;17;985
44;Grand Est;10;3;01;290;Planty;235;3;238
44;Grand Est;10;2;07;291;Plessis-Barbuise;187;7;194
44;Grand Est;10;3;02;293;Poivres;159;2;161
44;Grand Est;10;3;04;294;Poligny;62;2;64
44;Grand Est;10;3;04;295;Polisot;323;6;329
44;Grand Est;10;3;04;296;Polisy;190;9;199
44;Grand Est;10;3;15;297;Pont-Sainte-Marie;5154;92;5246
44;Grand Est;10;2;07;298;Pont-sur-Seine;1159;20;1179
44;Grand Est;10;3;02;299;Pouan-les-Vallées;522;17;539
44;Grand Est;10;3;02;300;Pougy;290;2;292
44;Grand Est;10;2;11;301;Pouy-sur-Vannes;173;4;177
44;Grand Est;10;3;08;302;Praslin;87;2;89
44;Grand Est;10;1;05;303;Précy-Notre-Dame;81;2;83
44;Grand Est;10;1;05;304;Précy-Saint-Martin;185;2;187
44;Grand Est;10;2;06;305;Prémierfait;86;3;89
44;Grand Est;10;1;03;306;Proverville;239;6;245
44;Grand Est;10;3;01;307;Prugny;367;10;377
44;Grand Est;10;2;11;308;Prunay-Belleville;211;8;219
44;Grand Est;10;3;08;309;Prusy;95;2;97
44;Grand Est;10;1;17;310;Puits-et-Nuisement;216;5;221
44;Grand Est;10;3;01;312;Racines;168;5;173
44;Grand Est;10;1;05;313;Radonvilliers;371;2;373
44;Grand Est;10;3;02;314;Ramerupt;409;4;413
44;Grand Est;10;1;05;315;Rances;45;2;47
44;Grand Est;10;2;06;316;Rhèges;221;4;225
44;Grand Est;10;3;08;317;Les Riceys;1212;23;1235
44;Grand Est;10;2;11;318;Rigny-la-Nonneuse;161;2;163
44;Grand Est;10;3;01;319;Rigny-le-Ferron;325;7;332
44;Grand Est;10;2;06;320;Rilly-Sainte-Syre;233;5;238
44;Grand Est;10;3;10;321;La Rivière-de-Corps;3591;113;3704
44;Grand Est;10;2;09;323;Romilly-sur-Seine;14480;318;14798
44;Grand Est;10;3;08;324;Roncenay;159;2;161
44;Grand Est;10;3;10;325;Rosières-près-Troyes;4521;347;4868
44;Grand Est;10;1;05;326;Rosnay-l'Hôpital;171;8;179
44;Grand Est;10;1;03;327;La Rothière;114;1;115
44;Grand Est;10;3;05;328;Rouilly-Sacey;388;4;392
44;Grand Est;10;3;17;329;Rouilly-Saint-Loup;513;45;558
44;Grand Est;10;1;03;330;Rouvres-les-Vignes;110;1;111
44;Grand Est;10;3;04;331;Rumilly-lès-Vaudes;557;10;567
44;Grand Est;10;3;17;332;Ruvigny;497;11;508
44;Grand Est;10;3;10;333;Saint-André-les-Vergers;12784;190;12974
44;Grand Est;10;2;07;334;Saint-Aubin;589;8;597
44;Grand Est;10;3;01;335;Saint-Benoist-sur-Vanne;241;6;247
44;Grand Est;10;3;06;336;Saint-Benoît-sur-Seine;395;5;400
44;Grand Est;10;1;05;337;Saint-Christophe-Dodinicourt;33;1;34
44;Grand Est;10;3;02;338;Saint-Étienne-sous-Barbuise;177;3;180
44;Grand Est;10;2;11;339;Saint-Flavy;291;6;297
44;Grand Est;10;3;10;340;Saint-Germain;2275;48;2323
44;Grand Est;10;2;09;341;Saint-Hilaire-sous-Romilly;357;9;366
44;Grand Est;10;3;08;342;Saint-Jean-de-Bonneval;404;8;412
44;Grand Est;10;3;15;343;Saint-Julien-les-Villas;6765;145;6910
44;Grand Est;10;3;17;344;Saint-Léger-près-Troyes;902;15;917
44;Grand Est;10;1;05;345;Saint-Léger-sous-Brienne;383;11;394
44;Grand Est;10;1;05;346;Saint-Léger-sous-Margerie;54;1;55
44;Grand Est;10;2;11;347;Saint-Loup-de-Buffigny;208;6;214
44;Grand Est;10;2;11;348;Saint-Lupien;231;4;235
44;Grand Est;10;3;11;349;Saint-Lyé;2885;62;2947
44;Grand Est;10;3;01;350;Saint-Mards-en-Othe;638;11;649
44;Grand Est;10;2;11;351;Saint-Martin-de-Bossenay;366;5;371
44;Grand Est;10;3;06;352;Sainte-Maure;1715;294;2009
44;Grand Est;10;2;06;353;Saint-Mesmin;886;10;896
44;Grand Est;10;3;02;354;Saint-Nabord-sur-Aube;137;4;141
44;Grand Est;10;2;07;355;Saint-Nicolas-la-Chapelle;67;0;67
44;Grand Est;10;2;06;356;Saint-Oulph;299;8;307
44;Grand Est;10;3;15;357;Saint-Parres-aux-Tertres;3167;49;3216
44;Grand Est;10;3;04;358;Saint-Parres-lès-Vaudes;1043;18;1061
44;Grand Est;10;3;01;359;Saint-Phal;513;11;524
44;Grand Est;10;3;08;360;Saint-Pouange;953;230;1183
44;Grand Est;10;3;02;361;Saint-Remy-sous-Barbuise;241;4;245
44;Grand Est;10;3;13;362;Sainte-Savine;10508;388;10896
44;Grand Est;10;3;17;363;Saint-Thibault;550;3;553
44;Grand Est;10;3;04;364;Saint-Usage;73;2;75
44;Grand Est;10;2;06;365;Salon;123;0;123
44;Grand Est;10;1;03;366;Saulcy;65;2;67
44;Grand Est;10;2;07;367;La Saulsotte;689;9;698
44;Grand Est;10;2;06;368;Savières;999;11;1010
44;Grand Est;10;3;02;369;Semoine;193;6;199
44;Grand Est;10;2;07;370;Soligny-les-Étangs;246;6;252
44;Grand Est;10;3;08;371;Sommeval;308;5;313
44;Grand Est;10;1;03;372;Soulaines-Dhuys;417;6;423
44;Grand Est;10;3;08;373;Souligny;379;20;399
44;Grand Est;10;1;03;374;Spoy;161;1;162
44;Grand Est;10;3;17;375;Thennelières;332;10;342
44;Grand Est;10;3;04;376;Thieffrain;154;3;157
44;Grand Est;10;1;03;377;Thil;112;9;121
44;Grand Est;10;1;03;378;Thors;69;3;72
44;Grand Est;10;3;02;379;Torcy-le-Grand;456;9;465
44;Grand Est;10;3;02;380;Torcy-le-Petit;80;5;85
44;Grand Est;10;3;10;381;Torvilliers;988;18;1006
44;Grand Est;10;2;07;382;Traînel;1047;13;1060
44;Grand Est;10;2;11;383;Trancault;185;3;188
44;Grand Est;10;1;17;384;Trannes;217;7;224
44;Grand Est;10;3;02;386;Trouans;224;7;231
44;Grand Est;10;3;99;387;Troyes;61957;1130;63087
44;Grand Est;10;3;08;388;Turgy;44;1;45
44;Grand Est;10;1;05;389;Unienville;116;4;120
44;Grand Est;10;1;03;390;Urville;122;2;124
44;Grand Est;10;3;06;391;Vailly;294;1;295
44;Grand Est;10;2;06;392;Vallant-Saint-Georges;400;9;409
44;Grand Est;10;1;05;393;Vallentigny;177;3;180
44;Grand Est;10;3;08;394;Vallières;165;1;166
44;Grand Est;10;3;08;395;Vanlay;295;4;299
44;Grand Est;10;3;01;396;Vauchassis;500;5;505
44;Grand Est;10;1;17;397;Vauchonvilliers;164;2;166
44;Grand Est;10;3;02;398;Vaucogne;76;4;80
44;Grand Est;10;3;04;399;Vaudes;720;8;728
44;Grand Est;10;3;02;400;Vaupoisson;117;5;122
44;Grand Est;10;1;17;401;Vendeuvre-sur-Barse;2315;39;2354
44;Grand Est;10;3;08;402;La Vendue-Mignot;245;5;250
44;Grand Est;10;1;03;403;Vernonvilliers;54;1;55
44;Grand Est;10;3;04;404;Verpillières-sur-Ource;109;2;111
44;Grand Est;10;3;02;405;Verricourt;56;0;56
44;Grand Est;10;3;17;406;Verrières;1858;37;1895
44;Grand Est;10;2;06;408;Viâpres-le-Petit;132;5;137
44;Grand Est;10;3;06;409;Villacerf;602;4;606
44;Grand Est;10;2;11;410;Villadin;107;4;111
44;Grand Est;10;1;03;411;La Ville-aux-Bois;27;0;27
44;Grand Est;10;3;06;412;Villechétif;942;20;962
44;Grand Est;10;3;11;414;Villeloup;124;5;129
44;Grand Est;10;3;08;416;Villemereuil;245;9;254
44;Grand Est;10;3;01;417;Villemoiron-en-Othe;204;6;210
44;Grand Est;10;3;04;418;Villemorien;201;9;210
44;Grand Est;10;3;04;419;Villemoyenne;753;13;766
44;Grand Est;10;2;07;420;Villenauxe-la-Grande;2726;30;2756
44;Grand Est;10;2;07;421;La Villeneuve-au-Châtelot;148;4;152
44;Grand Est;10;3;01;422;Villeneuve-au-Chemin;184;2;186
44;Grand Est;10;1;17;423;La Villeneuve-au-Chêne;417;15;432
44;Grand Est;10;1;05;424;Villeret;63;2;65
44;Grand Est;10;3;08;425;Villery;272;3;275
44;Grand Est;10;1;03;426;Ville-sous-la-Ferté;960;12;972
44;Grand Est;10;3;04;427;Ville-sur-Arce;204;7;211
44;Grand Est;10;1;03;428;Ville-sur-Terre;100;5;105
44;Grand Est;10;3;02;429;Villette-sur-Aube;248;3;251
44;Grand Est;10;3;02;430;Villiers-Herbisse;85;2;87
44;Grand Est;10;3;08;431;Villiers-le-Bois;101;1;102
44;Grand Est;10;3;08;432;Villiers-sous-Praslin;71;1;72
44;Grand Est;10;3;04;433;Villy-en-Trodes;251;8;259
44;Grand Est;10;3;08;434;Villy-le-Bois;56;1;57
44;Grand Est;10;3;08;435;Villy-le-Maréchal;186;4;190
44;Grand Est;10;3;02;436;Vinets;170;7;177
44;Grand Est;10;3;04;437;Virey-sous-Bar;605;10;615
44;Grand Est;10;3;04;438;Vitry-le-Croisé;221;5;226
44;Grand Est;10;3;04;439;Viviers-sur-Artaut;125;3;128
44;Grand Est;10;1;03;440;Voigny;146;6;152
44;Grand Est;10;3;01;441;Vosnon;232;2;234
44;Grand Est;10;3;02;442;Voué;686;9;695
44;Grand Est;10;3;08;443;Vougrey;45;1;46
44;Grand Est;10;3;01;444;Vulaines;227;3;230
44;Grand Est;10;1;05;445;Yèvres-le-Petit;54;9;63
76;Occitanie;11;1;15;001;Aigues-Vives;563;11;574
76;Occitanie;11;1;05;002;Airoux;168;2;170
76;Occitanie;11;2;09;003;Ajac;196;3;199
76;Occitanie;11;2;01;004;Alaigne;333;5;338
76;Occitanie;11;1;04;005;Alairac;1313;33;1346
76;Occitanie;11;3;07;006;Albas;79;2;81
76;Occitanie;11;3;07;007;Albières;121;4;125
76;Occitanie;11;2;09;008;Alet-les-Bains;386;3;389
76;Occitanie;11;1;10;009;Alzonne;1582;22;1604
76;Occitanie;11;2;14;010;Antugnac;258;7;265
76;Occitanie;11;1;19;011;Aragon;456;14;470
76;Occitanie;11;3;16;012;Argeliers;2189;32;2221
76;Occitanie;11;3;08;013;Argens-Minervois;355;6;361
76;Occitanie;11;3;06;014;Armissan;1513;30;1543
76;Occitanie;11;2;14;015;Arques;262;3;265
76;Occitanie;11;1;18;016;Arquettes-en-Val;80;3;83
76;Occitanie;11;2;14;017;Artigues;74;1;75
76;Occitanie;11;1;10;018;Arzens;1220;33;1253
76;Occitanie;11;2;14;019;Aunat;64;0;64
76;Occitanie;11;3;07;020;Auriac;38;0;38
76;Occitanie;11;2;14;021;Axat;535;11;546
76;Occitanie;11;1;15;022;Azille;1113;23;1136
76;Occitanie;11;1;18;023;Badens;760;14;774
76;Occitanie;11;3;12;024;Bages;784;15;799
76;Occitanie;11;1;15;025;Bagnoles;306;3;309
76;Occitanie;11;1;01;026;Baraigne;175;3;178
76;Occitanie;11;1;18;027;Barbaira;777;20;797
76;Occitanie;11;2;14;028;Belcaire;382;7;389
76;Occitanie;11;2;09;029;Belcastel-et-Buc;60;3;63
76;Occitanie;11;1;01;030;Belflou;118;6;124
76;Occitanie;11;2;14;031;Belfort-sur-Rebenty;23;2;25
76;Occitanie;11;2;01;032;Bellegarde-du-Razès;245;2;247
76;Occitanie;11;1;01;033;Belpech;1317;27;1344
76;Occitanie;11;2;01;034;Belvèze-du-Razès;857;7;864
76;Occitanie;11;2;14;035;Belvianes-et-Cavirac;243;6;249
76;Occitanie;11;2;14;036;Belvis;162;2;164
76;Occitanie;11;1;18;037;Berriac;966;10;976
76;Occitanie;11;2;14;038;Bessède-de-Sault;46;0;46
76;Occitanie;11;2;09;039;La Bezole;47;1;48
76;Occitanie;11;3;11;040;Bizanet;1746;28;1774
76;Occitanie;11;3;16;041;Bize-Minervois;1225;15;1240
76;Occitanie;11;1;18;042;Blomac;228;6;234
76;Occitanie;11;1;18;043;Bouilhonnac;223;6;229
76;Occitanie;11;3;07;044;Bouisse;105;0;105
76;Occitanie;11;2;09;045;Bouriège;141;1;142
76;Occitanie;11;2;09;046;Bourigeole;55;0;55
76;Occitanie;11;2;14;047;Le Bousquet;47;1;48
76;Occitanie;11;3;07;048;Boutenac;727;16;743
76;Occitanie;11;1;01;049;Bram;3208;81;3289
76;Occitanie;11;1;01;051;Brézilhac;181;4;185
76;Occitanie;11;1;10;052;Brousses-et-Villaret;343;5;348
76;Occitanie;11;2;01;053;Brugairolles;283;5;288
76;Occitanie;11;1;10;054;Les Brunels;271;11;282
76;Occitanie;11;2;14;055;Bugarach;240;4;244
76;Occitanie;11;1;15;056;Cabrespine;171;4;175
76;Occitanie;11;1;01;057;Cahuzac;29;0;29
76;Occitanie;11;2;01;058;Cailhau;256;8;264
76;Occitanie;11;2;01;059;Cailhavel;138;1;139
76;Occitanie;11;2;14;060;Cailla;49;1;50
76;Occitanie;11;2;01;061;Cambieure;303;4;307
76;Occitanie;11;2;14;062;Campagna-de-Sault;19;0;19
76;Occitanie;11;2;14;063;Campagne-sur-Aude;603;5;608
76;Occitanie;11;3;07;064;Camplong-d'Aude;371;4;375
76;Occitanie;11;2;14;065;Camps-sur-l'Agly;53;1;54
76;Occitanie;11;2;14;066;Camurac;102;0;102
76;Occitanie;11;3;16;067;Canet;1826;18;1844
76;Occitanie;11;1;18;068;Capendu;1473;41;1514
76;Occitanie;11;1;98;069;Carcassonne;46825;1291;48116
76;Occitanie;11;1;10;070;Carlipa;337;5;342
76;Occitanie;11;3;07;071;Cascastel-des-Corbières;224;7;231
76;Occitanie;11;1;01;072;La Cassaigne;165;8;173
76;Occitanie;11;2;14;073;Cassaignes;59;0;59
76;Occitanie;11;1;05;074;Les Cassés;302;2;304
76;Occitanie;11;1;15;075;Castans;133;2;135
76;Occitanie;11;1;05;076;Castelnaudary;12187;507;12694
76;Occitanie;11;3;08;077;Castelnau-d'Aude;503;9;512
76;Occitanie;11;2;09;078;Castelreng;207;7;214
76;Occitanie;11;1;19;079;Caudebronde;206;3;209
76;Occitanie;11;2;14;080;Val de Lambronne;170;2;172
76;Occitanie;11;1;15;081;Caunes-Minervois;1621;30;1651
76;Occitanie;11;2;09;082;Caunette-sur-Lauquet;8;0;8
76;Occitanie;11;1;18;083;Caunettes-en-Val;52;0;52
76;Occitanie;11;1;10;084;Caux-et-Sauzens;1003;23;1026
76;Occitanie;11;1;03;085;Cavanac;954;39;993
76;Occitanie;11;3;17;086;Caves;906;13;919
76;Occitanie;11;1;01;087;Cazalrenoux;93;1;94
76;Occitanie;11;1;03;088;Cazilhac;1652;50;1702
76;Occitanie;11;1;10;089;Cenne-Monestiés;407;7;414
76;Occitanie;11;2;09;090;Cépie;623;17;640
76;Occitanie;11;2;14;091;Chalabre;1132;12;1144
76;Occitanie;11;1;15;092;Citou;87;1;88
76;Occitanie;11;2;14;093;Le Clat;28;2;30
76;Occitanie;11;2;09;094;Clermont-sur-Lauquet;26;0;26
76;Occitanie;11;1;18;095;Comigne;303;8;311
76;Occitanie;11;2;14;096;Comus;36;2;38
76;Occitanie;11;3;08;098;Conilhac-Corbières;905;19;924
76;Occitanie;11;1;19;099;Conques-sur-Orbiel;2581;55;2636
76;Occitanie;11;2;14;100;Corbières;26;1;27
76;Occitanie;11;2;14;101;Coudons;52;1;53
76;Occitanie;11;1;03;102;Couffoulens;587;8;595
76;Occitanie;11;2;14;103;Couiza;1118;21;1139
76;Occitanie;11;2;14;104;Counozouls;50;0;50
76;Occitanie;11;2;09;105;Cournanel;726;10;736
76;Occitanie;11;3;06;106;Coursan;5825;96;5921
76;Occitanie;11;2;14;107;Courtauly;76;1;77
76;Occitanie;11;2;01;108;La Courtète;46;1;47
76;Occitanie;11;2;14;109;Coustaussa;52;1;53
76;Occitanie;11;3;07;110;Coustouge;118;0;118
76;Occitanie;11;3;08;111;Cruscades;933;9;942
76;Occitanie;11;2;14;112;Cubières-sur-Cinoble;84;1;85
76;Occitanie;11;3;07;113;Cucugnan;116;5;121
76;Occitanie;11;1;01;114;Cumiès;39;0;39
76;Occitanie;11;1;10;115;Cuxac-Cabardès;897;24;921
76;Occitanie;11;3;06;116;Cuxac-d'Aude;4033;71;4104
76;Occitanie;11;3;07;117;Davejean;115;2;117
76;Occitanie;11;3;07;118;Dernacueillette;44;1;45
76;Occitanie;11;2;09;119;La Digne-d'Amont;295;7;302
76;Occitanie;11;2;09;120;La Digne-d'Aval;530;13;543
76;Occitanie;11;2;01;121;Donazac;110;1;111
76;Occitanie;11;1;18;122;Douzens;765;12;777
76;Occitanie;11;3;07;123;Duilhac-sous-Peyrepertuse;146;3;149
76;Occitanie;11;3;07;124;Durban-Corbières;654;11;665
76;Occitanie;11;3;07;125;Embres-et-Castelmaure;153;0;153
76;Occitanie;11;3;08;126;Escales;477;4;481
76;Occitanie;11;2;14;127;Escouloubre;71;3;74
76;Occitanie;11;2;01;128;Escueillens-et-Saint-Just-de-Bélengard;148;2;150
76;Occitanie;11;2;14;129;Espéraza;1729;32;1761
76;Occitanie;11;2;14;130;Espezel;227;5;232
76;Occitanie;11;2;14;131;Val-du-Faby;573;13;586
76;Occitanie;11;3;07;132;Fabrezan;1256;16;1272
76;Occitanie;11;1;18;133;Fajac-en-Val;42;0;42
76;Occitanie;11;1;01;134;Fajac-la-Relenque;50;4;54
76;Occitanie;11;2;14;135;La Fajolle;12;1;13
76;Occitanie;11;1;01;136;Fanjeaux;849;89;938
76;Occitanie;11;3;07;137;Félines-Termenès;127;5;132
76;Occitanie;11;1;05;138;Fendeille;526;16;542
76;Occitanie;11;1;01;139;Fenouillet-du-Razès;79;0;79
76;Occitanie;11;3;07;140;Ferrals-les-Corbières;1235;21;1256
76;Occitanie;11;1;01;141;Ferran;120;1;121
76;Occitanie;11;2;09;142;Festes-et-Saint-André;198;5;203
76;Occitanie;11;3;17;143;Feuilla;110;0;110
76;Occitanie;11;3;17;144;Fitou;1069;12;1081
76;Occitanie;11;3;06;145;Fleury;3758;62;3820
76;Occitanie;11;1;18;146;Floure;406;8;414
76;Occitanie;11;2;14;147;Fontanès-de-Sault;5;0;5
76;Occitanie;11;3;07;148;Fontcouverte;552;10;562
76;Occitanie;11;1;01;149;Fonters-du-Razès;79;1;80
76;Occitanie;11;1;10;150;Fontiers-Cabardès;450;50;500
76;Occitanie;11;1;18;151;Fontiès-d'Aude;514;11;525
76;Occitanie;11;3;07;152;Fontjoncouse;127;4;131
76;Occitanie;11;1;01;153;La Force;241;7;248
76;Occitanie;11;1;19;154;Fournes-Cabardès;49;0;49
76;Occitanie;11;2;14;155;Fourtou;78;1;79
76;Occitanie;11;1;10;156;Fraisse-Cabardès;105;2;107
76;Occitanie;11;3;07;157;Fraissé-des-Corbières;213;5;218
76;Occitanie;11;2;09;158;Gaja-et-Villedieu;291;11;302
76;Occitanie;11;1;01;159;Gaja-la-Selve;138;2;140
76;Occitanie;11;2;14;160;Galinagues;36;0;36
76;Occitanie;11;2;09;161;Gardie;127;3;130
76;Occitanie;11;1;01;162;Generville;58;1;59
76;Occitanie;11;2;14;163;Gincla;46;0;46
76;Occitanie;11;3;16;164;Ginestas;1499;21;1520
76;Occitanie;11;2;14;165;Ginoles;303;9;312
76;Occitanie;11;1;01;166;Gourvieille;81;0;81
76;Occitanie;11;2;01;167;Gramazie;124;2;126
76;Occitanie;11;2;14;168;Granès;95;0;95
76;Occitanie;11;2;09;169;Greffeil;86;5;91
76;Occitanie;11;3;12;170;Gruissan;5087;80;5167
76;Occitanie;11;3;08;172;Homps;594;11;605
76;Occitanie;11;1;01;173;Hounoux;132;3;135
76;Occitanie;11;1;19;174;Les Ilhes;55;0;55
76;Occitanie;11;1;05;175;Issel;476;9;485
76;Occitanie;11;3;07;176;Jonquières;59;2;61
76;Occitanie;11;2;14;177;Joucou;32;0;32
76;Occitanie;11;1;05;178;Labastide-d'Anjou;1284;15;1299
76;Occitanie;11;1;18;179;Labastide-en-Val;91;2;93
76;Occitanie;11;1;19;180;Labastide-Esparbairenque;64;0;64
76;Occitanie;11;1;10;181;Labécède-Lauragais;399;8;407
76;Occitanie;11;1;10;182;Lacombe;175;3;178
76;Occitanie;11;2;09;183;Ladern-sur-Lauquet;267;9;276
76;Occitanie;11;1;01;184;Lafage;92;3;95
76;Occitanie;11;3;07;185;Lagrasse;540;9;549
76;Occitanie;11;3;07;186;Lairière;55;2;57
76;Occitanie;11;3;07;187;Lanet;57;1;58
76;Occitanie;11;3;17;188;La Palme;1704;31;1735
76;Occitanie;11;1;10;189;Laprade;106;1;107
76;Occitanie;11;1;15;190;La Redorte;1227;20;1247
76;Occitanie;11;3;07;191;Laroque-de-Fa;151;7;158
76;Occitanie;11;1;05;192;Lasbordes;788;30;818
76;Occitanie;11;1;01;193;Lasserre-de-Prouille;278;3;281
76;Occitanie;11;1;19;194;Lastours;157;3;160
76;Occitanie;11;1;01;195;Laurabuc;402;9;411
76;Occitanie;11;1;01;196;Laurac;180;8;188
76;Occitanie;11;2;01;197;Lauraguel;604;16;620
76;Occitanie;11;1;15;198;Laure-Minervois;1022;15;1037
76;Occitanie;11;1;04;199;Lavalette;1513;26;1539
76;Occitanie;11;1;15;200;Lespinassière;134;7;141
76;Occitanie;11;1;03;201;Leuc;865;15;880
76;Occitanie;11;3;17;202;Leucate;4612;58;4670
76;Occitanie;11;3;08;203;Lézignan-Corbières;11317;220;11537
76;Occitanie;11;2;01;204;Lignairolles;48;0;48
76;Occitanie;11;1;15;205;Limousis;134;2;136
76;Occitanie;11;2;09;206;Limoux;10012;509;10521
76;Occitanie;11;2;09;207;Loupia;239;5;244
76;Occitanie;11;1;01;208;La Louvière-Lauragais;80;3;83
76;Occitanie;11;2;14;209;Luc-sur-Aude;246;7;253
76;Occitanie;11;3;07;210;Luc-sur-Orbieu;1138;10;1148
76;Occitanie;11;2;09;211;Magrie;534;5;539
76;Occitanie;11;3;16;212;Mailhac;574;12;586
76;Occitanie;11;3;07;213;Maisons;47;0;47
76;Occitanie;11;2;09;214;Malras;422;12;434
76;Occitanie;11;1;19;215;Malves-en-Minervois;864;26;890
76;Occitanie;11;2;01;216;Malviès;368;12;380
76;Occitanie;11;3;16;217;Marcorignan;1314;27;1341
76;Occitanie;11;1;01;218;Marquein;83;0;83
76;Occitanie;11;2;14;219;Marsa;19;0;19
76;Occitanie;11;1;18;220;Marseillette;703;13;716
76;Occitanie;11;1;19;221;Les Martys;299;5;304
76;Occitanie;11;1;19;222;Mas-Cabardès;178;5;183
76;Occitanie;11;1;03;223;Mas-des-Cours;25;1;26
76;Occitanie;11;3;07;224;Massac;27;1;28
76;Occitanie;11;1;05;225;Mas-Saintes-Puelles;927;22;949
76;Occitanie;11;1;01;226;Mayreville;81;1;82
76;Occitanie;11;1;18;227;Mayronnes;38;1;39
76;Occitanie;11;2;01;228;Mazerolles-du-Razès;151;4;155
76;Occitanie;11;2;14;229;Mazuby;25;1;26
76;Occitanie;11;2;14;230;Mérial;32;0;32
76;Occitanie;11;1;01;231;Mézerville;97;3;100
76;Occitanie;11;1;19;232;Miraval-Cabardès;46;0;46
76;Occitanie;11;3;16;233;Mirepeisset;758;13;771
76;Occitanie;11;1;01;234;Mireval-Lauragais;185;5;190
76;Occitanie;11;2;14;235;Missègre;60;2;62
76;Occitanie;11;1;01;236;Molandier;242;2;244
76;Occitanie;11;1;01;238;Molleville;138;6;144
76;Occitanie;11;1;01;239;Montauriol;83;2;85
76;Occitanie;11;2;14;240;Montazels;556;9;565
76;Occitanie;11;3;08;241;Montbrun-des-Corbières;329;1;330
76;Occitanie;11;1;04;242;Montclar;173;0;173
76;Occitanie;11;1;05;243;Montferrand;602;10;612
76;Occitanie;11;2;14;244;Montfort-sur-Boulzane;90;3;93
76;Occitanie;11;3;07;245;Montgaillard;38;0;38
76;Occitanie;11;2;01;246;Montgradail;46;0;46
76;Occitanie;11;2;01;247;Monthaut;38;0;38
76;Occitanie;11;1;18;248;Montirat;69;1;70
76;Occitanie;11;2;14;249;Montjardin;82;1;83
76;Occitanie;11;3;07;250;Montjoi;36;1;37
76;Occitanie;11;1;18;251;Val-de-Dagne;741;10;751
76;Occitanie;11;1;05;252;Montmaur;304;9;313
76;Occitanie;11;1;10;253;Montolieu;836;14;850
76;Occitanie;11;1;10;254;Montréal;1900;173;2073
76;Occitanie;11;3;11;255;Montredon-des-Corbières;1485;15;1500
76;Occitanie;11;3;07;256;Montséret;614;12;626
76;Occitanie;11;1;18;257;Monze;230;3;233
76;Occitanie;11;3;16;258;Moussan;2030;48;2078
76;Occitanie;11;1;10;259;Moussoulens;1005;30;1035
76;Occitanie;11;3;07;260;Mouthoumet;106;3;109
76;Occitanie;11;3;18;261;Moux;701;8;709
76;Occitanie;11;3;99;262;Narbonne;55516;1184;56700
76;Occitanie;11;2;14;263;Nébias;260;5;265
76;Occitanie;11;3;11;264;Névian;1289;32;1321
76;Occitanie;11;2;14;265;Niort-de-Sault;38;1;39
76;Occitanie;11;3;17;266;Port-la-Nouvelle;5795;68;5863
76;Occitanie;11;3;08;267;Ornaisons;1127;25;1152
76;Occitanie;11;1;01;268;Orsans;113;0;113
76;Occitanie;11;3;16;269;Ouveillan;2564;50;2614
76;Occitanie;11;3;07;270;Padern;137;1;138
76;Occitanie;11;3;07;271;Palairac;33;0;33
76;Occitanie;11;1;03;272;Palaja;2398;101;2499
76;Occitanie;11;3;16;273;Paraza;673;12;685
76;Occitanie;11;2;09;274;Pauligne;369;15;384
76;Occitanie;11;1;01;275;Payra-sur-l'Hers;205;3;208
76;Occitanie;11;3;07;276;Paziols;526;17;543
76;Occitanie;11;1;01;277;Pécharic-et-le-Py;28;2;30
76;Occitanie;11;1;01;278;Pech-Luna;74;1;75
76;Occitanie;11;1;19;279;Pennautier;2634;60;2694
76;Occitanie;11;1;15;280;Pépieux;1087;30;1117
76;Occitanie;11;1;01;281;Pexiora;1230;19;1249
76;Occitanie;11;2;14;282;Peyrefitte-du-Razès;52;2;54
76;Occitanie;11;1;01;283;Peyrefitte-sur-l'Hers;77;5;82
76;Occitanie;11;1;05;284;Peyrens;476;16;492
76;Occitanie;11;3;17;285;Peyriac-de-Mer;1132;23;1155
76;Occitanie;11;1;15;286;Peyriac-Minervois;1166;20;1186
76;Occitanie;11;2;14;287;Peyrolles;87;2;89
76;Occitanie;11;1;10;288;Pezens;1577;155;1732
76;Occitanie;11;2;09;289;Pieusse;967;17;984
76;Occitanie;11;1;01;290;Plaigne;116;1;117
76;Occitanie;11;1;01;291;Plavilla;108;4;112
76;Occitanie;11;1;05;292;La Pomarède;165;1;166
76;Occitanie;11;2;09;293;Pomas;899;23;922
76;Occitanie;11;2;01;294;Pomy;58;1;59
76;Occitanie;11;3;17;295;Portel-des-Corbières;1339;19;1358
76;Occitanie;11;3;16;296;Pouzols-Minervois;565;9;574
76;Occitanie;11;1;19;297;Pradelles-Cabardès;142;1;143
76;Occitanie;11;1;04;299;Preixan;623;14;637
76;Occitanie;11;1;05;300;Puginier;154;0;154
76;Occitanie;11;1;15;301;Puichéric;1184;17;1201
76;Occitanie;11;2;14;302;Puilaurens;265;9;274
76;Occitanie;11;2;14;303;Puivert;441;15;456
76;Occitanie;11;2;14;304;Quillan;3212;108;3320
76;Occitanie;11;3;07;305;Quintillan;50;0;50
76;Occitanie;11;2;14;306;Quirbajou;52;2;54
76;Occitanie;11;3;16;307;Raissac-d'Aude;262;5;267
76;Occitanie;11;1;10;308;Raissac-sur-Lampy;451;9;460
76;Occitanie;11;2;14;309;Rennes-le-Château;93;4;97
76;Occitanie;11;2;14;310;Rennes-les-Bains;201;1;202
76;Occitanie;11;3;07;311;Ribaute;270;4;274
76;Occitanie;11;1;01;312;Ribouisse;111;5;116
76;Occitanie;11;1;05;313;Ricaud;302;7;309
76;Occitanie;11;1;18;314;Rieux-en-Val;85;7;92
76;Occitanie;11;1;15;315;Rieux-Minervois;1949;26;1975
76;Occitanie;11;2;14;316;Rivel;210;3;213
76;Occitanie;11;2;14;317;Rodome;113;1;114
76;Occitanie;11;3;18;318;Roquecourbe-Minervois;136;6;142
76;Occitanie;11;1;19;319;Roquefère;80;1;81
76;Occitanie;11;2;14;320;Roquefeuil;294;4;298
76;Occitanie;11;2;14;321;Roquefort-de-Sault;83;0;83
76;Occitanie;11;3;17;322;Roquefort-des-Corbières;990;18;1008
76;Occitanie;11;2;14;323;Roquetaillade-et-Conilhac;275;2;277
76;Occitanie;11;3;16;324;Roubia;505;13;518
76;Occitanie;11;1;04;325;Rouffiac-d'Aude;452;11;463
76;Occitanie;11;3;07;326;Rouffiac-des-Corbières;80;1;81
76;Occitanie;11;1;04;327;Roullens;472;13;485
76;Occitanie;11;2;01;328;Routier;241;3;244
76;Occitanie;11;1;15;330;Rustiques;506;12;518
76;Occitanie;11;1;01;331;Saint-Amans;61;3;64
76;Occitanie;11;3;07;332;Saint-André-de-Roquelongue;1369;16;1385
76;Occitanie;11;2;14;333;Saint-Benoît;107;3;110
76;Occitanie;11;1;01;334;Sainte-Camelle;117;2;119
76;Occitanie;11;2;14;335;Sainte-Colombe-sur-Guette;45;0;45
76;Occitanie;11;2;14;336;Sainte-Colombe-sur-l'Hers;436;7;443
76;Occitanie;11;3;18;337;Saint-Couat-d'Aude;387;4;391
76;Occitanie;11;2;09;338;Saint-Couat-du-Razès;41;1;42
76;Occitanie;11;1;10;339;Saint-Denis;504;12;516
76;Occitanie;11;1;10;340;Sainte-Eulalie;525;10;535
76;Occitanie;11;2;14;341;Saint-Ferriol;112;2;114
76;Occitanie;11;1;15;342;Saint-Frichoux;242;4;246
76;Occitanie;11;1;01;343;Saint-Gaudéric;120;2;122
76;Occitanie;11;2;09;344;Saint-Hilaire;713;16;729
76;Occitanie;11;3;07;345;Saint-Jean-de-Barrou;262;0;262
76;Occitanie;11;2;14;346;Saint-Jean-de-Paracol;127;3;130
76;Occitanie;11;2;14;347;Saint-Julia-de-Bec;104;2;106
76;Occitanie;11;1;01;348;Saint-Julien-de-Briola;88;1;89
76;Occitanie;11;2;14;350;Saint-Just-et-le-Bézu;51;3;54
76;Occitanie;11;3;07;351;Saint-Laurent-de-la-Cabrerisse;724;26;750
76;Occitanie;11;2;14;352;Saint-Louis-et-Parahou;51;2;53
76;Occitanie;11;3;16;353;Saint-Marcel-sur-Aude;2020;46;2066
76;Occitanie;11;3;07;354;Saint-Martin-des-Puits;27;0;27
76;Occitanie;11;2;09;355;Saint-Martin-de-Villereglan;361;8;369
76;Occitanie;11;1;05;356;Saint-Martin-Lalande;1121;20;1141
76;Occitanie;11;1;10;357;Saint-Martin-le-Vieil;217;7;224
76;Occitanie;11;2;14;358;Saint-Martin-Lys;24;2;26
76;Occitanie;11;1;01;359;Saint-Michel-de-Lanès;475;6;481
76;Occitanie;11;3;16;360;Saint-Nazaire-d'Aude;2069;35;2104
76;Occitanie;11;1;05;361;Saint-Papoul;883;20;903
76;Occitanie;11;1;05;362;Saint-Paulet;201;4;205
76;Occitanie;11;3;07;363;Saint-Pierre-des-Champs;182;5;187
76;Occitanie;11;2;09;364;Saint-Polycarpe;143;2;145
76;Occitanie;11;1;01;365;Saint-Sernin;41;2;43
76;Occitanie;11;3;16;366;Sainte-Valière;537;10;547
76;Occitanie;11;1;10;367;Saissac;922;23;945
76;Occitanie;11;1;15;368;Sallèles-Cabardès;119;3;122
76;Occitanie;11;3;16;369;Sallèles-d'Aude;3024;43;3067
76;Occitanie;11;3;06;370;Salles-d'Aude;3254;76;3330
76;Occitanie;11;1;01;371;Salles-sur-l'Hers;707;13;720
76;Occitanie;11;1;19;372;Salsigne;379;5;384
76;Occitanie;11;2;14;373;Salvezines;72;1;73
76;Occitanie;11;3;07;374;Salza;16;0;16
76;Occitanie;11;2;01;375;Seignalens;30;1;31
76;Occitanie;11;2;14;376;La Serpent;95;4;99
76;Occitanie;11;2;14;377;Serres;76;0;76
76;Occitanie;11;1;18;378;Serviès-en-Val;203;6;209
76;Occitanie;11;3;17;379;Sigean;5533;96;5629
76;Occitanie;11;2;14;380;Sonnac-sur-l'Hers;130;3;133
76;Occitanie;11;2;14;381;Sougraigne;122;7;129
76;Occitanie;11;1;05;382;Souilhanels;362;58;420
76;Occitanie;11;1;05;383;Souilhe;324;10;334
76;Occitanie;11;3;07;384;Soulatgé;126;0;126
76;Occitanie;11;1;05;385;Soupex;236;7;243
76;Occitanie;11;3;07;386;Talairan;483;7;490
76;Occitanie;11;1;18;387;Taurize;111;1;112
76;Occitanie;11;3;07;388;Termes;47;0;47
76;Occitanie;11;2;14;389;Terroles;16;0;16
76;Occitanie;11;3;07;390;Thézan-des-Corbières;556;10;566
76;Occitanie;11;1;19;391;La Tourette-Cabardès;24;2;26
76;Occitanie;11;3;07;392;Tournissan;270;4;274
76;Occitanie;11;3;08;393;Tourouzelle;487;7;494
76;Occitanie;11;2;09;394;Tourreilles;131;0;131
76;Occitanie;11;1;15;395;Trassanel;30;0;30
76;Occitanie;11;1;15;396;Trausse;597;3;600
76;Occitanie;11;1;18;397;Trèbes;5502;128;5630
76;Occitanie;11;3;17;398;Treilles;255;5;260
76;Occitanie;11;1;05;399;Tréville;106;5;111
76;Occitanie;11;2;14;400;Tréziers;103;1;104
76;Occitanie;11;3;07;401;Tuchan;793;11;804
76;Occitanie;11;2;14;402;Valmigère;23;0;23
76;Occitanie;11;1;19;404;Ventenac-Cabardès;956;33;989
76;Occitanie;11;3;16;405;Ventenac-en-Minervois;574;10;584
76;Occitanie;11;2;09;406;Véraza;33;2;35
76;Occitanie;11;1;10;407;Verdun-en-Lauragais;280;6;286
76;Occitanie;11;1;03;408;Verzeille;504;8;512
76;Occitanie;11;3;07;409;Vignevieille;105;1;106
76;Occitanie;11;1;19;410;Villalier;986;17;1003
76;Occitanie;11;1;19;411;Villanière;135;1;136
76;Occitanie;11;2;09;412;Villardebelle;55;0;55
76;Occitanie;11;1;19;413;Villardonnel;503;11;514
76;Occitanie;11;1;18;414;Villar-en-Val;24;1;25
76;Occitanie;11;2;09;415;Villar-Saint-Anselme;124;0;124
76;Occitanie;11;1;15;416;Villarzel-Cabardès;249;5;254
76;Occitanie;11;2;01;417;Villarzel-du-Razès;98;0;98
76;Occitanie;11;1;01;418;Villasavary;1211;39;1250
76;Occitanie;11;1;01;419;Villautou;63;0;63
76;Occitanie;11;2;09;420;Villebazy;135;3;138
76;Occitanie;11;3;11;421;Villedaigne;534;8;542
76;Occitanie;11;1;18;422;Villedubert;348;15;363
76;Occitanie;11;1;03;423;Villefloure;159;4;163
76;Occitanie;11;2;14;424;Villefort;85;1;86
76;Occitanie;11;1;19;425;Villegailhenc;1684;54;1738
76;Occitanie;11;1;15;426;Villegly;1177;23;1200
76;Occitanie;11;2;09;427;Villelongue-d'Aude;302;8;310
76;Occitanie;11;1;10;428;Villemagne;252;7;259
76;Occitanie;11;1;19;429;Villemoustaussou;4469;80;4549
76;Occitanie;11;1;05;430;Villeneuve-la-Comptal;1359;42;1401
76;Occitanie;11;3;07;431;Villeneuve-les-Corbières;248;7;255
76;Occitanie;11;1;10;432;Villeneuve-lès-Montréal;322;10;332
76;Occitanie;11;1;15;433;Villeneuve-Minervois;976;17;993
76;Occitanie;11;1;01;434;Villepinte;1276;25;1301
76;Occitanie;11;3;07;435;Villerouge-Termenès;154;6;160
76;Occitanie;11;3;07;436;Villesèque-des-Corbières;370;2;372
76;Occitanie;11;1;10;437;Villesèquelande;911;17;928
76;Occitanie;11;1;01;438;Villesiscle;388;6;394
76;Occitanie;11;1;10;439;Villespy;400;8;408
76;Occitanie;11;1;18;440;Villetritouls;35;3;38
76;Occitanie;11;3;06;441;Vinassan;2658;53;2711
76;Occitanie;12;1;03;001;Agen-d'Aveyron;1069;32;1101
76;Occitanie;12;1;12;002;Aguessac;869;29;898
76;Occitanie;12;3;08;003;Les Albres;343;7;350
76;Occitanie;12;3;07;004;Almont-les-Junies;445;20;465
76;Occitanie;12;1;15;006;Alrance;351;11;362
76;Occitanie;12;3;23;007;Ambeyrac;176;8;184
76;Occitanie;12;3;06;008;Anglars-Saint-Félix;885;19;904
76;Occitanie;12;1;04;009;Arnac-sur-Dourdou;36;1;37
76;Occitanie;12;1;15;010;Arques;153;2;155
76;Occitanie;12;1;13;011;Arvieu;775;28;803
76;Occitanie;12;3;08;012;Asprières;746;9;755
76;Occitanie;12;3;06;013;Aubin;3741;113;3854
76;Occitanie;12;1;13;015;Auriac-Lagast;228;3;231
76;Occitanie;12;3;06;016;Auzits;824;26;850
76;Occitanie;12;1;15;017;Ayssènes;216;5;221
76;Occitanie;12;3;08;018;Balaguier-d'Olt;181;7;188
76;Occitanie;12;1;04;019;Balaguier-sur-Rance;89;4;93
76;Occitanie;12;3;02;021;Le Bas Ségala;1558;55;1613
76;Occitanie;12;1;19;022;La Bastide-Pradines;109;0;109
76;Occitanie;12;1;04;023;La Bastide-Solages;106;1;107
76;Occitanie;12;3;06;024;Belcastel;195;3;198
76;Occitanie;12;1;04;025;Belmont-sur-Rance;972;12;984
76;Occitanie;12;2;09;026;Bertholène;1054;20;1074
76;Occitanie;12;2;10;027;Bessuéjouls;202;10;212
76;Occitanie;12;3;07;028;Boisse-Penchot;518;9;527
76;Occitanie;12;3;02;029;Bor-et-Bar;201;4;205
76;Occitanie;12;3;08;030;Bouillac;379;15;394
76;Occitanie;12;3;06;031;Bournazel;356;5;361
76;Occitanie;12;3;05;032;Boussac;595;14;609
76;Occitanie;12;2;03;033;Bozouls;2923;66;2989
76;Occitanie;12;3;23;034;Brandonnet;303;7;310
76;Occitanie;12;1;04;035;Brasc;172;8;180
76;Occitanie;12;2;01;036;Brommat;637;8;645
76;Occitanie;12;1;15;037;Broquiès;608;16;624
76;Occitanie;12;1;15;038;Brousse-le-Château;164;4;168
76;Occitanie;12;1;04;039;Brusque;264;5;269
76;Occitanie;12;3;05;041;Cabanès;264;6;270
76;Occitanie;12;1;19;042;Calmels-et-le-Viala;208;11;219
76;Occitanie;12;3;13;043;Calmont;2166;76;2242
76;Occitanie;12;1;04;044;Camarès;1028;32;1060
76;Occitanie;12;3;05;045;Camboulazet;388;12;400
76;Occitanie;12;3;05;046;Camjac;573;16;589
76;Occitanie;12;2;20;047;Campagnac;451;6;457
76;Occitanie;12;2;01;048;Campouriez;345;9;354
76;Occitanie;12;2;10;049;Campuac;451;10;461
76;Occitanie;12;1;15;050;Canet-de-Salars;442;12;454
76;Occitanie;12;2;01;051;Cantoin;310;2;312
76;Occitanie;12;3;08;052;Capdenac-Gare;4419;115;4534
76;Occitanie;12;3;23;053;La Capelle-Balaguier;327;6;333
76;Occitanie;12;3;02;054;La Capelle-Bleys;351;8;359
76;Occitanie;12;2;20;055;La Capelle-Bonance;83;0;83
76;Occitanie;12;3;05;056;Baraqueville;3150;84;3234
76;Occitanie;12;3;13;057;Cassagnes-Bégonhès;925;34;959
76;Occitanie;12;2;01;058;Cassuéjouls;106;5;111
76;Occitanie;12;3;05;059;Castanet;517;24;541
76;Occitanie;12;3;02;060;Castelmary;114;4;118
76;Occitanie;12;2;09;061;Castelnau-de-Mandailles;575;11;586
76;Occitanie;12;1;20;062;Castelnau-Pégayrols;343;3;346
76;Occitanie;12;1;04;063;La Cavalerie;1939;29;1968
76;Occitanie;12;2;10;064;Le Cayrol;268;6;274
76;Occitanie;12;3;05;065;Centrès;461;14;475
76;Occitanie;12;2;21;066;Clairvaux-d'Aveyron;1148;28;1176
76;Occitanie;12;1;04;067;Le Clapier;76;0;76
76;Occitanie;12;3;05;068;Colombiès;878;26;904
76;Occitanie;12;1;04;069;Combret;265;7;272
76;Occitanie;12;1;12;070;Compeyre;522;26;548
76;Occitanie;12;3;23;071;Compolibat;334;7;341
76;Occitanie;12;1;11;072;Comprégnac;232;7;239
76;Occitanie;12;1;13;073;Comps-la-Grand-Ville;625;19;644
76;Occitanie;12;2;01;074;Condom-d'Aubrac;295;14;309
76;Occitanie;12;1;13;075;Connac;106;2;108
76;Occitanie;12;2;07;076;Conques-en-Rouergue;1615;57;1672
76;Occitanie;12;1;04;077;Cornus;513;12;525
76;Occitanie;12;1;15;078;Les Costes-Gozon;185;2;187
76;Occitanie;12;2;10;079;Coubisou;491;18;509
76;Occitanie;12;1;04;080;Coupiac;373;9;382
76;Occitanie;12;1;04;082;La Couvertoirade;189;2;191
76;Occitanie;12;3;06;083;Cransac;1473;52;1525
76;Occitanie;12;1;11;084;Creissels;1569;57;1626
76;Occitanie;12;3;02;085;Crespin;315;0;315
76;Occitanie;12;1;20;086;La Cresse;324;16;340
76;Occitanie;12;2;01;088;Curières;228;4;232
76;Occitanie;12;3;07;089;Decazeville;5323;206;5529
76;Occitanie;12;2;21;090;Druelle Balsac;3205;94;3299
76;Occitanie;12;3;23;091;Drulhe;455;11;466
76;Occitanie;12;1;13;092;Durenque;523;10;533
76;Occitanie;12;2;10;093;Le Fel;176;1;177
76;Occitanie;12;2;10;094;Entraygues-sur-Truyère;985;17;1002
76;Occitanie;12;3;06;095;Escandolières;240;6;246
76;Occitanie;12;2;10;096;Espalion;4601;149;4750
76;Occitanie;12;2;10;097;Espeyrac;248;3;251
76;Occitanie;12;2;10;098;Estaing;461;21;482
76;Occitanie;12;1;04;099;Fayet;241;4;245
76;Occitanie;12;3;06;100;Firmi;2372;67;2439
76;Occitanie;12;3;07;101;Flagnac;1072;35;1107
76;Occitanie;12;1;14;102;Flavin;2359;51;2410
76;Occitanie;12;2;01;103;Florentin-la-Capelle;282;8;290
76;Occitanie;12;3;08;104;Foissac;488;10;498
76;Occitanie;12;3;02;105;La Fouillade;1108;25;1133
76;Occitanie;12;2;03;106;Gabriac;534;11;545
76;Occitanie;12;2;09;107;Gaillac-d'Aveyron;318;5;323
76;Occitanie;12;3;08;108;Galgan;375;5;380
76;Occitanie;12;1;04;109;Gissac;99;2;101
76;Occitanie;12;2;10;110;Golinhac;325;16;341
76;Occitanie;12;3;06;111;Goutrens;495;18;513
76;Occitanie;12;3;05;113;Gramond;506;7;513
76;Occitanie;12;1;04;115;L'Hospitalet-du-Larzac;290;3;293
76;Occitanie;12;2;01;116;Huparlac;266;8;274
76;Occitanie;12;2;01;118;Lacroix-Barrez;522;13;535
76;Occitanie;12;2;01;119;Laguiole;1234;28;1262
76;Occitanie;12;2;09;120;Laissac-Sévérac l'Église;2147;104;2251
76;Occitanie;12;3;23;121;Lanuéjouls;723;16;739
76;Occitanie;12;1;04;122;Lapanouse-de-Cernon;124;8;132
76;Occitanie;12;2;09;124;Lassouts;306;9;315
76;Occitanie;12;1;04;125;Laval-Roquecezière;278;4;282
76;Occitanie;12;1;13;127;Lédergues;636;20;656
76;Occitanie;12;3;02;128;Lescure-Jaoul;220;6;226
76;Occitanie;12;1;15;129;Lestrade-et-Thouels;463;14;477
76;Occitanie;12;3;07;130;Livinhac-le-Haut;1127;32;1159
76;Occitanie;12;2;03;131;La Loubière;1512;47;1559
76;Occitanie;12;2;14;133;Luc-la-Primaube;6005;166;6171
76;Occitanie;12;3;08;134;Lugan;347;10;357
76;Occitanie;12;3;02;135;Lunac;441;14;455
76;Occitanie;12;3;23;136;Maleville;938;17;955
76;Occitanie;12;3;05;137;Manhac;838;11;849
76;Occitanie;12;2;21;138;Marcillac-Vallon;1729;50;1779
76;Occitanie;12;1;04;139;Marnhagues-et-Latour;139;1;140
76;Occitanie;12;3;23;140;Martiel;988;24;1012
76;Occitanie;12;1;04;141;Martrin;222;7;229
76;Occitanie;12;3;06;142;Mayran;637;15;652
76;Occitanie;12;1;04;143;Mélagues;62;0;62
76;Occitanie;12;3;05;144;Meljac;125;2;127
76;Occitanie;12;1;98;145;Millau;21979;680;22659
76;Occitanie;12;2;17;146;Le Monastère;2284;77;2361
76;Occitanie;12;1;04;147;Montagnol;138;1;139
76;Occitanie;12;3;08;148;Montbazens;1407;39;1446
76;Occitanie;12;1;04;149;Montclar;154;5;159
76;Occitanie;12;3;02;150;Monteils;502;89;591
76;Occitanie;12;2;01;151;Montézic;214;8;222
76;Occitanie;12;1;04;152;Montfranc;127;2;129
76;Occitanie;12;1;20;153;Montjaux;421;7;428
76;Occitanie;12;1;04;154;Montlaur;619;26;645
76;Occitanie;12;1;04;155;Fondamente;334;9;343
76;Occitanie;12;2;01;156;Montpeyroux;532;13;545
76;Occitanie;12;2;03;157;Montrozier;1693;49;1742
76;Occitanie;12;3;23;158;Montsalès;327;8;335
76;Occitanie;12;3;02;159;Morlhon-le-Haut;561;24;585
76;Occitanie;12;1;20;160;Mostuéjouls;317;5;322
76;Occitanie;12;2;21;161;Mouret;545;15;560
76;Occitanie;12;3;05;162;Moyrazès;1080;28;1108
76;Occitanie;12;1;04;163;Murasson;210;4;214
76;Occitanie;12;2;01;164;Mur-de-Barrez;701;14;715
76;Occitanie;12;2;21;165;Muret-le-Château;363;16;379
76;Occitanie;12;2;01;166;Murols;115;1;116
76;Occitanie;12;3;02;167;Najac;699;22;721
76;Occitanie;12;1;12;168;Nant;998;18;1016
76;Occitanie;12;3;05;169;Naucelle;2007;146;2153
76;Occitanie;12;3;08;170;Naussac;370;8;378
76;Occitanie;12;2;21;171;Nauviale;584;19;603
76;Occitanie;12;2;10;172;Le Nayrac;530;12;542
76;Occitanie;12;2;14;174;Olemps;3439;99;3538
76;Occitanie;12;3;23;175;Ols-et-Rinhodes;178;2;180
76;Occitanie;12;2;18;176;Onet-le-Château;11665;594;12259
76;Occitanie;12;2;09;177;Palmas d'Aveyron;1017;15;1032
76;Occitanie;12;1;12;178;Paulhe;373;9;382
76;Occitanie;12;1;04;179;Peux-et-Couffouleux;84;1;85
76;Occitanie;12;1;20;180;Peyreleau;73;2;75
76;Occitanie;12;3;08;181;Peyrusse-le-Roc;214;5;219
76;Occitanie;12;2;09;182;Pierrefiche;279;5;284
76;Occitanie;12;1;04;183;Plaisance;218;6;224
76;Occitanie;12;2;09;184;Pomayrols;120;6;126
76;Occitanie;12;1;15;185;Pont-de-Salars;1639;68;1707
76;Occitanie;12;1;04;186;Pousthomy;211;2;213
76;Occitanie;12;2;09;187;Prades-d'Aubrac;354;4;358
76;Occitanie;12;1;15;188;Prades-Salars;316;10;326
76;Occitanie;12;3;05;189;Pradinas;354;6;360
76;Occitanie;12;3;02;190;Prévinquières;295;9;304
76;Occitanie;12;3;23;191;Privezac;322;9;331
76;Occitanie;12;1;04;192;Mounes-Prohencoux;185;4;189
76;Occitanie;12;2;21;193;Pruines;286;13;299
76;Occitanie;12;3;05;194;Quins;848;21;869
76;Occitanie;12;1;04;195;Rebourguil;274;3;277
76;Occitanie;12;1;13;197;Réquista;1983;78;2061
76;Occitanie;12;3;02;198;Rieupeyroux;1949;72;2021
76;Occitanie;12;3;06;199;Rignac;1991;142;2133
76;Occitanie;12;1;20;200;Rivière-sur-Tarn;1039;27;1066
76;Occitanie;12;2;03;201;Rodelle;1067;45;1112
76;Occitanie;12;2;99;202;Rodez;24475;1935;26410
76;Occitanie;12;1;19;203;Roquefort-sur-Soulzon;554;15;569
76;Occitanie;12;1;20;204;La Roque-Sainte-Marguerite;178;4;182
76;Occitanie;12;3;22;205;La Rouquette;775;16;791
76;Occitanie;12;3;08;206;Roussennac;637;15;652
76;Occitanie;12;1;13;207;Rullac-Saint-Cirq;345;14;359
76;Occitanie;12;1;19;208;Saint-Affrique;8023;635;8658
76;Occitanie;12;2;01;209;Saint-Amans-des-Cots;749;13;762
76;Occitanie;12;3;02;210;Saint-André-de-Najac;454;5;459
76;Occitanie;12;1;20;211;Saint-André-de-Vézines;134;1;135
76;Occitanie;12;1;04;212;Saint-Beaulize;88;7;95
76;Occitanie;12;1;20;213;Saint-Beauzély;616;15;631
76;Occitanie;12;2;01;214;Saint-Chély-d'Aubrac;521;13;534
76;Occitanie;12;2;21;215;Saint-Christophe-Vallon;1160;48;1208
76;Occitanie;12;2;09;216;Saint-Côme-d'Olt;1400;37;1437
76;Occitanie;12;3;23;217;Sainte-Croix;745;18;763
76;Occitanie;12;2;09;219;Sainte-Eulalie-d'Olt;376;9;385
76;Occitanie;12;1;04;220;Sainte-Eulalie-de-Cernon;288;2;290
76;Occitanie;12;2;07;221;Saint-Félix-de-Lunel;339;10;349
76;Occitanie;12;1;19;222;Saint-Félix-de-Sorgues;195;4;199
76;Occitanie;12;2;01;223;Argences en Aubrac;1600;38;1638
76;Occitanie;12;2;09;224;Saint Geniez d'Olt et d'Aubrac;2211;40;2251
76;Occitanie;12;1;11;225;Saint-Georges-de-Luzençon;1617;44;1661
76;Occitanie;12;2;10;226;Saint-Hippolyte;427;13;440
76;Occitanie;12;3;23;227;Saint-Igest;182;5;187
76;Occitanie;12;1;19;228;Saint-Izaire;303;8;311
76;Occitanie;12;1;19;229;Saint-Jean-d'Alcapiès;254;7;261
76;Occitanie;12;1;13;230;Saint-Jean-Delnous;403;16;419
76;Occitanie;12;1;12;231;Saint-Jean-du-Bruel;715;8;723
76;Occitanie;12;1;04;232;Saint-Jean-et-Saint-Paul;279;8;287
76;Occitanie;12;1;04;233;Saint-Juéry;293;3;296
76;Occitanie;12;3;13;234;Sainte-Juliette-sur-Viaur;613;8;621
76;Occitanie;12;3;05;235;Saint-Just-sur-Viaur;206;7;213
76;Occitanie;12;1;15;236;Saint-Laurent-de-Lévézou;154;5;159
76;Occitanie;12;2;20;237;Saint-Laurent-d'Olt;645;81;726
76;Occitanie;12;1;15;238;Saint-Léons;416;14;430
76;Occitanie;12;2;20;239;Saint-Martin-de-Lenne;315;13;328
76;Occitanie;12;3;07;240;Saint-Parthem;403;10;413
76;Occitanie;12;2;14;241;Sainte-Radegonde;1751;65;1816
76;Occitanie;12;3;23;242;Saint-Rémy;306;15;321
76;Occitanie;12;1;19;243;Saint-Rome-de-Cernon;948;13;961
76;Occitanie;12;1;15;244;Saint-Rome-de-Tarn;883;10;893
76;Occitanie;12;3;07;246;Saint-Santin;538;15;553
76;Occitanie;12;2;20;247;Saint-Saturnin-de-Lenne;284;7;291
76;Occitanie;12;1;04;248;Saint-Sernin-sur-Rance;611;104;715
76;Occitanie;12;1;04;249;Saint-Sever-du-Moustier;194;8;202
76;Occitanie;12;2;01;250;Saint-Symphorien-de-Thénières;205;2;207
76;Occitanie;12;1;15;251;Saint-Victor-et-Melvieu;336;7;343
76;Occitanie;12;3;08;252;Salles-Courbatiès;418;9;427
76;Occitanie;12;1;15;253;Salles-Curan;1013;30;1043
76;Occitanie;12;2;21;254;Salles-la-Source;2265;75;2340
76;Occitanie;12;1;13;255;Salmiech;766;28;794
76;Occitanie;12;3;23;256;Salvagnac-Cajarc;371;10;381
76;Occitanie;12;3;08;257;Causse-et-Diège;788;18;806
76;Occitanie;12;3;02;258;La Salvetat-Peyralès;982;15;997
76;Occitanie;12;3;02;259;Sanvensa;648;17;665
76;Occitanie;12;1;04;260;Sauclières;171;2;173
76;Occitanie;12;3;23;261;Saujac;122;4;126
76;Occitanie;12;3;05;262;Sauveterre-de-Rouergue;711;14;725
76;Occitanie;12;3;23;263;Savignac;732;23;755
76;Occitanie;12;2;03;264;Sébazac-Concourès;3256;92;3348
76;Occitanie;12;2;10;265;Sébrazac;521;14;535
76;Occitanie;12;1;15;266;Ségur;548;5;553
76;Occitanie;12;1;13;267;La Selve;627;12;639
76;Occitanie;12;2;07;268;Sénergues;421;18;439
76;Occitanie;12;1;04;269;La Serre;126;3;129
76;Occitanie;12;2;20;270;Sévérac d'Aveyron;4069;122;4191
76;Occitanie;12;3;08;272;Sonnac;519;13;532
76;Occitanie;12;2;01;273;Soulages-Bonneval;291;8;299
76;Occitanie;12;1;04;274;Sylvanès;112;2;114
76;Occitanie;12;1;04;275;Tauriac-de-Camarès;36;1;37
76;Occitanie;12;3;05;276;Tauriac-de-Naucelle;362;13;375
76;Occitanie;12;2;01;277;Taussac;530;4;534
76;Occitanie;12;3;02;278;Tayrac;183;2;185
76;Occitanie;12;2;01;280;Thérondels;407;6;413
76;Occitanie;12;3;23;281;Toulonjac;740;22;762
76;Occitanie;12;1;19;282;Tournemire;425;8;433
76;Occitanie;12;1;15;283;Trémouilles;485;15;500
76;Occitanie;12;1;15;284;Le Truel;345;1;346
76;Occitanie;12;1;19;286;Vabres-l'Abbaye;1206;31;1237
76;Occitanie;12;3;22;287;Vailhourles;636;22;658
76;Occitanie;12;2;21;288;Valady;1593;38;1631
76;Occitanie;12;3;08;289;Valzergues;206;8;214
76;Occitanie;12;3;23;290;Vaureilles;489;10;499
76;Occitanie;12;1;20;291;Verrières;403;9;412
76;Occitanie;12;1;19;292;Versols-et-Lapeyre;417;14;431
76;Occitanie;12;1;20;293;Veyreau;137;1;138
76;Occitanie;12;1;15;294;Vézins-de-Lévézou;656;18;674
76;Occitanie;12;1;04;295;Viala-du-Pas-de-Jaux;98;2;100
76;Occitanie;12;1;20;296;Viala-du-Tarn;529;13;542
76;Occitanie;12;1;15;297;Le Vibal;510;19;529
76;Occitanie;12;2;10;298;Villecomtal;415;8;423
76;Occitanie;12;1;15;299;Villefranche-de-Panat;692;26;718
76;Occitanie;12;3;22;300;Villefranche-de-Rouergue;11602;551;12153
76;Occitanie;12;3;23;301;Villeneuve;1988;46;2034
76;Occitanie;12;2;09;303;Vimenet;249;5;254
76;Occitanie;12;3;07;305;Viviez;1243;22;1265
76;Occitanie;12;1;15;307;Curan;295;15;310
93;Provence-Alpes-Côte d'Azur;13;1;97;001;Aix-en-Provence;145133;3203;148336
93;Provence-Alpes-Côte d'Azur;13;3;03;002;Allauch;21372;225;21597
93;Provence-Alpes-Côte d'Azur;13;1;25;003;Alleins;2626;54;2680
93;Provence-Alpes-Côte d'Azur;13;2;04;004;Arles;50454;789;51243
93;Provence-Alpes-Côte d'Azur;13;3;05;005;Aubagne;47535;451;47986
93;Provence-Alpes-Côte d'Azur;13;2;26;006;Aureille;1545;26;1571
93;Provence-Alpes-Côte d'Azur;13;3;03;007;Auriol;12922;162;13084
93;Provence-Alpes-Côte d'Azur;13;1;25;008;Aurons;563;16;579
93;Provence-Alpes-Côte d'Azur;13;1;25;009;La Barben;828;33;861
93;Provence-Alpes-Côte d'Azur;13;2;07;010;Barbentane;4192;162;4354
93;Provence-Alpes-Côte d'Azur;13;2;26;011;Les Baux-de-Provence;342;7;349
93;Provence-Alpes-Côte d'Azur;13;1;28;012;Beaurecueil;593;55;648
93;Provence-Alpes-Côte d'Azur;13;3;03;013;Belcodène;1916;35;1951
93;Provence-Alpes-Côte d'Azur;13;4;06;014;Berre-l'Étang;13660;77;13737
93;Provence-Alpes-Côte d'Azur;13;1;29;015;Bouc-Bel-Air;14838;305;15143
93;Provence-Alpes-Côte d'Azur;13;3;03;016;La Bouilladisse;6270;83;6353
93;Provence-Alpes-Côte d'Azur;13;2;07;017;Boulbon;1509;18;1527
93;Provence-Alpes-Côte d'Azur;13;2;07;018;Cabannes;4439;59;4498
93;Provence-Alpes-Côte d'Azur;13;1;29;019;Cabriès;9918;324;10242
93;Provence-Alpes-Côte d'Azur;13;3;03;020;Cadolive;2168;44;2212
93;Provence-Alpes-Côte d'Azur;13;4;11;021;Carry-le-Rouet;5690;127;5817
93;Provence-Alpes-Côte d'Azur;13;3;08;022;Cassis;6905;108;7013
93;Provence-Alpes-Côte d'Azur;13;3;08;023;Ceyreste;4729;109;4838
93;Provence-Alpes-Côte d'Azur;13;1;25;024;Charleval;2669;36;2705
93;Provence-Alpes-Côte d'Azur;13;1;28;025;Châteauneuf-le-Rouge;2380;76;2456
93;Provence-Alpes-Côte d'Azur;13;4;11;026;Châteauneuf-les-Martigues;17606;61;17667
93;Provence-Alpes-Côte d'Azur;13;2;07;027;Châteaurenard;16063;252;16315
93;Provence-Alpes-Côte d'Azur;13;3;08;028;La Ciotat;35993;381;36374
93;Provence-Alpes-Côte d'Azur;13;4;06;029;Cornillon-Confoux;1437;23;1460
93;Provence-Alpes-Côte d'Azur;13;3;08;030;Cuges-les-Pins;5244;55;5299
93;Provence-Alpes-Côte d'Azur;13;3;03;031;La Destrousse;3768;44;3812
93;Provence-Alpes-Côte d'Azur;13;1;25;032;Éguilles;8030;143;8173
93;Provence-Alpes-Côte d'Azur;13;4;11;033;Ensuès-la-Redonne;5783;99;5882
93;Provence-Alpes-Côte d'Azur;13;2;26;034;Eygalières;1740;28;1768
93;Provence-Alpes-Côte d'Azur;13;1;26;035;Eyguières;6844;161;7005
93;Provence-Alpes-Côte d'Azur;13;2;07;036;Eyragues;4496;128;4624
93;Provence-Alpes-Côte d'Azur;13;1;06;037;La Fare-les-Oliviers;8744;104;8848
93;Provence-Alpes-Côte d'Azur;13;2;26;038;Fontvieille;3544;71;3615
93;Provence-Alpes-Côte d'Azur;13;4;10;039;Fos-sur-Mer;15687;183;15870
93;Provence-Alpes-Côte d'Azur;13;1;28;040;Fuveau;10161;188;10349
93;Provence-Alpes-Côte d'Azur;13;1;09;041;Gardanne;21521;338;21859
93;Provence-Alpes-Côte d'Azur;13;3;08;042;Gémenos;6635;128;6763
93;Provence-Alpes-Côte d'Azur;13;4;11;043;Gignac-la-Nerthe;9887;90;9977
93;Provence-Alpes-Côte d'Azur;13;4;27;044;Grans;5196;84;5280
93;Provence-Alpes-Côte d'Azur;13;2;07;045;Graveson;4856;73;4929
93;Provence-Alpes-Côte d'Azur;13;1;03;046;Gréasque;4271;78;4349
93;Provence-Alpes-Côte d'Azur;13;4;10;047;Istres;43626;657;44283
93;Provence-Alpes-Côte d'Azur;13;1;28;048;Jouques;4406;98;4504
93;Provence-Alpes-Côte d'Azur;13;1;26;049;Lamanon;2037;41;2078
93;Provence-Alpes-Côte d'Azur;13;1;25;050;Lambesc;9909;266;10175
93;Provence-Alpes-Côte d'Azur;13;1;06;051;Lançon-Provence;8941;120;9061
93;Provence-Alpes-Côte d'Azur;13;2;07;052;Maillane;2667;33;2700
93;Provence-Alpes-Côte d'Azur;13;1;25;053;Mallemort;6134;156;6290
93;Provence-Alpes-Côte d'Azur;13;4;11;054;Marignane;32384;228;32612
93;Provence-Alpes-Côte d'Azur;13;4;24;056;Martigues;48574;516;49090
93;Provence-Alpes-Côte d'Azur;13;2;26;057;Mas-Blanc-des-Alpilles;517;11;528
93;Provence-Alpes-Côte d'Azur;13;2;26;058;Maussane-les-Alpilles;2362;50;2412
93;Provence-Alpes-Côte d'Azur;13;1;28;059;Meyrargues;3855;53;3908
93;Provence-Alpes-Côte d'Azur;13;1;28;060;Meyreuil;5821;91;5912
93;Provence-Alpes-Côte d'Azur;13;2;07;061;Saint-Pierre-de-Mézoargues;215;5;220
93;Provence-Alpes-Côte d'Azur;13;1;09;062;Mimet;4213;74;4287
93;Provence-Alpes-Côte d'Azur;13;4;27;063;Miramas;26428;400;26828
93;Provence-Alpes-Côte d'Azur;13;2;07;064;Mollégès;2656;29;2685
93;Provence-Alpes-Côte d'Azur;13;2;26;065;Mouriès;3410;49;3459
93;Provence-Alpes-Côte d'Azur;13;2;07;066;Noves;5847;68;5915
93;Provence-Alpes-Côte d'Azur;13;2;26;067;Orgon;2821;34;2855
93;Provence-Alpes-Côte d'Azur;13;2;26;068;Paradou;2110;36;2146
93;Provence-Alpes-Côte d'Azur;13;1;25;069;Pélissanne;10487;267;10754
93;Provence-Alpes-Côte d'Azur;13;3;05;070;La Penne-sur-Huveaune;6519;61;6580
93;Provence-Alpes-Côte d'Azur;13;1;09;071;Les Pennes-Mirabeau;21623;287;21910
93;Provence-Alpes-Côte d'Azur;13;1;28;072;Peynier;3540;94;3634
93;Provence-Alpes-Côte d'Azur;13;3;03;073;Peypin;5598;78;5676
93;Provence-Alpes-Côte d'Azur;13;1;28;074;Peyrolles-en-Provence;5134;89;5223
93;Provence-Alpes-Côte d'Azur;13;3;03;075;Plan-de-Cuques;11649;103;11752
93;Provence-Alpes-Côte d'Azur;13;2;07;076;Plan-d'Orgon;3515;49;3564
93;Provence-Alpes-Côte d'Azur;13;4;24;077;Port-de-Bouc;16651;127;16778
93;Provence-Alpes-Côte d'Azur;13;4;04;078;Port-Saint-Louis-du-Rhône;8424;80;8504
93;Provence-Alpes-Côte d'Azur;13;1;28;079;Puyloubier;1783;103;1886
93;Provence-Alpes-Côte d'Azur;13;1;28;080;Le Puy-Sainte-Réparade;5882;90;5972
93;Provence-Alpes-Côte d'Azur;13;4;06;081;Rognac;12086;123;12209
93;Provence-Alpes-Côte d'Azur;13;1;25;082;Rognes;4637;126;4763
93;Provence-Alpes-Côte d'Azur;13;2;07;083;Rognonas;4058;58;4116
93;Provence-Alpes-Côte d'Azur;13;1;25;084;La Roque-d'Anthéron;5426;120;5546
93;Provence-Alpes-Côte d'Azur;13;3;08;085;Roquefort-la-Bédoule;6015;74;6089
93;Provence-Alpes-Côte d'Azur;13;3;05;086;Roquevaire;8713;124;8837
93;Provence-Alpes-Côte d'Azur;13;1;28;087;Rousset;4918;140;5058
93;Provence-Alpes-Côte d'Azur;13;4;11;088;Le Rove;5145;48;5193
93;Provence-Alpes-Côte d'Azur;13;2;07;089;Saint-Andiol;3346;51;3397
93;Provence-Alpes-Côte d'Azur;13;1;28;090;Saint-Antonin-sur-Bayon;123;4;127
93;Provence-Alpes-Côte d'Azur;13;1;25;091;Saint-Cannat;5638;114;5752
93;Provence-Alpes-Côte d'Azur;13;4;06;092;Saint-Chamas;8591;129;8720
93;Provence-Alpes-Côte d'Azur;13;1;25;093;Saint-Estève-Janson;379;8;387
93;Provence-Alpes-Côte d'Azur;13;2;26;094;Saint-Étienne-du-Grès;2497;45;2542
93;Provence-Alpes-Côte d'Azur;13;1;28;095;Saint-Marc-Jaumegarde;1236;68;1304
93;Provence-Alpes-Côte d'Azur;13;2;04;096;Saintes-Maries-de-la-Mer;2144;21;2165
93;Provence-Alpes-Côte d'Azur;13;2;27;097;Saint-Martin-de-Crau;13413;299;13712
93;Provence-Alpes-Côte d'Azur;13;4;10;098;Saint-Mitre-les-Remparts;5820;110;5930
93;Provence-Alpes-Côte d'Azur;13;1;28;099;Saint-Paul-lès-Durance;885;13;898
93;Provence-Alpes-Côte d'Azur;13;2;26;100;Saint-Rémy-de-Provence;9769;223;9992
93;Provence-Alpes-Côte d'Azur;13;3;03;101;Saint-Savournin;3443;59;3502
93;Provence-Alpes-Côte d'Azur;13;4;29;102;Saint-Victoret;6631;52;6683
93;Provence-Alpes-Côte d'Azur;13;1;99;103;Salon-de-Provence;45386;584;45970
93;Provence-Alpes-Côte d'Azur;13;4;11;104;Sausset-les-Pins;7581;144;7725
93;Provence-Alpes-Côte d'Azur;13;1;26;105;Sénas;6894;86;6980
93;Provence-Alpes-Côte d'Azur;13;3;09;106;Septèmes-les-Vallons;11196;95;11291
93;Provence-Alpes-Côte d'Azur;13;1;09;107;Simiane-Collongue;5808;122;5930
93;Provence-Alpes-Côte d'Azur;13;2;07;108;Tarascon;15811;142;15953
93;Provence-Alpes-Côte d'Azur;13;1;28;109;Le Tholonet;2271;56;2327
93;Provence-Alpes-Côte d'Azur;13;1;28;110;Trets;10303;150;10453
93;Provence-Alpes-Côte d'Azur;13;1;28;111;Vauvenargues;1007;20;1027
93;Provence-Alpes-Côte d'Azur;13;1;06;112;Velaux;8582;151;8733
93;Provence-Alpes-Côte d'Azur;13;1;28;113;Venelles;8400;184;8584
93;Provence-Alpes-Côte d'Azur;13;1;06;114;Ventabren;5407;137;5544
93;Provence-Alpes-Côte d'Azur;13;1;25;115;Vernègues;2028;40;2068
93;Provence-Alpes-Côte d'Azur;13;2;07;116;Verquières;819;17;836
93;Provence-Alpes-Côte d'Azur;13;4;29;117;Vitrolles;33333;368;33701
93;Provence-Alpes-Côte d'Azur;13;1;06;118;Coudoux;3702;52;3754
93;Provence-Alpes-Côte d'Azur;13;3;08;119;Carnoux-en-Provence;6498;84;6582
93;Provence-Alpes-Côte d'Azur;13;3;12;201;Marseille 1er Arrondissement;39893;200;40093
93;Provence-Alpes-Côte d'Azur;13;3;13;202;Marseille 2e Arrondissement;25217;58;25275
93;Provence-Alpes-Côte d'Azur;13;3;98;203;Marseille 3e Arrondissement;51792;194;51986
93;Provence-Alpes-Côte d'Azur;13;3;98;204;Marseille 4e Arrondissement;49296;303;49599
93;Provence-Alpes-Côte d'Azur;13;3;98;205;Marseille 5e Arrondissement;46152;279;46431
93;Provence-Alpes-Côte d'Azur;13;3;98;206;Marseille 6e Arrondissement;42135;406;42541
93;Provence-Alpes-Côte d'Azur;13;3;23;207;Marseille 7e Arrondissement;34697;313;35010
93;Provence-Alpes-Côte d'Azur;13;3;98;208;Marseille 8e Arrondissement;81436;1254;82690
93;Provence-Alpes-Côte d'Azur;13;3;98;209;Marseille 9e Arrondissement;76633;654;77287
93;Provence-Alpes-Côte d'Azur;13;3;98;210;Marseille 10e Arrondissement;58491;340;58831
93;Provence-Alpes-Côte d'Azur;13;3;98;211;Marseille 11e Arrondissement;57278;443;57721
93;Provence-Alpes-Côte d'Azur;13;3;98;212;Marseille 12e Arrondissement;61406;552;61958
93;Provence-Alpes-Côte d'Azur;13;3;98;213;Marseille 13e Arrondissement;91358;717;92075
93;Provence-Alpes-Côte d'Azur;13;3;98;214;Marseille 14e Arrondissement;61702;252;61954
93;Provence-Alpes-Côte d'Azur;13;3;98;215;Marseille 15e Arrondissement;77243;299;77542
93;Provence-Alpes-Côte d'Azur;13;3;14;216;Marseille 16e Arrondissement;16002;100;16102
28;Normandie;14;3;15;001;Ablon;1212;45;1257
28;Normandie;14;1;02;003;Agy;304;7;311
28;Normandie;14;2;24;005;Valambray;1723;38;1761
28;Normandie;14;2;12;006;Amayé-sur-Orne;1046;21;1067
28;Normandie;14;4;01;007;Amayé-sur-Seulles;231;4;235
28;Normandie;14;3;04;009;Amfreville;1356;19;1375
28;Normandie;14;4;01;011;Aurseulles;1894;38;1932
28;Normandie;14;3;04;012;Angerville;192;1;193
28;Normandie;14;2;11;014;Colomby-Anguerny;1206;34;1240
28;Normandie;14;2;11;015;Anisy;738;22;760
28;Normandie;14;3;04;016;Annebault;484;14;498
28;Normandie;14;1;02;019;Arganchy;219;3;222
28;Normandie;14;2;24;020;Argences;3795;30;3825
28;Normandie;14;1;11;021;Arromanches-les-Bains;473;11;484
28;Normandie;14;1;11;022;Asnelles;584;8;592
28;Normandie;14;1;23;023;Asnières-en-Bessin;68;1;69
28;Normandie;14;3;04;024;Auberville;591;12;603
28;Normandie;14;2;13;025;Aubigny;308;3;311
28;Normandie;14;1;03;026;Audrieu;1109;20;1129
28;Normandie;14;4;89;027;Les Monts d'Aunay;4595;67;4662
28;Normandie;14;2;06;030;Authie;1696;49;1745
28;Normandie;14;3;21;032;Les Authieux-sur-Calonne;275;11;286
28;Normandie;14;3;19;033;Auvillars;216;2;218
28;Normandie;14;2;12;034;Avenay;569;2;571
28;Normandie;14;1;23;035;Balleroy-sur-Drôme;1374;57;1431
28;Normandie;14;2;24;036;Banneville-la-Campagne;172;1;173
28;Normandie;14;4;01;037;Malherbe-sur-Ajon;565;13;578
28;Normandie;14;1;11;038;Banville;789;9;798
28;Normandie;14;2;22;039;Barbery;824;18;842
28;Normandie;14;1;02;040;Barbeville;189;3;192
28;Normandie;14;3;15;041;Barneville-la-Bertran;124;2;126
28;Normandie;14;2;12;042;Baron-sur-Odon;975;21;996
28;Normandie;14;2;13;043;Barou-en-Auge;70;0;70
28;Normandie;14;2;11;044;Basly;1073;18;1091
28;Normandie;14;3;04;045;Basseneville;252;2;254
28;Normandie;14;3;04;046;Bavent;1923;14;1937
28;Normandie;14;1;02;047;Bayeux;12682;329;13011
28;Normandie;14;1;11;049;Bazenville;139;2;141
28;Normandie;14;1;23;050;La Bazoque;181;2;183
28;Normandie;14;2;13;053;Beaumais;172;3;175
28;Normandie;14;4;25;054;Beaumesnil;200;3;203
28;Normandie;14;3;21;055;Beaumont-en-Auge;405;9;414
28;Normandie;14;2;24;057;Bellengreville;1477;8;1485
28;Normandie;14;3;21;059;Benerville-sur-Mer;414;32;446
28;Normandie;14;2;20;060;Bénouville;2042;26;2068
28;Normandie;14;4;10;061;Souleuvre en Bocage;8950;157;9107
28;Normandie;14;1;03;062;Bény-sur-Mer;447;7;454
28;Normandie;14;1;23;063;Bernesq;214;1;215
28;Normandie;14;2;13;064;Bernières-d'Ailly;224;7;231
28;Normandie;14;2;11;066;Bernières-sur-Mer;2274;35;2309
28;Normandie;14;2;20;068;Biéville-Beuville;3561;85;3646
28;Normandie;14;3;17;069;Beuvillers;1338;27;1365
28;Normandie;14;3;19;070;Beuvron-en-Auge;194;2;196
28;Normandie;14;2;20;076;Blainville-sur-Orne;5855;73;5928
28;Normandie;14;3;21;077;Blangy-le-Château;719;55;774
28;Normandie;14;1;23;078;Blay;370;4;374
28;Normandie;14;3;21;079;Blonville-sur-Mer;1553;35;1588
28;Normandie;14;2;22;080;Le Bô;124;5;129
28;Normandie;14;3;19;082;La Boissière;189;9;198
28;Normandie;14;3;19;083;Bonnebosq;666;15;681
28;Normandie;14;4;01;084;Bonnemaison;403;9;412
28;Normandie;14;3;21;085;Bonneville-la-Louvet;795;21;816
28;Normandie;14;3;21;086;Bonneville-sur-Touques;325;13;338
28;Normandie;14;2;13;087;Bonnœil;125;1;126
28;Normandie;14;2;13;088;Bons-Tassilly;406;7;413
28;Normandie;14;2;12;089;Bougy;394;9;403
28;Normandie;14;2;22;090;Boulon;736;6;742
28;Normandie;14;3;04;091;Bourgeauville;102;1;103
28;Normandie;14;2;12;092;Bourguébus;2186;24;2210
28;Normandie;14;3;04;093;Branville;198;5;203
28;Normandie;14;4;01;096;Brémoy;226;6;232
28;Normandie;14;2;22;097;Bretteville-le-Rabet;305;4;309
28;Normandie;14;2;03;098;Thue et Mue;6120;100;6220
28;Normandie;14;2;22;100;Bretteville-sur-Laize;1913;24;1937
28;Normandie;14;2;05;101;Bretteville-sur-Odon;4005;72;4077
28;Normandie;14;3;21;102;Le Breuil-en-Auge;1012;23;1035
28;Normandie;14;1;23;103;Le Breuil-en-Bessin;408;7;415
28;Normandie;14;3;21;104;Le Brévedent;166;4;170
28;Normandie;14;3;04;106;Bréville-les-Monts;660;6;666
28;Normandie;14;1;23;107;Bricqueville;164;0;164
28;Normandie;14;3;04;110;Brucourt;125;2;127
28;Normandie;14;1;03;111;Bucéels;438;6;444
28;Normandie;14;2;22;116;Le Bû-sur-Rouvres;109;5;114
28;Normandie;14;3;04;117;Cabourg;3558;31;3589
28;Normandie;14;2;99;118;Caen;106230;2174;108404
28;Normandie;14;2;24;119;Cagny;1966;21;1987
28;Normandie;14;4;01;120;Cahagnes;1396;23;1419
28;Normandie;14;1;23;121;Cahagnolles;252;1;253
28;Normandie;14;2;12;122;La Caine;158;1;159
28;Normandie;14;2;03;123;Cairon;2021;48;2069
28;Normandie;14;1;23;124;La Cambe;546;10;556
28;Normandie;14;2;20;125;Cambes-en-Plaine;1753;49;1802
28;Normandie;14;3;19;126;Cambremer;1334;36;1370
28;Normandie;14;4;25;127;Campagnolles;548;4;552
28;Normandie;14;1;02;130;Campigny;186;1;187
28;Normandie;14;3;21;131;Canapville;228;4;232
28;Normandie;14;1;23;132;Canchy;204;0;204
28;Normandie;14;2;24;134;Canteloup;186;5;191
28;Normandie;14;1;03;135;Carcagny;281;2;283
28;Normandie;14;1;23;136;Cardonville;101;0;101
28;Normandie;14;2;06;137;Carpiquet;2886;25;2911
28;Normandie;14;1;23;138;Cartigny-l'Épinay;292;6;298
28;Normandie;14;1;23;140;Castillon;349;6;355
28;Normandie;14;3;19;141;Castillon-en-Auge;163;2;165
28;Normandie;14;4;01;143;Caumont-sur-Aure;2372;25;2397
28;Normandie;14;2;22;145;Cauvicourt;525;4;529
28;Normandie;14;2;22;146;Cauville;169;4;173
28;Normandie;14;3;18;147;Cernay;140;1;141
28;Normandie;14;2;24;149;Cesny-aux-Vignes;422;13;435
28;Normandie;14;2;22;150;Cesny-les-Sources;1338;27;1365
28;Normandie;14;1;02;159;Chouain;220;13;233
28;Normandie;14;2;22;160;Cintheaux;188;6;194
28;Normandie;14;3;21;161;Clarbec;342;16;358
28;Normandie;14;2;22;162;Clécy;1305;15;1320
28;Normandie;14;2;24;163;Cléville;382;3;385
28;Normandie;14;1;23;165;Colleville-sur-Mer;174;4;178
28;Normandie;14;2;20;166;Colleville-Montgomery;2555;44;2599
28;Normandie;14;2;14;167;Colombelles;6976;52;7028
28;Normandie;14;1;23;168;Colombières;207;5;212
28;Normandie;14;1;03;169;Colombiers-sur-Seulles;159;0;159
28;Normandie;14;2;22;171;Combray;144;1;145
28;Normandie;14;1;02;172;Commes;432;10;442
28;Normandie;14;2;19;173;Condé-sur-Ifs;440;14;454
28;Normandie;14;4;10;174;Condé-en-Normandie;6452;274;6726
28;Normandie;14;1;02;175;Condé-sur-Seulles;292;5;297
28;Normandie;14;3;21;177;Coquainvilliers;848;17;865
28;Normandie;14;3;17;179;Cordebugle;164;5;169
28;Normandie;14;2;13;180;Cordey;156;3;159
28;Normandie;14;2;16;181;Cormelles-le-Royal;4957;45;5002
28;Normandie;14;1;23;182;Cormolain;404;6;410
28;Normandie;14;2;22;183;Cossesseville;103;1;104
28;Normandie;14;1;02;184;Cottun;229;0;229
28;Normandie;14;2;13;190;Courcy;128;5;133
28;Normandie;14;2;11;191;Courseulles-sur-Mer;4196;54;4250
28;Normandie;14;3;17;193;Courtonne-la-Meurdrac;655;20;675
28;Normandie;14;3;17;194;Courtonne-les-Deux-Églises;648;10;658
28;Normandie;14;4;01;195;Courvaudon;261;1;262
28;Normandie;14;1;11;196;Crépon;208;6;214
28;Normandie;14;2;11;197;Cresserons;1116;27;1143
28;Normandie;14;3;04;198;Cresseveuille;255;9;264
28;Normandie;14;1;03;200;Creully sur Seulles;2261;79;2340
28;Normandie;14;3;15;202;Cricquebœuf;267;6;273
28;Normandie;14;3;04;203;Cricqueville-en-Auge;192;7;199
28;Normandie;14;1;23;204;Cricqueville-en-Bessin;179;2;181
28;Normandie;14;1;03;205;Cristot;217;6;223
28;Normandie;14;2;13;206;Crocy;298;0;298
28;Normandie;14;2;22;207;Croisilles;646;9;655
28;Normandie;14;1;23;209;Crouay;512;10;522
28;Normandie;14;2;22;211;Culey-le-Patry;360;4;364
28;Normandie;14;1;02;214;Cussy;190;2;192
28;Normandie;14;2;24;215;Cuverville;2259;34;2293
28;Normandie;14;2;13;216;Damblainville;238;3;241
28;Normandie;14;3;04;218;Danestal;403;6;409
28;Normandie;14;3;15;220;Deauville;3565;60;3625
28;Normandie;14;2;24;221;Démouville;3117;45;3162
28;Normandie;14;2;13;223;Le Détroit;87;2;89
28;Normandie;14;1;23;224;Deux-Jumeaux;49;2;51
28;Normandie;14;3;04;225;Dives-sur-Mer;5276;169;5445
28;Normandie;14;2;22;226;Donnay;299;2;301
28;Normandie;14;3;04;227;Douville-en-Auge;210;6;216
28;Normandie;14;2;11;228;Douvres-la-Délivrande;4973;204;5177
28;Normandie;14;3;04;229;Dozulé;2293;22;2315
28;Normandie;14;3;19;230;Drubec;116;1;117
28;Normandie;14;3;19;231;Beaufour-Druval;446;12;458
28;Normandie;14;1;03;232;Ducy-Sainte-Marguerite;168;3;171
28;Normandie;14;1;02;236;Ellon;585;7;592
28;Normandie;14;2;24;237;Émiéville;618;7;625
28;Normandie;14;3;21;238;Englesqueville-en-Auge;109;2;111
28;Normandie;14;1;23;239;Englesqueville-la-Percée;107;0;107
28;Normandie;14;2;13;240;Épaney;511;12;523
28;Normandie;14;4;01;241;Épinay-sur-Odon;621;15;636
28;Normandie;14;2;07;242;Épron;1623;24;1647
28;Normandie;14;3;15;243;Équemauville;1587;6;1593
28;Normandie;14;2;13;244;Eraines;312;11;323
28;Normandie;14;2;13;245;Ernes;320;11;331
28;Normandie;14;3;24;246;Escoville;807;6;813
28;Normandie;14;2;22;248;Espins;250;5;255
28;Normandie;14;2;12;249;Esquay-Notre-Dame;1431;10;1441
28;Normandie;14;1;02;250;Esquay-sur-Seulles;283;6;289
28;Normandie;14;2;22;251;Esson;539;6;545
28;Normandie;14;2;22;252;Estrées-la-Campagne;260;3;263
28;Normandie;14;2;09;254;Éterville;1653;27;1680
28;Normandie;14;1;23;256;Étréham;336;5;341
28;Normandie;14;2;12;257;Évrecy;2013;27;2040
28;Normandie;14;2;13;258;Falaise;7968;250;8218
28;Normandie;14;3;21;260;Fauguernon;245;7;252
28;Normandie;14;3;21;261;Le Faulq;338;7;345
28;Normandie;14;2;12;266;Feuguerolles-Bully;1439;23;1462
28;Normandie;14;3;21;269;Fierville-les-Parcs;226;4;230
28;Normandie;14;3;21;270;Firfol;398;16;414
28;Normandie;14;2;09;271;Fleury-sur-Orne;4938;69;5007
28;Normandie;14;1;23;272;La Folie;96;2;98
28;Normandie;14;3;18;273;La Folletière-Abenon;136;1;137
28;Normandie;14;2;12;274;Fontaine-Étoupefour;2617;64;2681
28;Normandie;14;1;03;275;Fontaine-Henry;464;6;470
28;Normandie;14;2;13;276;Fontaine-le-Pin;355;4;359
28;Normandie;14;2;12;277;Fontenay-le-Marmion;1941;13;1954
28;Normandie;14;1;03;278;Fontenay-le-Pesnel;1199;18;1217
28;Normandie;14;3;19;280;Formentin;256;9;265
28;Normandie;14;1;23;281;Formigny La Bataille;735;14;749
28;Normandie;14;1;23;282;Foulognes;208;6;214
28;Normandie;14;2;13;283;Fourches;224;7;231
28;Normandie;14;2;13;284;Fourneaux-le-Val;156;4;160
28;Normandie;14;3;19;285;Le Fournet;71;2;73
28;Normandie;14;3;15;286;Fourneville;484;20;504
28;Normandie;14;2;24;287;Frénouville;1970;14;1984
28;Normandie;14;2;03;288;Le Fresne-Camilly;933;24;957
28;Normandie;14;2;13;289;Fresné-la-Mère;584;13;597
28;Normandie;14;2;22;290;Fresney-le-Puceux;812;8;820
28;Normandie;14;2;22;291;Fresney-le-Vieux;289;4;293
28;Normandie;14;3;21;293;Fumichon;274;6;280
28;Normandie;14;2;12;297;Gavrus;584;7;591
28;Normandie;14;1;23;298;Géfosse-Fontenay;135;3;138
28;Normandie;14;3;15;299;Genneville;835;18;853
28;Normandie;14;3;19;300;Gerrots;52;0;52
28;Normandie;14;2;16;301;Giberville;4916;47;4963
28;Normandie;14;3;21;302;Glanville;166;14;180
28;Normandie;14;3;17;303;Glos;919;20;939
28;Normandie;14;3;15;304;Gonneville-sur-Honfleur;882;35;917
28;Normandie;14;3;04;305;Gonneville-sur-Mer;678;13;691
28;Normandie;14;3;04;306;Gonneville-en-Auge;390;5;395
28;Normandie;14;3;04;308;Goustranville;268;0;268
28;Normandie;14;2;22;309;Gouvix;840;4;844
28;Normandie;14;2;22;310;Grainville-Langannerie;706;7;713
28;Normandie;14;2;12;311;Grainville-sur-Odon;1045;9;1054
28;Normandie;14;1;23;312;Grandcamp-Maisy;1536;24;1560
28;Normandie;14;3;04;316;Grangues;265;3;268
28;Normandie;14;1;11;318;Graye-sur-Mer;728;7;735
28;Normandie;14;2;12;319;Grentheville;973;8;981
28;Normandie;14;2;22;320;Grimbosq;283;7;290
28;Normandie;14;1;02;322;Guéron;245;5;250
28;Normandie;14;2;20;325;Hermanville-sur-Mer;3110;42;3152
28;Normandie;14;3;21;326;Hermival-les-Vaux;808;39;847
28;Normandie;14;2;14;327;Hérouville-Saint-Clair;22555;275;22830
28;Normandie;14;3;04;328;Hérouvillette;1345;9;1354
28;Normandie;14;3;04;329;Heuland;109;4;113
28;Normandie;14;2;13;332;La Hoguette;667;11;678
28;Normandie;14;3;15;333;Honfleur;6733;200;6933
28;Normandie;14;3;17;334;L'Hôtellerie;316;6;322
28;Normandie;14;3;19;335;Hotot-en-Auge;300;3;303
28;Normandie;14;1;01;336;Hottot-les-Bagues;476;5;481
28;Normandie;14;3;19;337;La Houblonnière;329;10;339
28;Normandie;14;3;04;338;Houlgate;1711;37;1748
28;Normandie;14;2;16;341;Ifs;11696;193;11889
28;Normandie;14;1;23;342;Isigny-sur-Mer;3610;43;3653
28;Normandie;14;2;13;343;Les Isles-Bardel;66;0;66
28;Normandie;14;2;24;344;Janville;379;9;388
28;Normandie;14;2;13;345;Jort;301;2;303
28;Normandie;14;1;02;346;Juaye-Mondaye;679;14;693
28;Normandie;14;4;01;347;Dialan sur Chaîne;1041;12;1053
28;Normandie;14;1;03;348;Juvigny-sur-Seulles;81;1;82
28;Normandie;14;2;12;349;Laize-Clinchamps;2116;21;2137
28;Normandie;14;4;25;352;Landelles-et-Coupigny;841;20;861
28;Normandie;14;4;01;353;Landes-sur-Ajon;451;5;456
28;Normandie;14;2;11;354;Langrune-sur-Mer;1934;48;1982
28;Normandie;14;1;03;355;Ponts sur Seulles;1191;20;1211
28;Normandie;14;4;10;357;Terres de Druance;910;22;932
28;Normandie;14;3;19;358;Léaupartie;89;2;91
28;Normandie;14;2;13;360;Leffard;216;2;218
28;Normandie;14;3;19;362;Lessard-et-le-Chêne;160;0;160
28;Normandie;14;1;01;364;Lingèvres;465;13;478
28;Normandie;14;2;20;365;Lion-sur-Mer;2536;40;2576
28;Normandie;14;3;17;366;Lisieux;20038;654;20692
28;Normandie;14;1;23;367;Lison;437;5;442
28;Normandie;14;3;18;368;Lisores;262;11;273
28;Normandie;14;1;23;369;Litteau;288;3;291
28;Normandie;14;1;23;370;Le Molay-Littry;3016;39;3055
28;Normandie;14;3;18;371;Livarot-Pays-d'Auge;6220;110;6330
28;Normandie;14;4;01;374;Les Loges;142;2;144
28;Normandie;14;2;13;375;Les Loges-Saulces;166;3;169
28;Normandie;14;1;02;377;Longues-sur-Mer;592;9;601
28;Normandie;14;1;23;378;Longueville;274;9;283
28;Normandie;14;4;01;379;Longvillers;364;5;369
28;Normandie;14;1;03;380;Loucelles;186;5;191
28;Normandie;14;2;13;381;Louvagny;61;2;63
28;Normandie;14;2;09;383;Louvigny;2683;38;2721
28;Normandie;14;2;11;384;Luc-sur-Mer;3213;52;3265
28;Normandie;14;1;02;385;Magny-en-Bessin;164;9;173
28;Normandie;14;4;01;389;Maisoncelles-Pelvey;263;9;272
28;Normandie;14;4;01;390;Maisoncelles-sur-Ajon;189;4;193
28;Normandie;14;1;23;391;Maisons;393;4;397
28;Normandie;14;2;12;393;Maizet;366;7;373
28;Normandie;14;2;13;394;Maizières;428;14;442
28;Normandie;14;2;12;396;Maltot;1024;15;1039
28;Normandie;14;1;23;397;Mandeville-en-Bessin;335;6;341
28;Normandie;14;3;19;398;Manerbe;547;16;563
28;Normandie;14;3;21;399;Manneville-la-Pipard;275;11;286
28;Normandie;14;1;02;400;Le Manoir;217;3;220
28;Normandie;14;1;02;401;Manvieux;132;6;138
28;Normandie;14;2;13;402;Le Marais-la-Chapelle;109;2;111
28;Normandie;14;3;17;403;Marolles;745;21;766
28;Normandie;14;2;22;404;Martainville;120;2;122
28;Normandie;14;2;13;405;Martigny-sur-l'Ante;325;7;332
28;Normandie;14;1;03;406;Moulins-en-Bessin;1116;27;1143
28;Normandie;14;2;20;407;Mathieu;2286;56;2342
28;Normandie;14;2;12;408;May-sur-Orne;2014;14;2028
28;Normandie;14;3;04;409;Merville-Franceville-Plage;2186;35;2221
28;Normandie;14;3;19;410;Méry-Bissières-en-Auge;1080;7;1087
28;Normandie;14;2;22;411;Meslay;309;6;315
28;Normandie;14;4;01;412;Le Mesnil-au-Grain;83;2;85
28;Normandie;14;3;19;419;Le Mesnil-Eudes;257;9;266
28;Normandie;14;3;17;421;Le Mesnil-Guillaume;607;6;613
28;Normandie;14;4;25;424;Le Mesnil-Robert;190;3;193
28;Normandie;14;3;19;425;Le Mesnil-Simon;164;6;170
28;Normandie;14;3;21;426;Le Mesnil-sur-Blangy;160;7;167
28;Normandie;14;2;13;427;Le Mesnil-Villement;294;3;297
28;Normandie;14;1;11;430;Meuvaines;137;3;140
28;Normandie;14;3;19;431;Mézidon Vallée d'Auge;9586;113;9699
28;Normandie;14;3;19;435;Les Monceaux;198;3;201
28;Normandie;14;1;02;436;Monceaux-en-Bessin;558;5;563
28;Normandie;14;2;16;437;Mondeville;9973;244;10217
28;Normandie;14;2;12;438;Mondrainville;545;10;555
28;Normandie;14;1;23;439;Monfréville;90;2;92
28;Normandie;14;1;23;445;Montfiquet;95;2;97
28;Normandie;14;2;12;446;Montigny;98;2;100
28;Normandie;14;3;19;448;Montreuil-en-Auge;64;0;64
28;Normandie;14;4;01;449;Monts-en-Bessin;408;5;413
28;Normandie;14;2;13;452;Morteaux-Coulibœuf;626;10;636
28;Normandie;14;1;23;453;Mosles;352;7;359
28;Normandie;14;2;05;454;Mouen;1626;22;1648
28;Normandie;14;2;22;455;Moulines;285;2;287
28;Normandie;14;2;24;456;Moult-Chicheboville;3273;45;3318
28;Normandie;14;2;13;457;Les Moutiers-en-Auge;128;1;129
28;Normandie;14;2;22;458;Les Moutiers-en-Cinglais;533;58;591
28;Normandie;14;3;21;460;Moyaux;1353;31;1384
28;Normandie;14;2;22;461;Mutrécy;470;2;472
28;Normandie;14;1;02;465;Nonant;501;13;514
28;Normandie;14;3;21;466;Norolles;342;9;351
28;Normandie;14;2;13;467;Noron-l'Abbaye;320;7;327
28;Normandie;14;1;23;468;Noron-la-Poterie;363;6;369
28;Normandie;14;2;13;469;Norrey-en-Auge;91;3;94
28;Normandie;14;3;19;473;Notre-Dame-de-Livaye;112;3;115
28;Normandie;14;3;19;474;Notre-Dame-d'Estrées-Corbon;201;3;204
28;Normandie;14;4;01;475;Val d'Arry;2352;43;2395
28;Normandie;14;2;13;476;Olendon;178;3;181
28;Normandie;14;3;18;478;Orbec;1967;50;2017
28;Normandie;14;1;23;480;Osmanville;521;7;528
28;Normandie;14;2;24;482;Ouézy;238;2;240
28;Normandie;14;2;22;483;Ouffières;191;3;194
28;Normandie;14;3;21;484;Ouilly-du-Houley;245;4;249
28;Normandie;14;2;13;486;Ouilly-le-Tesson;570;9;579
28;Normandie;14;3;21;487;Ouilly-le-Vicomte;774;23;797
28;Normandie;14;2;20;488;Ouistreham;9344;118;9462
28;Normandie;14;4;01;491;Parfouru-sur-Odon;196;11;207
28;Normandie;14;3;15;492;Pennedepie;313;7;320
28;Normandie;14;3;04;494;Périers-en-Auge;129;7;136
28;Normandie;14;2;20;495;Périers-sur-le-Dan;548;11;559
28;Normandie;14;4;10;496;Périgny;57;4;61
28;Normandie;14;2;13;497;Perrières;333;7;340
28;Normandie;14;2;13;498;Pertheville-Ners;240;4;244
28;Normandie;14;3;04;499;Petiville;534;5;539
28;Normandie;14;3;21;500;Pierrefitte-en-Auge;159;6;165
28;Normandie;14;2;13;501;Pierrefitte-en-Cinglais;247;5;252
28;Normandie;14;2;13;502;Pierrepont;89;1;90
28;Normandie;14;3;21;504;Le Pin;813;21;834
28;Normandie;14;1;23;506;Planquery;246;3;249
28;Normandie;14;2;11;509;Plumetot;212;5;217
28;Normandie;14;2;22;510;La Pommeraye;55;3;58
28;Normandie;14;4;25;511;Pont-Bellanger;67;0;67
28;Normandie;14;4;10;512;Pontécoulant;73;0;73
28;Normandie;14;3;21;514;Pont-l'Évêque;4627;70;4697
28;Normandie;14;1;02;515;Port-en-Bessin-Huppain;1938;17;1955
28;Normandie;14;2;13;516;Potigny;2079;19;2098
28;Normandie;14;2;12;519;Préaux-Bocage;126;0;126
28;Normandie;14;3;19;520;Le Pré-d'Auge;867;23;890
28;Normandie;14;3;19;522;Prêtreville;391;7;398
28;Normandie;14;3;04;524;Putot-en-Auge;294;5;299
28;Normandie;14;3;19;527;Belle Vie en Auge;538;8;546
28;Normandie;14;3;15;528;Quetteville;391;5;396
28;Normandie;14;1;02;529;Ranchy;262;3;265
28;Normandie;14;3;04;530;Ranville;1909;27;1936
28;Normandie;14;2;13;531;Rapilly;48;0;48
28;Normandie;14;3;19;533;Repentigny;96;4;100
28;Normandie;14;3;21;534;Reux;391;6;397
28;Normandie;14;2;03;535;Reviers;554;12;566
28;Normandie;14;3;15;536;La Rivière-Saint-Sauveur;2547;43;2590
28;Normandie;14;2;12;538;Castine-en-Plaine;1650;31;1681
28;Normandie;14;3;21;540;Rocques;289;14;303
28;Normandie;14;3;19;541;La Roque-Baignard;121;1;122
28;Normandie;14;2;03;542;Rosel;535;11;546
28;Normandie;14;2;03;543;Rots;2448;71;2519
28;Normandie;14;2;13;546;Rouvres;222;2;224
28;Normandie;14;1;23;547;Rubercy;158;3;161
28;Normandie;14;3;19;550;Rumesnil;94;1;95
28;Normandie;14;1;02;552;Ryes;505;14;519
28;Normandie;14;2;12;554;Le Castelet;1659;10;1669
28;Normandie;14;3;21;555;Saint-André-d'Hébertot;452;6;458
28;Normandie;14;2;09;556;Saint-André-sur-Orne;1822;23;1845
28;Normandie;14;3;21;557;Saint-Arnoult;1132;12;1144
28;Normandie;14;2;20;558;Saint-Aubin-d'Arquenay;1093;15;1108
28;Normandie;14;4;25;559;Saint-Aubin-des-Bois;229;1;230
28;Normandie;14;2;11;562;Saint-Aubin-sur-Mer;2237;41;2278
28;Normandie;14;3;21;563;Saint-Benoît-d'Hébertot;430;9;439
28;Normandie;14;1;11;565;Saint-Côme-de-Fresné;259;4;263
28;Normandie;14;2;06;566;Saint-Contest;2525;52;2577
28;Normandie;14;1;11;569;Sainte-Croix-sur-Mer;236;6;242
28;Normandie;14;3;18;570;Valorbiquet;2507;44;2551
28;Normandie;14;3;18;571;Saint-Denis-de-Mailloc;305;5;310
28;Normandie;14;4;10;572;Saint-Denis-de-Méré;788;7;795
28;Normandie;14;3;19;574;Saint-Désir;1751;88;1839
28;Normandie;14;3;21;575;Saint-Étienne-la-Thillaye;389;25;414
28;Normandie;14;3;18;576;Val-de-Vie;524;13;537
28;Normandie;14;3;15;578;Saint-Gatien-des-Bois;1352;30;1382
28;Normandie;14;4;01;579;Seulline;1321;24;1345
28;Normandie;14;3;19;582;Saint-Germain-de-Livet;735;24;759
28;Normandie;14;1;23;586;Saint-Germain-du-Pert;164;6;170
28;Normandie;14;2;06;587;Saint-Germain-la-Blanche-Herbe;2298;42;2340
28;Normandie;14;2;13;588;Saint-Germain-Langot;330;3;333
28;Normandie;14;2;22;589;Saint-Germain-le-Vasson;950;9;959
28;Normandie;14;1;23;590;Sainte-Honorine-de-Ducy;133;1;134
28;Normandie;14;1;23;591;Aure sur Mer;732;10;742
28;Normandie;14;2;12;592;Sainte-Honorine-du-Fay;1340;22;1362
28;Normandie;14;3;21;593;Saint-Hymer;688;10;698
28;Normandie;14;3;19;595;Saint-Jean-de-Livet;237;5;242
28;Normandie;14;3;04;598;Saint-Jouin;230;4;234
28;Normandie;14;3;21;601;Saint-Julien-sur-Calonne;168;5;173
28;Normandie;14;2;22;602;Saint-Lambert;270;3;273
28;Normandie;14;2;22;603;Saint-Laurent-de-Condel;508;8;516
28;Normandie;14;1;23;605;Saint-Laurent-sur-Mer;265;8;273
28;Normandie;14;3;04;606;Saint-Léger-Dubosq;211;2;213
28;Normandie;14;4;01;607;Saint-Louet-sur-Seulles;145;1;146
28;Normandie;14;1;02;609;Saint-Loup-Hors;545;9;554
28;Normandie;14;2;03;610;Saint-Manvieu-Norrey;1955;115;2070
28;Normandie;14;1;23;613;Saint-Marcouf;94;1;95
28;Normandie;14;1;23;614;Sainte-Marguerite-d'Elle;779;13;792
28;Normandie;14;4;25;619;Sainte-Marie-Outre-l'Eau;124;2;126
28;Normandie;14;3;21;620;Saint-Martin-aux-Chartrains;422;9;431
28;Normandie;14;3;18;621;Saint-Martin-de-Bienfaite-la-Cressonnière;436;7;443
28;Normandie;14;1;23;622;Saint-Martin-de-Blagny;127;6;133
28;Normandie;14;2;12;623;Saint-Martin-de-Fontenay;2523;19;2542
28;Normandie;14;3;17;625;Saint-Martin-de-la-Lieue;772;14;786
28;Normandie;14;3;19;626;Saint-Martin-de-Mailloc;930;21;951
28;Normandie;14;2;13;627;Saint-Martin-de-Mieux;398;8;406
28;Normandie;14;1;02;630;Saint-Martin-des-Entrées;705;18;723
28;Normandie;14;2;22;635;Saint-Omer;187;2;189
28;Normandie;14;2;24;637;Saint-Ouen-du-Mesnil-Oger;204;3;207
28;Normandie;14;3;19;639;Saint-Ouen-le-Pin;257;9;266
28;Normandie;14;2;24;640;Saint-Pair;237;1;238
28;Normandie;14;1;23;643;Saint-Paul-du-Vernay;831;14;845
28;Normandie;14;3;21;644;Saint-Philbert-des-Champs;654;14;668
28;Normandie;14;3;21;645;Saint-Pierre-Azif;163;9;172
28;Normandie;14;2;13;646;Saint-Pierre-Canivet;439;9;448
28;Normandie;14;3;19;648;Saint-Pierre-des-Ifs;453;19;472
28;Normandie;14;2;13;649;Saint-Pierre-du-Bû;475;10;485
28;Normandie;14;4;01;650;Saint-Pierre-du-Fresne;190;4;194
28;Normandie;14;2;24;651;Saint-Pierre-du-Jonquet;261;2;263
28;Normandie;14;1;23;652;Saint-Pierre-du-Mont;79;2;81
28;Normandie;14;3;18;654;Saint-Pierre-en-Auge;7329;340;7669
28;Normandie;14;2;22;656;Saint-Rémy;988;16;1004
28;Normandie;14;3;24;657;Saint-Samson;313;4;317
28;Normandie;14;4;25;658;Noues de Sienne;4357;97;4454
28;Normandie;14;2;22;659;Saint-Sylvain;1428;24;1452
28;Normandie;14;3;04;660;Saint-Vaast-en-Auge;94;3;97
28;Normandie;14;1;03;661;Saint-Vaast-sur-Seulles;154;1;155
28;Normandie;14;1;02;663;Saint-Vigor-le-Grand;2490;52;2542
28;Normandie;14;1;23;664;Sallen;311;4;315
28;Normandie;14;3;04;665;Sallenelles;294;4;298
28;Normandie;14;2;24;666;Sannerville;1906;27;1933
28;Normandie;14;1;23;667;Saon;222;4;226
28;Normandie;14;1;23;668;Saonnet;318;3;321
28;Normandie;14;2;13;669;Sassy;207;2;209
28;Normandie;14;4;01;672;Val de Drôme;874;15;889
28;Normandie;14;2;22;674;Soignolles;128;3;131
28;Normandie;14;2;12;675;Soliers;2036;25;2061
28;Normandie;14;1;02;676;Sommervieu;993;23;1016
28;Normandie;14;2;13;677;Soulangy;254;6;260
28;Normandie;14;2;13;678;Soumont-Saint-Quentin;562;8;570
28;Normandie;14;1;02;679;Subles;666;21;687
28;Normandie;14;1;02;680;Sully;153;6;159
28;Normandie;14;1;23;681;Surrain;151;4;155
28;Normandie;14;3;21;682;Surville;452;13;465
28;Normandie;14;1;03;684;Tessel;253;3;256
28;Normandie;14;2;03;685;Thaon;1726;33;1759
28;Normandie;14;3;15;687;Le Theil-en-Auge;192;3;195
28;Normandie;14;2;22;689;Le Hom;3629;48;3677
28;Normandie;14;1;03;692;Tilly-sur-Seulles;1744;21;1765
28;Normandie;14;3;21;694;Le Torquesne;510;19;529
28;Normandie;14;3;24;698;Touffréville;391;1;392
28;Normandie;14;3;15;699;Touques;3731;67;3798
28;Normandie;14;1;23;700;Tour-en-Bessin;664;9;673
28;Normandie;14;3;21;701;Tourgéville;782;19;801
28;Normandie;14;1;23;705;Tournières;152;1;153
28;Normandie;14;3;21;706;Tourville-en-Auge;240;11;251
28;Normandie;14;2;05;707;Tourville-sur-Odon;1118;14;1132
28;Normandie;14;4;01;708;Tracy-Bocage;297;7;304
28;Normandie;14;1;02;709;Tracy-sur-Mer;346;7;353
28;Normandie;14;2;13;710;Tréprel;105;0;105
28;Normandie;14;1;23;711;Trévières;917;10;927
28;Normandie;14;2;24;712;Troarn;3459;91;3550
28;Normandie;14;2;22;713;Montillières-sur-Orne;577;11;588
28;Normandie;14;1;23;714;Le Tronquay;785;10;795
28;Normandie;14;3;15;715;Trouville-sur-Mer;4603;89;4692
28;Normandie;14;1;23;716;Trungy;210;3;213
28;Normandie;14;2;22;719;Urville;700;7;707
28;Normandie;14;2;13;720;Ussy;857;28;885
28;Normandie;14;2;12;721;Vacognes-Neuilly;648;9;657
28;Normandie;14;3;19;723;Valsemé;270;4;274
28;Normandie;14;3;04;724;Varaville;997;12;1009
28;Normandie;14;4;10;726;Valdallière;5755;117;5872
28;Normandie;14;1;02;728;Vaucelles;563;7;570
28;Normandie;14;3;21;731;Vauville;188;13;201
28;Normandie;14;1;02;732;Vaux-sur-Aure;307;11;318
28;Normandie;14;1;02;733;Vaux-sur-Seulles;312;9;321
28;Normandie;14;1;03;734;Vendes;333;8;341
28;Normandie;14;2;18;735;Vendeuvre;800;11;811
28;Normandie;14;2;13;737;Versainville;500;8;508
28;Normandie;14;2;05;738;Verson;3636;54;3690
28;Normandie;14;1;11;739;Ver-sur-Mer;1645;36;1681
28;Normandie;14;3;18;740;La Vespière-Friardel;1181;18;1199
28;Normandie;14;2;22;741;Le Vey;121;3;124
28;Normandie;14;2;13;742;Vicques;72;0;72
28;Normandie;14;3;19;743;Victot-Pontfol;88;3;91
28;Normandie;14;1;02;744;Vienne-en-Bessin;299;4;303
28;Normandie;14;1;23;745;Vierville-sur-Mer;230;4;234
28;Normandie;14;2;12;747;Vieux;678;8;686
28;Normandie;14;3;21;748;Vieux-Bourg;74;1;75
28;Normandie;14;2;13;751;Vignats;295;9;304
28;Normandie;14;4;01;752;Villers-Bocage;3160;37;3197
28;Normandie;14;2;13;753;Villers-Canivet;740;22;762
28;Normandie;14;3;21;754;Villers-sur-Mer;2543;58;2601
28;Normandie;14;3;15;755;Villerville;593;13;606
28;Normandie;14;4;10;756;La Villette;231;3;234
28;Normandie;14;2;06;758;Villons-les-Buissons;777;25;802
28;Normandie;14;2;13;759;Villy-lez-Falaise;269;10;279
28;Normandie;14;4;01;760;Villy-Bocage;742;6;748
28;Normandie;14;2;24;761;Vimont;817;15;832
28;Normandie;14;4;25;762;Vire Normandie;16590;891;17481
28;Normandie;14;2;13;764;Pont-d'Ouilly;975;16;991
84;Auvergne-Rhône-Alpes;15;3;07;001;Allanche;799;9;808
84;Auvergne-Rhône-Alpes;15;3;09;002;Alleuze;223;4;227
84;Auvergne-Rhône-Alpes;15;2;05;003;Ally;599;12;611
84;Auvergne-Rhône-Alpes;15;3;11;004;Andelat;472;9;481
84;Auvergne-Rhône-Alpes;15;3;09;005;Anglards-de-Saint-Flour;350;16;366
84;Auvergne-Rhône-Alpes;15;2;05;006;Anglards-de-Salers;731;28;759
84;Auvergne-Rhône-Alpes;15;3;09;007;Anterrieux;121;7;128
84;Auvergne-Rhône-Alpes;15;2;15;008;Antignac;285;1;286
84;Auvergne-Rhône-Alpes;15;2;10;009;Apchon;186;6;192
84;Auvergne-Rhône-Alpes;15;2;15;010;Arches;190;3;193
84;Auvergne-Rhône-Alpes;15;1;13;011;Arnac;182;3;185
84;Auvergne-Rhône-Alpes;15;1;01;012;Arpajon-sur-Cère;6279;192;6471
84;Auvergne-Rhône-Alpes;15;3;11;013;Auriac-l'Église;147;0;147
84;Auvergne-Rhône-Alpes;15;1;98;014;Aurillac;25593;1283;26876
84;Auvergne-Rhône-Alpes;15;2;10;015;Auzers;167;4;171
84;Auvergne-Rhône-Alpes;15;1;13;016;Ayrens;629;14;643
84;Auvergne-Rhône-Alpes;15;1;14;017;Badailhac;145;6;151
84;Auvergne-Rhône-Alpes;15;2;05;018;Barriac-les-Bosquets;132;1;133
84;Auvergne-Rhône-Alpes;15;2;15;019;Bassignac;235;4;239
84;Auvergne-Rhône-Alpes;15;2;15;020;Beaulieu;97;4;101
84;Auvergne-Rhône-Alpes;15;1;06;021;Boisset;634;16;650
84;Auvergne-Rhône-Alpes;15;3;11;022;Bonnac;163;6;169
84;Auvergne-Rhône-Alpes;15;2;05;024;Brageac;76;0;76
84;Auvergne-Rhône-Alpes;15;3;07;025;Albepierre-Bredons;240;7;247
84;Auvergne-Rhône-Alpes;15;3;12;026;Brezons;183;1;184
84;Auvergne-Rhône-Alpes;15;1;06;027;Puycapel;745;14;759
84;Auvergne-Rhône-Alpes;15;1;14;028;Carlat;356;9;365
84;Auvergne-Rhône-Alpes;15;1;01;029;Cassaniouze;507;16;523
84;Auvergne-Rhône-Alpes;15;1;13;030;Cayrols;294;7;301
84;Auvergne-Rhône-Alpes;15;3;09;032;Celoux;60;3;63
84;Auvergne-Rhône-Alpes;15;3;12;033;Cézens;215;4;219
84;Auvergne-Rhône-Alpes;15;3;09;034;Chaliers;145;6;151
84;Auvergne-Rhône-Alpes;15;2;05;036;Chalvignac;470;8;478
84;Auvergne-Rhône-Alpes;15;2;15;037;Champagnac;1056;24;1080
84;Auvergne-Rhône-Alpes;15;2;15;038;Champs-sur-Tarentaine-Marchal;1030;25;1055
84;Auvergne-Rhône-Alpes;15;3;10;040;Chanterelle;98;7;105
84;Auvergne-Rhône-Alpes;15;3;07;041;La Chapelle-d'Alagnon;252;5;257
84;Auvergne-Rhône-Alpes;15;3;11;042;La Chapelle-Laurent;254;4;258
84;Auvergne-Rhône-Alpes;15;3;07;043;Charmensac;87;2;89
84;Auvergne-Rhône-Alpes;15;3;09;045;Chaudes-Aigues;841;11;852
84;Auvergne-Rhône-Alpes;15;2;05;046;Chaussenac;218;3;221
84;Auvergne-Rhône-Alpes;15;3;09;048;Chazelles;31;1;32
84;Auvergne-Rhône-Alpes;15;3;07;049;Cheylade;221;5;226
84;Auvergne-Rhône-Alpes;15;3;07;050;Le Claux;170;2;172
84;Auvergne-Rhône-Alpes;15;3;09;051;Clavières;209;5;214
84;Auvergne-Rhône-Alpes;15;2;10;052;Collandres;156;12;168
84;Auvergne-Rhône-Alpes;15;3;11;053;Coltines;439;10;449
84;Auvergne-Rhône-Alpes;15;3;10;054;Condat;989;24;1013
84;Auvergne-Rhône-Alpes;15;3;11;055;Coren;442;12;454
84;Auvergne-Rhône-Alpes;15;1;08;056;Crandelles;856;20;876
84;Auvergne-Rhône-Alpes;15;1;13;057;Cros-de-Montvert;189;4;193
84;Auvergne-Rhône-Alpes;15;1;14;058;Cros-de-Ronesque;147;0;147
84;Auvergne-Rhône-Alpes;15;3;12;059;Cussac;121;7;128
84;Auvergne-Rhône-Alpes;15;3;09;060;Deux-Verges;51;1;52
84;Auvergne-Rhône-Alpes;15;3;07;061;Dienne;272;4;276
84;Auvergne-Rhône-Alpes;15;2;05;063;Drugeac;332;14;346
84;Auvergne-Rhône-Alpes;15;2;05;064;Escorailles;83;1;84
84;Auvergne-Rhône-Alpes;15;3;09;065;Espinasse;79;1;80
84;Auvergne-Rhône-Alpes;15;2;10;066;Le Falgoux;117;2;119
84;Auvergne-Rhône-Alpes;15;2;05;067;Le Fau;28;1;29
84;Auvergne-Rhône-Alpes;15;3;11;069;Ferrières-Saint-Mary;248;2;250
84;Auvergne-Rhône-Alpes;15;2;05;070;Fontanges;200;3;203
84;Auvergne-Rhône-Alpes;15;1;08;072;Freix-Anglards;222;6;228
84;Auvergne-Rhône-Alpes;15;3;09;073;Fridefont;92;2;94
84;Auvergne-Rhône-Alpes;15;1;14;074;Giou-de-Mamou;763;21;784
84;Auvergne-Rhône-Alpes;15;1;08;075;Girgols;74;4;78
84;Auvergne-Rhône-Alpes;15;1;13;076;Glénat;171;4;175
84;Auvergne-Rhône-Alpes;15;3;12;077;Gourdièges;61;0;61
84;Auvergne-Rhône-Alpes;15;3;09;078;Jabrun;155;2;157
84;Auvergne-Rhône-Alpes;15;2;15;079;Jaleyrac;372;9;381
84;Auvergne-Rhône-Alpes;15;3;07;080;Joursac;147;4;151
84;Auvergne-Rhône-Alpes;15;1;14;081;Jou-sous-Monjou;98;2;100
84;Auvergne-Rhône-Alpes;15;1;01;082;Junhac;297;11;308
84;Auvergne-Rhône-Alpes;15;1;08;083;Jussac;2022;67;2089
84;Auvergne-Rhône-Alpes;15;1;01;084;Labesserette;291;9;300
84;Auvergne-Rhône-Alpes;15;1;14;085;Labrousse;496;12;508
84;Auvergne-Rhône-Alpes;15;3;12;086;Lacapelle-Barrès;58;2;60
84;Auvergne-Rhône-Alpes;15;1;01;087;Lacapelle-del-Fraisse;360;10;370
84;Auvergne-Rhône-Alpes;15;1;13;088;Lacapelle-Viescamp;512;15;527
84;Auvergne-Rhône-Alpes;15;1;01;089;Ladinhac;449;8;457
84;Auvergne-Rhône-Alpes;15;1;01;090;Lafeuillade-en-Vézie;591;15;606
84;Auvergne-Rhône-Alpes;15;3;07;091;Landeyrat;90;5;95
84;Auvergne-Rhône-Alpes;15;2;15;092;Lanobre;1405;41;1446
84;Auvergne-Rhône-Alpes;15;1;01;093;Lapeyrugue;99;3;102
84;Auvergne-Rhône-Alpes;15;1;13;094;Laroquebrou;829;16;845
84;Auvergne-Rhône-Alpes;15;1;08;095;Laroquevieille;355;3;358
84;Auvergne-Rhône-Alpes;15;1;14;096;Lascelle;286;7;293
84;Auvergne-Rhône-Alpes;15;3;11;097;Lastic;111;5;116
84;Auvergne-Rhône-Alpes;15;3;11;098;Laurie;93;0;93
84;Auvergne-Rhône-Alpes;15;3;07;100;Laveissenet;131;2;133
84;Auvergne-Rhône-Alpes;15;3;07;101;Laveissière;517;14;531
84;Auvergne-Rhône-Alpes;15;3;07;102;Lavigerie;107;0;107
84;Auvergne-Rhône-Alpes;15;1;01;103;Leucamp;237;6;243
84;Auvergne-Rhône-Alpes;15;1;06;104;Leynhac;345;9;354
84;Auvergne-Rhône-Alpes;15;3;11;105;Leyvaux;35;3;38
84;Auvergne-Rhône-Alpes;15;3;09;106;Lieutadès;156;2;158
84;Auvergne-Rhône-Alpes;15;3;09;107;Lorcières;171;4;175
84;Auvergne-Rhône-Alpes;15;3;09;108;Val d'Arcomie;990;23;1013
84;Auvergne-Rhône-Alpes;15;3;10;110;Lugarde;130;6;136
84;Auvergne-Rhône-Alpes;15;2;15;111;Madic;208;7;215
84;Auvergne-Rhône-Alpes;15;3;12;112;Malbo;92;4;96
84;Auvergne-Rhône-Alpes;15;1;14;113;Mandailles-Saint-Julien;183;4;187
84;Auvergne-Rhône-Alpes;15;3;10;114;Marcenat;517;7;524
84;Auvergne-Rhône-Alpes;15;3;10;116;Marchastel;154;11;165
84;Auvergne-Rhône-Alpes;15;1;06;117;Marcolès;593;68;661
84;Auvergne-Rhône-Alpes;15;1;08;118;Marmanhac;726;31;757
84;Auvergne-Rhône-Alpes;15;3;11;119;Massiac;1797;66;1863
84;Auvergne-Rhône-Alpes;15;2;05;120;Mauriac;3498;218;3716
84;Auvergne-Rhône-Alpes;15;3;09;121;Maurines;108;1;109
84;Auvergne-Rhône-Alpes;15;1;06;122;Maurs;2111;60;2171
84;Auvergne-Rhône-Alpes;15;2;10;123;Méallet;164;2;166
84;Auvergne-Rhône-Alpes;15;2;10;124;Menet;532;23;555
84;Auvergne-Rhône-Alpes;15;3;11;125;Mentières;128;3;131
84;Auvergne-Rhône-Alpes;15;3;11;126;Molèdes;81;2;83
84;Auvergne-Rhône-Alpes;15;3;11;127;Molompize;281;3;284
84;Auvergne-Rhône-Alpes;15;2;15;128;La Monselie;120;3;123
84;Auvergne-Rhône-Alpes;15;3;10;129;Montboudif;174;6;180
84;Auvergne-Rhône-Alpes;15;3;11;130;Montchamp;140;4;144
84;Auvergne-Rhône-Alpes;15;2;15;131;Le Monteil;286;12;298
84;Auvergne-Rhône-Alpes;15;3;10;132;Montgreleix;45;0;45
84;Auvergne-Rhône-Alpes;15;1;06;133;Montmurat;135;1;136
84;Auvergne-Rhône-Alpes;15;1;01;134;Montsalvy;815;12;827
84;Auvergne-Rhône-Alpes;15;1;13;135;Montvert;115;6;121
84;Auvergne-Rhône-Alpes;15;2;10;137;Moussages;267;7;274
84;Auvergne-Rhône-Alpes;15;3;07;138;Murat;1845;99;1944
84;Auvergne-Rhône-Alpes;15;3;12;139;Narnhac;68;0;68
84;Auvergne-Rhône-Alpes;15;1;08;140;Naucelles;2113;58;2171
84;Auvergne-Rhône-Alpes;15;3;07;141;Neussargues en Pinatelle;1804;30;1834
84;Auvergne-Rhône-Alpes;15;3;09;142;Neuvéglise-sur-Truyère;1735;40;1775
84;Auvergne-Rhône-Alpes;15;1;13;143;Nieudan;102;1;103
84;Auvergne-Rhône-Alpes;15;1;13;144;Omps;330;10;340
84;Auvergne-Rhône-Alpes;15;1;14;146;Pailherols;126;5;131
84;Auvergne-Rhône-Alpes;15;1;13;147;Parlan;450;9;459
84;Auvergne-Rhône-Alpes;15;3;12;148;Paulhac;432;11;443
84;Auvergne-Rhône-Alpes;15;3;12;149;Paulhenc;257;3;260
84;Auvergne-Rhône-Alpes;15;3;07;151;Peyrusse;151;0;151
84;Auvergne-Rhône-Alpes;15;3;12;152;Pierrefort;898;18;916
84;Auvergne-Rhône-Alpes;15;2;05;153;Pleaux;1463;36;1499
84;Auvergne-Rhône-Alpes;15;1;14;154;Polminhac;1188;24;1212
84;Auvergne-Rhône-Alpes;15;3;07;155;Pradiers;87;2;89
84;Auvergne-Rhône-Alpes;15;1;01;156;Prunet;685;15;700
84;Auvergne-Rhône-Alpes;15;1;06;157;Quézac;351;43;394
84;Auvergne-Rhône-Alpes;15;3;09;158;Rageade;103;2;105
84;Auvergne-Rhône-Alpes;15;1;14;159;Raulhac;269;8;277
84;Auvergne-Rhône-Alpes;15;1;08;160;Reilhac;1094;22;1116
84;Auvergne-Rhône-Alpes;15;3;11;161;Rézentières;108;2;110
84;Auvergne-Rhône-Alpes;15;2;10;162;Riom-ès-Montagnes;2479;62;2541
84;Auvergne-Rhône-Alpes;15;1;06;163;Roannes-Saint-Mary;1098;31;1129
84;Auvergne-Rhône-Alpes;15;3;11;164;Roffiac;627;18;645
84;Auvergne-Rhône-Alpes;15;1;13;165;Rouffiac;203;3;206
84;Auvergne-Rhône-Alpes;15;1;13;166;Roumégoux;314;10;324
84;Auvergne-Rhône-Alpes;15;1;06;167;Rouziers;117;8;125
84;Auvergne-Rhône-Alpes;15;3;09;168;Ruynes-en-Margeride;712;25;737
84;Auvergne-Rhône-Alpes;15;2;15;169;Saignes;820;16;836
84;Auvergne-Rhône-Alpes;15;3;10;170;Saint-Amandin;231;4;235
84;Auvergne-Rhône-Alpes;15;1;06;172;Saint-Antoine;93;1;94
84;Auvergne-Rhône-Alpes;15;3;10;173;Saint-Bonnet-de-Condat;115;5;120
84;Auvergne-Rhône-Alpes;15;2;05;174;Saint-Bonnet-de-Salers;271;6;277
84;Auvergne-Rhône-Alpes;15;1;08;175;Saint-Cernin;1070;27;1097
84;Auvergne-Rhône-Alpes;15;2;08;176;Saint-Chamant;242;9;251
84;Auvergne-Rhône-Alpes;15;1;14;178;Saint-Cirgues-de-Jordanne;142;7;149
84;Auvergne-Rhône-Alpes;15;1;08;179;Saint-Cirgues-de-Malbert;249;4;253
84;Auvergne-Rhône-Alpes;15;1;14;180;Saint-Clément;75;3;78
84;Auvergne-Rhône-Alpes;15;1;06;181;Saint-Constant-Fournoulès;577;11;588
84;Auvergne-Rhône-Alpes;15;1;13;182;Saint-Étienne-Cantalès;133;3;136
84;Auvergne-Rhône-Alpes;15;1;14;183;Saint-Étienne-de-Carlat;135;0;135
84;Auvergne-Rhône-Alpes;15;1;06;184;Saint-Étienne-de-Maurs;785;19;804
84;Auvergne-Rhône-Alpes;15;2;10;185;Saint-Étienne-de-Chomeil;243;11;254
84;Auvergne-Rhône-Alpes;15;2;05;186;Sainte-Eulalie;229;3;232
84;Auvergne-Rhône-Alpes;15;3;99;187;Saint-Flour;6458;542;7000
84;Auvergne-Rhône-Alpes;15;3;09;188;Saint-Georges;1198;31;1229
84;Auvergne-Rhône-Alpes;15;1;13;189;Saint-Gérons;222;7;229
84;Auvergne-Rhône-Alpes;15;2;10;190;Saint-Hippolyte;104;3;107
84;Auvergne-Rhône-Alpes;15;1;08;191;Saint-Illide;644;9;653
84;Auvergne-Rhône-Alpes;15;1;14;192;Saint-Jacques-des-Blats;293;4;297
84;Auvergne-Rhône-Alpes;15;1;06;194;Saint-Julien-de-Toursac;105;6;111
84;Auvergne-Rhône-Alpes;15;1;06;196;Saint-Mamet-la-Salvetat;1548;53;1601
84;Auvergne-Rhône-Alpes;15;3;12;198;Sainte-Marie;108;1;109
84;Auvergne-Rhône-Alpes;15;3;09;199;Saint-Martial;75;0;75
84;Auvergne-Rhône-Alpes;15;2;05;200;Saint-Martin-Cantalès;146;3;149
84;Auvergne-Rhône-Alpes;15;3;12;201;Saint-Martin-sous-Vigouroux;226;3;229
84;Auvergne-Rhône-Alpes;15;2;05;202;Saint-Martin-Valmeroux;717;17;734
84;Auvergne-Rhône-Alpes;15;3;11;203;Saint-Mary-le-Plain;174;3;177
84;Auvergne-Rhône-Alpes;15;1;13;204;Saint-Paul-des-Landes;1539;42;1581
84;Auvergne-Rhône-Alpes;15;2;05;205;Saint-Paul-de-Salers;105;5;110
84;Auvergne-Rhône-Alpes;15;2;15;206;Saint-Pierre;142;2;144
84;Auvergne-Rhône-Alpes;15;3;11;207;Saint-Poncy;362;12;374
84;Auvergne-Rhône-Alpes;15;2;08;208;Saint-Projet-de-Salers;135;4;139
84;Auvergne-Rhône-Alpes;15;3;09;209;Saint-Rémy-de-Chaudes-Aigues;124;5;129
84;Auvergne-Rhône-Alpes;15;1;13;211;Saint-Santin-Cantalès;298;5;303
84;Auvergne-Rhône-Alpes;15;1;06;212;Saint-Santin-de-Maurs;359;15;374
84;Auvergne-Rhône-Alpes;15;3;07;213;Saint-Saturnin;203;4;207
84;Auvergne-Rhône-Alpes;15;1;13;214;Saint-Saury;178;5;183
84;Auvergne-Rhône-Alpes;15;1;14;215;Saint-Simon;1121;37;1158
84;Auvergne-Rhône-Alpes;15;3;09;216;Saint-Urcize;402;14;416
84;Auvergne-Rhône-Alpes;15;1;13;217;Saint-Victor;106;3;109
84;Auvergne-Rhône-Alpes;15;2;10;218;Saint-Vincent-de-Salers;68;2;70
84;Auvergne-Rhône-Alpes;15;2;05;219;Salers;325;5;330
84;Auvergne-Rhône-Alpes;15;2;05;220;Salins;145;2;147
84;Auvergne-Rhône-Alpes;15;1;06;221;Sansac-de-Marmiesse;1368;34;1402
84;Auvergne-Rhône-Alpes;15;1;01;222;Sansac-Veinazès;217;10;227
84;Auvergne-Rhône-Alpes;15;2;15;223;Sauvat;214;6;220
84;Auvergne-Rhône-Alpes;15;1;13;224;La Ségalassière;132;13;145
84;Auvergne-Rhône-Alpes;15;3;07;225;Ségur-les-Villas;212;4;216
84;Auvergne-Rhône-Alpes;15;1;01;226;Sénezergues;204;4;208
84;Auvergne-Rhône-Alpes;15;1;13;228;Siran;462;10;472
84;Auvergne-Rhône-Alpes;15;3;09;229;Soulages;81;2;83
84;Auvergne-Rhône-Alpes;15;2;15;230;Sourniac;197;9;206
84;Auvergne-Rhône-Alpes;15;3;11;231;Talizat;596;20;616
84;Auvergne-Rhône-Alpes;15;3;12;232;Tanavelle;228;7;235
84;Auvergne-Rhône-Alpes;15;1;08;233;Teissières-de-Cornet;301;5;306
84;Auvergne-Rhône-Alpes;15;1;14;234;Teissières-lès-Bouliès;330;6;336
84;Auvergne-Rhône-Alpes;15;3;12;235;Les Ternes;573;23;596
84;Auvergne-Rhône-Alpes;15;1;14;236;Thiézac;602;14;616
84;Auvergne-Rhône-Alpes;15;3;11;237;Tiviers;172;6;178
84;Auvergne-Rhône-Alpes;15;1;08;238;Tournemire;128;3;131
84;Auvergne-Rhône-Alpes;15;2;15;240;Trémouille;173;7;180
84;Auvergne-Rhône-Alpes;15;3;09;241;La Trinitat;48;3;51
84;Auvergne-Rhône-Alpes;15;1;06;242;Le Trioulou;101;3;104
84;Auvergne-Rhône-Alpes;15;2;10;243;Trizac;503;9;512
84;Auvergne-Rhône-Alpes;15;3;07;244;Ussel;473;10;483
84;Auvergne-Rhône-Alpes;15;3;09;245;Vabres;252;4;256
84;Auvergne-Rhône-Alpes;15;2;10;246;Valette;235;2;237
84;Auvergne-Rhône-Alpes;15;3;11;247;Valjouze;23;0;23
84;Auvergne-Rhône-Alpes;15;3;12;248;Valuéjols;564;12;576
84;Auvergne-Rhône-Alpes;15;2;10;249;Le Vaulmier;64;2;66
84;Auvergne-Rhône-Alpes;15;2;15;250;Vebret;509;18;527
84;Auvergne-Rhône-Alpes;15;3;09;251;Védrines-Saint-Loup;141;6;147
84;Auvergne-Rhône-Alpes;15;1;14;252;Velzic;413;18;431
84;Auvergne-Rhône-Alpes;15;3;07;253;Vernols;65;1;66
84;Auvergne-Rhône-Alpes;15;2;15;254;Veyrières;119;2;121
84;Auvergne-Rhône-Alpes;15;1;14;255;Vézac;1249;35;1284
84;Auvergne-Rhône-Alpes;15;3;07;256;Vèze;52;5;57
84;Auvergne-Rhône-Alpes;15;1;14;257;Vezels-Roussy;125;4;129
84;Auvergne-Rhône-Alpes;15;1;14;258;Vic-sur-Cère;1838;36;1874
84;Auvergne-Rhône-Alpes;15;3;11;259;Vieillespesse;244;3;247
84;Auvergne-Rhône-Alpes;15;1;01;260;Vieillevie;108;4;112
84;Auvergne-Rhône-Alpes;15;2;05;261;Le Vigean;825;21;846
84;Auvergne-Rhône-Alpes;15;3;12;262;Villedieu;562;11;573
84;Auvergne-Rhône-Alpes;15;3;07;263;Virargues;124;5;129
84;Auvergne-Rhône-Alpes;15;1;06;264;Vitrac;269;6;275
84;Auvergne-Rhône-Alpes;15;2;15;265;Ydes;1644;28;1672
84;Auvergne-Rhône-Alpes;15;1;14;266;Yolet;551;10;561
84;Auvergne-Rhône-Alpes;15;1;02;267;Ytrac;4335;106;4441
84;Auvergne-Rhône-Alpes;15;1;13;268;Le Rouget-Pers;1233;26;1259
84;Auvergne-Rhône-Alpes;15;1;08;269;Besse;130;3;133
75;Nouvelle-Aquitaine;16;3;10;001;Abzac;503;1;504
75;Nouvelle-Aquitaine;16;3;08;002;Les Adjots;523;8;531
75;Nouvelle-Aquitaine;16;1;19;003;Agris;857;10;867
75;Nouvelle-Aquitaine;16;3;08;005;Aigre;1579;39;1618
75;Nouvelle-Aquitaine;16;3;06;007;Alloue;463;11;474
75;Nouvelle-Aquitaine;16;3;05;008;Ambérac;310;2;312
75;Nouvelle-Aquitaine;16;3;10;009;Ambernac;380;6;386
75;Nouvelle-Aquitaine;16;2;07;010;Ambleville;167;4;171
75;Nouvelle-Aquitaine;16;3;05;011;Anais;568;21;589
75;Nouvelle-Aquitaine;16;2;07;012;Angeac-Champagne;503;9;512
75;Nouvelle-Aquitaine;16;2;07;013;Angeac-Charente;319;8;327
75;Nouvelle-Aquitaine;16;2;09;014;Angeduc;128;0;128
75;Nouvelle-Aquitaine;16;1;98;015;Angoulême;41603;1687;43290
75;Nouvelle-Aquitaine;16;3;10;016;Ansac-sur-Vienne;827;23;850
75;Nouvelle-Aquitaine;16;2;12;018;Ars;709;18;727
75;Nouvelle-Aquitaine;16;1;18;019;Asnières-sur-Nouère;1248;23;1271
75;Nouvelle-Aquitaine;16;1;17;020;Aubeterre-sur-Dronne;347;4;351
75;Nouvelle-Aquitaine;16;3;05;023;Aunac-sur-Charente;590;11;601
75;Nouvelle-Aquitaine;16;3;05;024;Aussac-Vadalle;515;9;524
75;Nouvelle-Aquitaine;16;2;09;025;Baignes-Sainte-Radegonde;1237;31;1268
75;Nouvelle-Aquitaine;16;1;14;026;Balzac;1359;27;1386
75;Nouvelle-Aquitaine;16;3;08;027;Barbezières;126;3;129
75;Nouvelle-Aquitaine;16;2;09;028;Barbezieux-Saint-Hilaire;4714;177;4891
75;Nouvelle-Aquitaine;16;1;17;029;Bardenac;226;5;231
75;Nouvelle-Aquitaine;16;2;09;030;Barret;1052;22;1074
75;Nouvelle-Aquitaine;16;3;08;031;Barro;410;11;421
75;Nouvelle-Aquitaine;16;2;15;032;Bassac;517;7;524
75;Nouvelle-Aquitaine;16;1;17;034;Bazac;144;2;146
75;Nouvelle-Aquitaine;16;3;06;035;Beaulieu-sur-Sonnette;199;5;204
75;Nouvelle-Aquitaine;16;2;09;036;Bécheresse;291;9;300
75;Nouvelle-Aquitaine;16;1;17;037;Bellon;141;5;146
75;Nouvelle-Aquitaine;16;3;06;038;Benest;310;8;318
75;Nouvelle-Aquitaine;16;3;08;039;Bernac;474;12;486
75;Nouvelle-Aquitaine;16;2;09;040;Berneuil;305;6;311
75;Nouvelle-Aquitaine;16;1;17;041;Bessac;111;1;112
75;Nouvelle-Aquitaine;16;3;08;042;Bessé;110;7;117
75;Nouvelle-Aquitaine;16;3;08;044;Bioussac;215;7;222
75;Nouvelle-Aquitaine;16;2;07;045;Birac;366;6;372
75;Nouvelle-Aquitaine;16;2;09;046;Coteaux-du-Blanzacais;1003;12;1015
75;Nouvelle-Aquitaine;16;1;17;047;Blanzaguet-Saint-Cybard;295;6;301
75;Nouvelle-Aquitaine;16;2;09;048;Boisbreteau;129;0;129
75;Nouvelle-Aquitaine;16;1;17;049;Bonnes;375;8;383
75;Nouvelle-Aquitaine;16;2;07;050;Bonneuil;251;8;259
75;Nouvelle-Aquitaine;16;1;17;052;Bors (Canton de Tude-et-Lavalette);246;3;249
75;Nouvelle-Aquitaine;16;2;09;053;Bors (Canton de Charente-Sud);119;1;120
75;Nouvelle-Aquitaine;16;3;06;054;Le Bouchage;175;1;176
75;Nouvelle-Aquitaine;16;1;04;055;Bouëx;892;11;903
75;Nouvelle-Aquitaine;16;2;15;056;Bourg-Charente;891;18;909
75;Nouvelle-Aquitaine;16;2;07;057;Bouteville;320;6;326
75;Nouvelle-Aquitaine;16;2;11;058;Boutiers-Saint-Trojan;1410;51;1461
75;Nouvelle-Aquitaine;16;3;08;059;Brettes;176;5;181
75;Nouvelle-Aquitaine;16;2;11;060;Bréville;454;12;466
75;Nouvelle-Aquitaine;16;1;16;061;Brie;4233;82;4315
75;Nouvelle-Aquitaine;16;2;09;062;Brie-sous-Barbezieux;137;1;138
75;Nouvelle-Aquitaine;16;1;17;063;Brie-sous-Chalais;159;0;159
75;Nouvelle-Aquitaine;16;3;10;064;Brigueuil;1115;17;1132
75;Nouvelle-Aquitaine;16;3;10;065;Brillac;621;6;627
75;Nouvelle-Aquitaine;16;2;09;066;Brossac;464;8;472
75;Nouvelle-Aquitaine;16;1;19;067;Bunzac;465;10;475
75;Nouvelle-Aquitaine;16;3;05;068;Cellefrouin;565;6;571
75;Nouvelle-Aquitaine;16;3;05;069;Cellettes;388;3;391
75;Nouvelle-Aquitaine;16;3;10;070;Chabanais;1568;32;1600
75;Nouvelle-Aquitaine;16;3;10;071;Chabrac;591;16;607
75;Nouvelle-Aquitaine;16;1;17;072;Chadurie;511;10;521
75;Nouvelle-Aquitaine;16;1;17;073;Chalais;1776;31;1807
75;Nouvelle-Aquitaine;16;2;09;074;Challignac;333;8;341
75;Nouvelle-Aquitaine;16;2;09;075;Champagne-Vigny;244;3;247
75;Nouvelle-Aquitaine;16;3;06;076;Champagne-Mouton;878;9;887
75;Nouvelle-Aquitaine;16;2;18;077;Champmillon;491;9;500
75;Nouvelle-Aquitaine;16;1;14;078;Champniers;5149;118;5267
75;Nouvelle-Aquitaine;16;2;09;079;Chantillac;347;3;350
75;Nouvelle-Aquitaine;16;3;05;081;La Chapelle;215;5;220
75;Nouvelle-Aquitaine;16;1;17;082;Boisné-La Tude;673;12;685
75;Nouvelle-Aquitaine;16;3;08;083;Charmé;340;6;346
75;Nouvelle-Aquitaine;16;1;19;084;Charras;334;3;337
75;Nouvelle-Aquitaine;16;3;06;085;Chasseneuil-sur-Bonnieure;3083;272;3355
75;Nouvelle-Aquitaine;16;3;10;086;Chassenon;864;17;881
75;Nouvelle-Aquitaine;16;3;06;087;Chassiecq;142;2;144
75;Nouvelle-Aquitaine;16;2;15;088;Chassors;1105;38;1143
75;Nouvelle-Aquitaine;16;2;12;089;Châteaubernard;3746;66;3812
75;Nouvelle-Aquitaine;16;2;07;090;Châteauneuf-sur-Charente;3537;64;3601
75;Nouvelle-Aquitaine;16;1;17;091;Châtignac;172;2;174
75;Nouvelle-Aquitaine;16;1;19;093;Chazelles;1587;26;1613
75;Nouvelle-Aquitaine;16;3;05;095;Chenon;130;4;134
75;Nouvelle-Aquitaine;16;3;06;096;Cherves-Châtelars;418;3;421
75;Nouvelle-Aquitaine;16;2;11;097;Cherves-Richemont;2299;100;2399
75;Nouvelle-Aquitaine;16;3;08;098;La Chèvrerie;141;2;143
75;Nouvelle-Aquitaine;16;2;09;099;Chillac;221;1;222
75;Nouvelle-Aquitaine;16;3;10;100;Chirac;767;14;781
75;Nouvelle-Aquitaine;16;1;04;101;Claix;1052;18;1070
75;Nouvelle-Aquitaine;16;2;99;102;Cognac;18670;434;19104
75;Nouvelle-Aquitaine;16;1;17;103;Combiers;123;5;128
75;Nouvelle-Aquitaine;16;3;08;104;Condac;470;9;479
75;Nouvelle-Aquitaine;16;2;09;105;Condéon;620;5;625
75;Nouvelle-Aquitaine;16;3;10;106;Confolens;2712;154;2866
75;Nouvelle-Aquitaine;16;1;19;107;Coulgens;534;6;540
75;Nouvelle-Aquitaine;16;3;05;108;Coulonges;131;1;132
75;Nouvelle-Aquitaine;16;2;18;109;Courbillac;763;8;771
75;Nouvelle-Aquitaine;16;3;08;110;Courcôme;777;21;798
75;Nouvelle-Aquitaine;16;1;17;111;Courgeac;178;3;181
75;Nouvelle-Aquitaine;16;1;17;112;Courlac;57;2;59
75;Nouvelle-Aquitaine;16;1;13;113;La Couronne;7764;260;8024
75;Nouvelle-Aquitaine;16;3;08;114;Couture;165;3;168
75;Nouvelle-Aquitaine;16;2;07;116;Criteuil-la-Magdeleine;390;9;399
75;Nouvelle-Aquitaine;16;1;17;117;Curac;120;3;123
75;Nouvelle-Aquitaine;16;1;17;118;Deviat;138;0;138
75;Nouvelle-Aquitaine;16;1;04;119;Dignac;1355;15;1370
75;Nouvelle-Aquitaine;16;1;04;120;Dirac;1520;21;1541
75;Nouvelle-Aquitaine;16;2;18;121;Douzat;440;13;453
75;Nouvelle-Aquitaine;16;3;08;122;Ébréon;140;4;144
75;Nouvelle-Aquitaine;16;2;18;123;Échallat;488;10;498
75;Nouvelle-Aquitaine;16;1;19;124;Écuras;569;10;579
75;Nouvelle-Aquitaine;16;1;17;125;Édon;263;3;266
75;Nouvelle-Aquitaine;16;3;08;127;Empuré;95;3;98
75;Nouvelle-Aquitaine;16;3;10;128;Épenède;174;6;180
75;Nouvelle-Aquitaine;16;1;17;130;Les Essards;186;7;193
75;Nouvelle-Aquitaine;16;3;10;131;Esse;497;7;504
75;Nouvelle-Aquitaine;16;3;10;132;Étagnac;990;9;999
75;Nouvelle-Aquitaine;16;2;09;133;Étriac;198;3;201
75;Nouvelle-Aquitaine;16;3;10;134;Exideuil-sur-Vienne;1014;27;1041
75;Nouvelle-Aquitaine;16;1;19;135;Eymouthiers;314;4;318
75;Nouvelle-Aquitaine;16;3;08;136;La Faye;572;12;584
75;Nouvelle-Aquitaine;16;1;19;137;Feuillade;312;6;318
75;Nouvelle-Aquitaine;16;1;01;138;Fléac;3818;105;3923
75;Nouvelle-Aquitaine;16;2;15;139;Fleurac;239;2;241
75;Nouvelle-Aquitaine;16;3;05;140;Fontclaireau;438;15;453
75;Nouvelle-Aquitaine;16;3;05;141;Fontenille;321;12;333
75;Nouvelle-Aquitaine;16;3;08;142;La Forêt-de-Tessé;200;4;204
75;Nouvelle-Aquitaine;16;1;17;143;Fouquebrune;704;13;717
75;Nouvelle-Aquitaine;16;3;08;144;Fouqueure;421;6;427
75;Nouvelle-Aquitaine;16;2;15;145;Foussignac;639;19;658
75;Nouvelle-Aquitaine;16;1;04;146;Garat;2108;35;2143
75;Nouvelle-Aquitaine;16;1;17;147;Gardes-le-Pontaroux;264;6;270
75;Nouvelle-Aquitaine;16;2;18;148;Genac-Bignac;1011;14;1025
75;Nouvelle-Aquitaine;16;2;07;150;Gensac-la-Pallue;1594;43;1637
75;Nouvelle-Aquitaine;16;2;07;151;Genté;886;21;907
75;Nouvelle-Aquitaine;16;2;12;152;Gimeux;719;20;739
75;Nouvelle-Aquitaine;16;2;15;153;Mainxe-Gondeville;1168;22;1190
75;Nouvelle-Aquitaine;16;1;14;154;Gond-Pontouvre;6119;115;6234
75;Nouvelle-Aquitaine;16;3;08;155;Les Gours;110;1;111
75;Nouvelle-Aquitaine;16;3;06;157;Le Grand-Madieu;162;3;165
75;Nouvelle-Aquitaine;16;1;19;158;Grassac;308;5;313
75;Nouvelle-Aquitaine;16;2;09;160;Guimps;482;7;489
75;Nouvelle-Aquitaine;16;2;09;161;Guizengeard;165;3;168
75;Nouvelle-Aquitaine;16;1;17;162;Gurat;182;0;182
75;Nouvelle-Aquitaine;16;2;18;163;Hiersac;1145;21;1166
75;Nouvelle-Aquitaine;16;3;10;164;Hiesse;243;2;245
75;Nouvelle-Aquitaine;16;2;15;165;Houlette;367;4;371
75;Nouvelle-Aquitaine;16;1;02;166;L'Isle-d'Espagnac;5626;153;5779
75;Nouvelle-Aquitaine;16;2;15;167;Jarnac;4434;134;4568
75;Nouvelle-Aquitaine;16;1;16;168;Jauldes;813;8;821
75;Nouvelle-Aquitaine;16;2;12;169;Javrezac;563;8;571
75;Nouvelle-Aquitaine;16;1;17;170;Juignac;399;2;401
75;Nouvelle-Aquitaine;16;2;07;171;Juillac-le-Coq;651;13;664
75;Nouvelle-Aquitaine;16;3;05;173;Juillé;180;4;184
75;Nouvelle-Aquitaine;16;2;15;174;Julienne;511;11;522
75;Nouvelle-Aquitaine;16;2;09;175;Val des Vignes;1390;34;1424
75;Nouvelle-Aquitaine;16;2;09;176;Lachaise;305;7;312
75;Nouvelle-Aquitaine;16;2;09;177;Ladiville;118;2;120
75;Nouvelle-Aquitaine;16;2;09;178;Lagarde-sur-le-Né;186;5;191
75;Nouvelle-Aquitaine;16;1;17;180;Laprade;247;6;253
75;Nouvelle-Aquitaine;16;3;10;181;Lessac;523;11;534
75;Nouvelle-Aquitaine;16;3;10;182;Lesterps;453;13;466
75;Nouvelle-Aquitaine;16;3;06;183;Lésignac-Durand;178;4;182
75;Nouvelle-Aquitaine;16;3;05;184;Lichères;87;1;88
75;Nouvelle-Aquitaine;16;3;08;185;Ligné;157;2;159
75;Nouvelle-Aquitaine;16;2;07;186;Lignières-Sonneville;552;17;569
75;Nouvelle-Aquitaine;16;1;18;187;Linars;2092;47;2139
75;Nouvelle-Aquitaine;16;3;06;188;Le Lindois;341;4;345
75;Nouvelle-Aquitaine;16;3;08;189;Londigny;254;6;260
75;Nouvelle-Aquitaine;16;3;08;190;Longré;186;6;192
75;Nouvelle-Aquitaine;16;3;05;191;Lonnes;181;1;182
75;Nouvelle-Aquitaine;16;3;89;192;Terres-de-Haute-Charente;3900;107;4007
75;Nouvelle-Aquitaine;16;2;11;193;Louzac-Saint-André;991;17;1008
75;Nouvelle-Aquitaine;16;3;08;194;Lupsault;104;1;105
75;Nouvelle-Aquitaine;16;3;06;195;Lussac;294;8;302
75;Nouvelle-Aquitaine;16;3;05;196;Luxé;723;9;732
75;Nouvelle-Aquitaine;16;3;08;197;La Magdeleine;110;7;117
75;Nouvelle-Aquitaine;16;1;17;198;Magnac-Lavalette-Villars;445;5;450
75;Nouvelle-Aquitaine;16;1;16;199;Magnac-sur-Touvre;3223;69;3292
75;Nouvelle-Aquitaine;16;3;05;200;Maine-de-Boixe;482;4;486
75;Nouvelle-Aquitaine;16;1;19;203;Mainzac;115;0;115
75;Nouvelle-Aquitaine;16;2;07;204;Bellevigne;1298;35;1333
75;Nouvelle-Aquitaine;16;3;10;205;Manot;540;5;545
75;Nouvelle-Aquitaine;16;3;05;206;Mansle;1692;17;1709
75;Nouvelle-Aquitaine;16;2;18;207;Marcillac-Lanville;492;9;501
75;Nouvelle-Aquitaine;16;2;18;208;Mareuil;398;4;402
75;Nouvelle-Aquitaine;16;1;19;209;Marillac-le-Franc;824;9;833
75;Nouvelle-Aquitaine;16;1;18;210;Marsac;817;10;827
75;Nouvelle-Aquitaine;16;1;19;211;Marthon;561;7;568
75;Nouvelle-Aquitaine;16;3;06;212;Massignac;391;6;397
75;Nouvelle-Aquitaine;16;3;06;213;Mazerolles;295;5;300
75;Nouvelle-Aquitaine;16;1;17;215;Médillac;155;5;160
75;Nouvelle-Aquitaine;16;2;15;216;Mérignac;843;14;857
75;Nouvelle-Aquitaine;16;2;12;217;Merpins;1101;24;1125
75;Nouvelle-Aquitaine;16;2;11;218;Mesnac;409;12;421
75;Nouvelle-Aquitaine;16;2;15;220;Les Métairies;716;15;731
75;Nouvelle-Aquitaine;16;2;18;221;Mons;238;4;242
75;Nouvelle-Aquitaine;16;1;17;222;Montboyer;328;7;335
75;Nouvelle-Aquitaine;16;1;19;223;Montbron;2009;28;2037
75;Nouvelle-Aquitaine;16;2;09;224;Montmérac;714;18;732
75;Nouvelle-Aquitaine;16;3;06;225;Montembœuf;650;31;681
75;Nouvelle-Aquitaine;16;3;05;226;Montignac-Charente;717;9;726
75;Nouvelle-Aquitaine;16;1;17;227;Montignac-le-Coq;139;0;139
75;Nouvelle-Aquitaine;16;3;08;229;Montjean;242;4;246
75;Nouvelle-Aquitaine;16;1;17;230;Montmoreau;2564;100;2664
75;Nouvelle-Aquitaine;16;3;10;231;Montrollet;321;2;323
75;Nouvelle-Aquitaine;16;1;16;232;Mornac;2151;50;2201
75;Nouvelle-Aquitaine;16;2;07;233;Mosnac-Saint-Simeux;1004;17;1021
75;Nouvelle-Aquitaine;16;2;18;234;Moulidars;731;8;739
75;Nouvelle-Aquitaine;16;1;04;236;Mouthiers-sur-Boëme;2397;73;2470
75;Nouvelle-Aquitaine;16;3;05;237;Mouton;223;0;223
75;Nouvelle-Aquitaine;16;3;05;238;Moutonneau;117;0;117
75;Nouvelle-Aquitaine;16;3;06;239;Mouzon;134;2;136
75;Nouvelle-Aquitaine;16;1;17;240;Nabinaud;99;0;99
75;Nouvelle-Aquitaine;16;3;05;241;Nanclars;207;4;211
75;Nouvelle-Aquitaine;16;3;08;242;Nanteuil-en-Vallée;1382;17;1399
75;Nouvelle-Aquitaine;16;2;15;243;Nercillac;1047;21;1068
75;Nouvelle-Aquitaine;16;1;13;244;Nersac;2348;54;2402
75;Nouvelle-Aquitaine;16;3;06;245;Nieuil;932;23;955
75;Nouvelle-Aquitaine;16;1;17;246;Nonac;266;8;274
75;Nouvelle-Aquitaine;16;3;08;248;Oradour;152;1;153
75;Nouvelle-Aquitaine;16;3;10;249;Oradour-Fanais;403;3;406
75;Nouvelle-Aquitaine;16;1;19;250;Orgedeuil;220;2;222
75;Nouvelle-Aquitaine;16;2;09;251;Oriolles;253;6;259
75;Nouvelle-Aquitaine;16;1;17;252;Orival;152;3;155
75;Nouvelle-Aquitaine;16;3;08;253;Paizay-Naudouin-Embourie;362;3;365
75;Nouvelle-Aquitaine;16;1;17;254;Palluaud;221;8;229
75;Nouvelle-Aquitaine;16;3;06;255;Parzac;141;5;146
75;Nouvelle-Aquitaine;16;2;09;256;Passirac;240;11;251
75;Nouvelle-Aquitaine;16;2;09;258;Pérignac;483;9;492
75;Nouvelle-Aquitaine;16;1;17;260;Pillac;271;7;278
75;Nouvelle-Aquitaine;16;3;06;261;Les Pins;467;17;484
75;Nouvelle-Aquitaine;16;1;04;263;Plassac-Rouffiac;400;5;405
75;Nouvelle-Aquitaine;16;3;10;264;Pleuville;323;6;329
75;Nouvelle-Aquitaine;16;1;17;267;Poullignac;89;1;90
75;Nouvelle-Aquitaine;16;3;08;268;Poursac;209;2;211
75;Nouvelle-Aquitaine;16;1;19;269;Pranzac;898;10;908
75;Nouvelle-Aquitaine;16;3;10;270;Pressignac;344;5;349
75;Nouvelle-Aquitaine;16;1;13;271;Puymoyen;2369;146;2515
75;Nouvelle-Aquitaine;16;3;05;272;Puyréaux;543;9;552
75;Nouvelle-Aquitaine;16;3;08;273;Raix;124;6;130
75;Nouvelle-Aquitaine;16;3;08;275;Ranville-Breuillaud;175;2;177
75;Nouvelle-Aquitaine;16;2;09;276;Reignac;761;17;778
75;Nouvelle-Aquitaine;16;2;15;277;Réparsac;595;11;606
75;Nouvelle-Aquitaine;16;1;17;279;Rioux-Martin;225;3;228
75;Nouvelle-Aquitaine;16;1;19;280;Rivières;1996;31;2027
75;Nouvelle-Aquitaine;16;1;19;281;La Rochefoucauld-en-Angoumois;3977;159;4136
75;Nouvelle-Aquitaine;16;1;19;282;La Rochette;534;11;545
75;Nouvelle-Aquitaine;16;1;17;283;Ronsenac;570;7;577
75;Nouvelle-Aquitaine;16;1;17;284;Rouffiac;120;1;121
75;Nouvelle-Aquitaine;16;1;17;285;Rougnac;406;5;411
75;Nouvelle-Aquitaine;16;2;18;286;Rouillac;2964;49;3013
75;Nouvelle-Aquitaine;16;1;04;287;Roullet-Saint-Estèphe;4277;69;4346
75;Nouvelle-Aquitaine;16;3;06;289;Roussines;294;2;296
75;Nouvelle-Aquitaine;16;1;19;290;Rouzède;242;4;246
75;Nouvelle-Aquitaine;16;1;16;291;Ruelle-sur-Touvre;7305;200;7505
75;Nouvelle-Aquitaine;16;3;08;292;Ruffec;3372;150;3522
75;Nouvelle-Aquitaine;16;1;19;293;Saint-Adjutory;492;7;499
75;Nouvelle-Aquitaine;16;3;05;295;Saint-Amant-de-Boixe;1333;24;1357
75;Nouvelle-Aquitaine;16;2;07;297;Graves-Saint-Amant;329;12;341
75;Nouvelle-Aquitaine;16;2;18;298;Saint-Amant-de-Nouère;373;5;378
75;Nouvelle-Aquitaine;16;3;05;300;Val-de-Bonnieure;1308;16;1324
75;Nouvelle-Aquitaine;16;2;09;301;Saint-Aulais-la-Chapelle;229;3;232
75;Nouvelle-Aquitaine;16;1;17;302;Saint-Avit;216;2;218
75;Nouvelle-Aquitaine;16;2;09;303;Saint-Bonnet;406;12;418
75;Nouvelle-Aquitaine;16;2;11;304;Saint-Brice;963;35;998
75;Nouvelle-Aquitaine;16;3;10;306;Saint-Christophe;317;8;325
75;Nouvelle-Aquitaine;16;3;05;307;Saint-Ciers-sur-Bonnieure;333;14;347
75;Nouvelle-Aquitaine;16;3;06;308;Saint-Claud;1053;24;1077
75;Nouvelle-Aquitaine;16;3;06;310;Saint-Coutant;216;2;218
75;Nouvelle-Aquitaine;16;2;18;312;Saint-Cybardeaux;823;13;836
75;Nouvelle-Aquitaine;16;2;09;315;Saint-Félix;107;1;108
75;Nouvelle-Aquitaine;16;2;07;316;Saint-Fort-sur-le-Né;385;6;391
75;Nouvelle-Aquitaine;16;3;08;317;Saint-Fraigne;439;5;444
75;Nouvelle-Aquitaine;16;3;05;318;Saint-Front;366;2;368
75;Nouvelle-Aquitaine;16;2;18;320;Saint-Genis-d'Hiersac;896;17;913
75;Nouvelle-Aquitaine;16;3;08;321;Saint-Georges;46;0;46
75;Nouvelle-Aquitaine;16;1;19;323;Saint-Germain-de-Montbron;471;11;482
75;Nouvelle-Aquitaine;16;3;08;325;Saint-Gourson;132;3;135
75;Nouvelle-Aquitaine;16;3;05;326;Saint-Groux;135;0;135
75;Nouvelle-Aquitaine;16;3;06;329;Saint-Laurent-de-Céris;782;15;797
75;Nouvelle-Aquitaine;16;2;12;330;Saint-Laurent-de-Cognac;826;28;854
75;Nouvelle-Aquitaine;16;1;17;331;Saint-Laurent-des-Combes;89;3;92
75;Nouvelle-Aquitaine;16;1;17;334;Saint-Martial;126;3;129
75;Nouvelle-Aquitaine;16;3;08;335;Saint-Martin-du-Clocher;124;3;127
75;Nouvelle-Aquitaine;16;3;06;336;Saint-Mary;343;3;346
75;Nouvelle-Aquitaine;16;3;10;337;Saint-Maurice-des-Lions;895;30;925
75;Nouvelle-Aquitaine;16;2;09;338;Saint-Médard;319;5;324
75;Nouvelle-Aquitaine;16;2;18;339;Val-d'Auge;802;19;821
75;Nouvelle-Aquitaine;16;2;15;340;Saint-Même-les-Carrières;1032;28;1060
75;Nouvelle-Aquitaine;16;1;13;341;Saint-Michel;3218;39;3257
75;Nouvelle-Aquitaine;16;2;09;342;Saint-Palais-du-Né;299;7;306
75;Nouvelle-Aquitaine;16;2;07;343;Saint-Preuil;296;9;305
75;Nouvelle-Aquitaine;16;3;10;345;Saint-Quentin-sur-Charente;218;2;220
75;Nouvelle-Aquitaine;16;1;17;346;Saint-Quentin-de-Chalais;248;8;256
75;Nouvelle-Aquitaine;16;1;17;347;Saint-Romain;508;12;520
75;Nouvelle-Aquitaine;16;1;18;348;Saint-Saturnin;1296;32;1328
75;Nouvelle-Aquitaine;16;2;15;349;Sainte-Sévère;513;11;524
75;Nouvelle-Aquitaine;16;1;17;350;Saint-Séverin;796;10;806
75;Nouvelle-Aquitaine;16;2;07;352;Saint-Simon;216;8;224
75;Nouvelle-Aquitaine;16;1;19;353;Saint-Sornin;787;16;803
75;Nouvelle-Aquitaine;16;2;09;354;Sainte-Souline;121;3;124
75;Nouvelle-Aquitaine;16;2;11;355;Saint-Sulpice-de-Cognac;1192;16;1208
75;Nouvelle-Aquitaine;16;3;08;356;Saint-Sulpice-de-Ruffec;31;0;31
75;Nouvelle-Aquitaine;16;2;09;357;Saint-Vallier;136;2;138
75;Nouvelle-Aquitaine;16;1;14;358;Saint-Yrieix-sur-Charente;7381;246;7627
75;Nouvelle-Aquitaine;16;2;07;359;Salles-d'Angles;1011;27;1038
75;Nouvelle-Aquitaine;16;2;09;360;Salles-de-Barbezieux;403;85;488
75;Nouvelle-Aquitaine;16;3;08;361;Salles-de-Villefagnan;313;6;319
75;Nouvelle-Aquitaine;16;1;17;362;Salles-Lavalette;326;12;338
75;Nouvelle-Aquitaine;16;3;10;363;Saulgond;524;10;534
75;Nouvelle-Aquitaine;16;3;06;364;Sauvagnac;64;2;66
75;Nouvelle-Aquitaine;16;2;09;365;Sauvignac;106;0;106
75;Nouvelle-Aquitaine;16;2;07;366;Segonzac;2074;77;2151
75;Nouvelle-Aquitaine;16;1;04;368;Sers;888;21;909
75;Nouvelle-Aquitaine;16;2;15;369;Sigogne;982;20;1002
75;Nouvelle-Aquitaine;16;1;18;370;Sireuil;1160;41;1201
75;Nouvelle-Aquitaine;16;1;19;372;Souffrignac;127;2;129
75;Nouvelle-Aquitaine;16;3;08;373;Souvigné;196;6;202
75;Nouvelle-Aquitaine;16;1;03;374;Soyaux;9761;312;10073
75;Nouvelle-Aquitaine;16;3;06;375;Suaux;386;6;392
75;Nouvelle-Aquitaine;16;3;05;377;La Tâche;116;0;116
75;Nouvelle-Aquitaine;16;3;08;378;Taizé-Aizie;573;15;588
75;Nouvelle-Aquitaine;16;1;19;379;Taponnat-Fleurignac;1486;27;1513
75;Nouvelle-Aquitaine;16;2;09;380;Le Tâtre;410;3;413
75;Nouvelle-Aquitaine;16;3;08;381;Theil-Rabier;164;2;166
75;Nouvelle-Aquitaine;16;1;04;382;Torsac;721;31;752
75;Nouvelle-Aquitaine;16;3;05;383;Tourriers;758;10;768
75;Nouvelle-Aquitaine;16;2;09;384;Touvérac;581;7;588
75;Nouvelle-Aquitaine;16;1;16;385;Touvre;1165;26;1191
75;Nouvelle-Aquitaine;16;2;15;387;Triac-Lautrait;466;63;529
75;Nouvelle-Aquitaine;16;1;18;388;Trois-Palis;940;22;962
75;Nouvelle-Aquitaine;16;3;06;389;Turgon;87;2;89
75;Nouvelle-Aquitaine;16;3;08;390;Tusson;222;7;229
75;Nouvelle-Aquitaine;16;3;05;392;Valence;189;6;195
75;Nouvelle-Aquitaine;16;3;05;393;Vars;2168;33;2201
75;Nouvelle-Aquitaine;16;1;17;394;Vaux-Lavalette;83;2;85
75;Nouvelle-Aquitaine;16;2;18;395;Vaux-Rouillac;297;4;301
75;Nouvelle-Aquitaine;16;3;05;396;Ventouse;124;0;124
75;Nouvelle-Aquitaine;16;3;08;397;Verdille;374;7;381
75;Nouvelle-Aquitaine;16;3;06;398;Verneuil;99;5;104
75;Nouvelle-Aquitaine;16;2;07;399;Verrières;346;9;355
75;Nouvelle-Aquitaine;16;3;08;400;Verteuil-sur-Charente;620;11;631
75;Nouvelle-Aquitaine;16;3;05;401;Vervant;146;2;148
75;Nouvelle-Aquitaine;16;2;07;402;Vibrac;283;5;288
75;Nouvelle-Aquitaine;16;3;06;403;Le Vieux-Cérier;127;3;130
75;Nouvelle-Aquitaine;16;3;06;404;Vieux-Ruffec;109;2;111
75;Nouvelle-Aquitaine;16;2;09;405;Vignolles;165;9;174
75;Nouvelle-Aquitaine;16;1;19;406;Moulins-sur-Tardoire;770;15;785
75;Nouvelle-Aquitaine;16;1;17;408;Villebois-Lavalette;717;19;736
75;Nouvelle-Aquitaine;16;3;08;409;Villefagnan;982;11;993
75;Nouvelle-Aquitaine;16;3;05;412;Villejoubert;338;1;339
75;Nouvelle-Aquitaine;16;3;08;413;Villiers-le-Roux;136;2;138
75;Nouvelle-Aquitaine;16;3;05;414;Villognon;312;4;316
75;Nouvelle-Aquitaine;16;1;18;415;Vindelle;1099;20;1119
75;Nouvelle-Aquitaine;16;3;06;416;Vitrac-Saint-Vincent;506;8;514
75;Nouvelle-Aquitaine;16;1;04;418;Vœuil-et-Giget;1547;28;1575
75;Nouvelle-Aquitaine;16;3;05;419;Vouharte;328;2;330
75;Nouvelle-Aquitaine;16;1;04;420;Voulgézac;242;4;246
75;Nouvelle-Aquitaine;16;1;19;421;Vouthon;411;6;417
75;Nouvelle-Aquitaine;16;1;04;422;Vouzan;811;8;819
75;Nouvelle-Aquitaine;16;3;05;423;Xambes;254;4;258
75;Nouvelle-Aquitaine;16;1;17;424;Yviers;525;8;533
75;Nouvelle-Aquitaine;16;1;19;425;Yvrac-et-Malleyrand;557;11;568
75;Nouvelle-Aquitaine;17;1;07;002;Agudelle;133;4;137
75;Nouvelle-Aquitaine;17;2;23;003;Aigrefeuille-d'Aunis;4143;74;4217
75;Nouvelle-Aquitaine;17;2;03;004;Île-d'Aix;207;5;212
75;Nouvelle-Aquitaine;17;1;07;005;Allas-Bocage;196;1;197
75;Nouvelle-Aquitaine;17;1;07;006;Allas-Champagne;252;4;256
75;Nouvelle-Aquitaine;17;2;06;007;Anais;313;7;320
75;Nouvelle-Aquitaine;17;3;09;008;Andilly;2272;33;2305
75;Nouvelle-Aquitaine;17;3;09;009;Angliers;1147;9;1156
75;Nouvelle-Aquitaine;17;3;03;010;Angoulins;4050;101;4151
75;Nouvelle-Aquitaine;17;5;18;011;Annepont;394;4;398
75;Nouvelle-Aquitaine;17;5;18;012;Annezay;155;5;160
75;Nouvelle-Aquitaine;17;5;11;013;Antezant-la-Chapelle;340;8;348
75;Nouvelle-Aquitaine;17;4;21;015;Arces;760;9;769
75;Nouvelle-Aquitaine;17;1;07;016;Archiac;782;12;794
75;Nouvelle-Aquitaine;17;5;18;017;Archingeay;670;13;683
75;Nouvelle-Aquitaine;17;2;23;018;Ardillières;855;13;868
75;Nouvelle-Aquitaine;17;3;05;019;Ars-en-Ré;1302;24;1326
75;Nouvelle-Aquitaine;17;1;07;020;Arthenac;349;4;353
75;Nouvelle-Aquitaine;17;2;26;021;Arvert;3566;84;3650
75;Nouvelle-Aquitaine;17;5;11;022;Asnières-la-Giraud;1006;23;1029
75;Nouvelle-Aquitaine;17;5;02;023;Aujac;373;7;380
75;Nouvelle-Aquitaine;17;5;11;024;Aulnay;1333;25;1358
75;Nouvelle-Aquitaine;17;5;02;025;Aumagne;704;29;733
75;Nouvelle-Aquitaine;17;5;02;026;Authon-Ébéon;385;5;390
75;Nouvelle-Aquitaine;17;1;12;027;Avy;471;7;478
75;Nouvelle-Aquitaine;17;3;01;028;Aytré;9247;167;9414
75;Nouvelle-Aquitaine;17;5;11;029;Bagnizeau;209;1;210
75;Nouvelle-Aquitaine;17;4;19;030;Balanzac;545;5;550
75;Nouvelle-Aquitaine;17;5;11;031;Ballans;195;2;197
75;Nouvelle-Aquitaine;17;2;23;032;Ballon;804;17;821
75;Nouvelle-Aquitaine;17;1;27;033;La Barde;496;5;501
75;Nouvelle-Aquitaine;17;4;21;034;Barzan;463;7;470
75;Nouvelle-Aquitaine;17;5;11;035;Bazauges;112;2;114
75;Nouvelle-Aquitaine;17;2;10;036;Beaugeay;780;14;794
75;Nouvelle-Aquitaine;17;5;11;037;Beauvais-sur-Matha;650;9;659
75;Nouvelle-Aquitaine;17;1;27;038;Bedenac;692;6;698
75;Nouvelle-Aquitaine;17;1;12;039;Belluire;211;1;212
75;Nouvelle-Aquitaine;17;3;09;041;Benon;1679;16;1695
75;Nouvelle-Aquitaine;17;5;02;042;Bercloux;443;9;452
75;Nouvelle-Aquitaine;17;5;18;043;Bernay-Saint-Martin;746;13;759
75;Nouvelle-Aquitaine;17;4;24;044;Berneuil;1149;22;1171
75;Nouvelle-Aquitaine;17;4;19;045;Beurlay;1030;18;1048
75;Nouvelle-Aquitaine;17;5;18;046;Bignay;387;8;395
75;Nouvelle-Aquitaine;17;1;12;047;Biron;237;1;238
75;Nouvelle-Aquitaine;17;5;11;048;Blanzac-lès-Matha;321;4;325
75;Nouvelle-Aquitaine;17;5;11;049;Blanzay-sur-Boutonne;79;5;84
75;Nouvelle-Aquitaine;17;1;12;050;Bois;517;144;661
75;Nouvelle-Aquitaine;17;3;05;051;Le Bois-Plage-en-Ré;2272;30;2302
75;Nouvelle-Aquitaine;17;1;12;052;Boisredon;693;9;702
75;Nouvelle-Aquitaine;17;5;18;053;Bords;1322;27;1349
75;Nouvelle-Aquitaine;17;1;27;054;Boresse-et-Martron;204;9;213
75;Nouvelle-Aquitaine;17;1;27;055;Boscamnant;361;4;365
75;Nouvelle-Aquitaine;17;1;12;056;Bougneau;600;14;614
75;Nouvelle-Aquitaine;17;2;06;057;Bouhet;916;16;932
75;Nouvelle-Aquitaine;17;2;10;058;Bourcefranc-le-Chapus;3506;126;3632
75;Nouvelle-Aquitaine;17;3;06;059;Bourgneuf;1375;25;1400
75;Nouvelle-Aquitaine;17;4;21;060;Boutenac-Touvent;228;5;233
75;Nouvelle-Aquitaine;17;1;27;061;Bran;137;2;139
75;Nouvelle-Aquitaine;17;5;11;062;Bresdon;216;3;219
75;Nouvelle-Aquitaine;17;2;23;063;Breuil-la-Réorte;453;7;460
75;Nouvelle-Aquitaine;17;2;26;064;Breuillet;3010;63;3073
75;Nouvelle-Aquitaine;17;2;25;065;Breuil-Magné;1777;53;1830
75;Nouvelle-Aquitaine;17;1;07;066;Brie-sous-Archiac;235;2;237
75;Nouvelle-Aquitaine;17;5;11;067;Brie-sous-Matha;173;4;177
75;Nouvelle-Aquitaine;17;4;21;068;Brie-sous-Mortagne;243;3;246
75;Nouvelle-Aquitaine;17;1;24;069;Brives-sur-Charente;232;6;238
75;Nouvelle-Aquitaine;17;5;02;070;Brizambourg;934;14;948
75;Nouvelle-Aquitaine;17;5;11;071;La Brousse;511;9;520
75;Nouvelle-Aquitaine;17;4;02;072;Burie;1303;26;1329
75;Nouvelle-Aquitaine;17;4;02;073;Bussac-sur-Charente;1277;44;1321
75;Nouvelle-Aquitaine;17;1;27;074;Bussac-Forêt;1053;15;1068
75;Nouvelle-Aquitaine;17;2;25;075;Cabariot;1386;23;1409
75;Nouvelle-Aquitaine;17;1;07;076;Celles;321;3;324
75;Nouvelle-Aquitaine;17;1;27;077;Cercoux;1235;20;1255
75;Nouvelle-Aquitaine;17;1;12;078;Chadenac;511;7;518
75;Nouvelle-Aquitaine;17;2;26;079;Chaillevette;1610;33;1643
75;Nouvelle-Aquitaine;17;2;23;080;Chambon;961;12;973
75;Nouvelle-Aquitaine;17;1;27;081;Chamouillac;372;7;379
75;Nouvelle-Aquitaine;17;1;07;082;Champagnac;527;8;535
75;Nouvelle-Aquitaine;17;2;10;083;Champagne;619;12;631
75;Nouvelle-Aquitaine;17;1;12;084;Champagnolles;678;8;686
75;Nouvelle-Aquitaine;17;5;18;085;Champdolent;408;6;414
75;Nouvelle-Aquitaine;17;4;02;086;Chaniers;3587;83;3670
75;Nouvelle-Aquitaine;17;5;18;087;Chantemerle-sur-la-Soie;205;2;207
75;Nouvelle-Aquitaine;17;4;02;089;La Chapelle-des-Pots;1004;26;1030
75;Nouvelle-Aquitaine;17;3;09;091;Charron;2001;27;2028
75;Nouvelle-Aquitaine;17;1;27;092;Chartuzac;160;4;164
75;Nouvelle-Aquitaine;17;2;04;093;Le Château-d'Oléron;4270;79;4349
75;Nouvelle-Aquitaine;17;3;03;094;Châtelaillon-Plage;5900;93;5993
75;Nouvelle-Aquitaine;17;1;27;095;Chatenet;215;6;221
75;Nouvelle-Aquitaine;17;1;07;096;Chaunac;77;2;79
75;Nouvelle-Aquitaine;17;4;22;097;Le Chay;778;15;793
75;Nouvelle-Aquitaine;17;4;21;098;Chenac-Saint-Seurin-d'Uzet;598;13;611
75;Nouvelle-Aquitaine;17;1;27;099;Chepniers;635;10;645
75;Nouvelle-Aquitaine;17;4;02;100;Chérac;1118;17;1135
75;Nouvelle-Aquitaine;17;5;11;101;Cherbonnières;331;1;332
75;Nouvelle-Aquitaine;17;4;24;102;Chermignac;1263;35;1298
75;Nouvelle-Aquitaine;17;1;27;104;Chevanceaux;1090;108;1198
75;Nouvelle-Aquitaine;17;5;11;105;Chives;316;1;317
75;Nouvelle-Aquitaine;17;1;07;106;Cierzac;313;5;318
75;Nouvelle-Aquitaine;17;2;23;107;Ciré-d'Aunis;1455;24;1479
75;Nouvelle-Aquitaine;17;1;07;108;Clam;407;15;422
75;Nouvelle-Aquitaine;17;3;06;109;Clavette;1438;20;1458
75;Nouvelle-Aquitaine;17;1;27;110;Clérac;977;15;992
75;Nouvelle-Aquitaine;17;1;07;111;Clion;820;12;832
75;Nouvelle-Aquitaine;17;4;24;112;La Clisse;713;16;729
75;Nouvelle-Aquitaine;17;1;27;113;La Clotte;717;7;724
75;Nouvelle-Aquitaine;17;5;11;114;Coivert;212;2;214
75;Nouvelle-Aquitaine;17;4;24;115;Colombiers;309;7;316
75;Nouvelle-Aquitaine;17;1;07;116;Consac;225;5;230
75;Nouvelle-Aquitaine;17;5;11;117;Contré;140;0;140
75;Nouvelle-Aquitaine;17;1;27;118;Corignac;348;10;358
75;Nouvelle-Aquitaine;17;4;22;119;Corme-Écluse;1127;20;1147
75;Nouvelle-Aquitaine;17;4;24;120;Corme-Royal;1878;39;1917
75;Nouvelle-Aquitaine;17;3;05;121;La Couarde-sur-Mer;1137;19;1156
75;Nouvelle-Aquitaine;17;1;24;122;Coulonges;234;4;238
75;Nouvelle-Aquitaine;17;5;18;124;Courant;426;5;431
75;Nouvelle-Aquitaine;17;5;11;125;Courcelles;462;10;472
75;Nouvelle-Aquitaine;17;5;11;126;Courcerac;299;6;305
75;Nouvelle-Aquitaine;17;3;09;127;Courçon;1776;30;1806
75;Nouvelle-Aquitaine;17;4;24;128;Courcoury;694;12;706
75;Nouvelle-Aquitaine;17;1;12;129;Courpignac;419;6;425
75;Nouvelle-Aquitaine;17;1;27;130;Coux;473;13;486
75;Nouvelle-Aquitaine;17;4;21;131;Cozes;2150;43;2193
75;Nouvelle-Aquitaine;17;3;09;132;Cramchaban;650;18;668
75;Nouvelle-Aquitaine;17;4;21;133;Cravans;896;75;971
75;Nouvelle-Aquitaine;17;4;19;134;Crazannes;432;9;441
75;Nouvelle-Aquitaine;17;5;11;135;Cressé;229;2;231
75;Nouvelle-Aquitaine;17;3;06;136;Croix-Chapeau;1284;28;1312
75;Nouvelle-Aquitaine;17;5;18;137;La Croix-Comtesse;223;3;226
75;Nouvelle-Aquitaine;17;5;11;138;Dampierre-sur-Boutonne;282;3;285
75;Nouvelle-Aquitaine;17;5;18;139;Dœuil-sur-le-Mignon;336;7;343
75;Nouvelle-Aquitaine;17;2;04;140;Dolus-d'Oléron;3144;62;3206
75;Nouvelle-Aquitaine;17;4;02;141;Dompierre-sur-Charente;470;9;479
75;Nouvelle-Aquitaine;17;3;01;142;Dompierre-sur-Mer;5638;143;5781
75;Nouvelle-Aquitaine;17;4;02;143;Le Douhet;703;13;716
75;Nouvelle-Aquitaine;17;1;12;145;Échebrune;485;8;493
75;Nouvelle-Aquitaine;17;2;25;146;Échillais;3547;70;3617
75;Nouvelle-Aquitaine;17;4;02;147;Écoyeux;1376;22;1398
75;Nouvelle-Aquitaine;17;4;19;148;Écurat;459;10;469
75;Nouvelle-Aquitaine;17;5;11;149;Les Éduts;59;2;61
75;Nouvelle-Aquitaine;17;5;11;150;Les Églises-d'Argenteuil;521;7;528
75;Nouvelle-Aquitaine;17;2;22;151;L'Éguille;876;23;899
75;Nouvelle-Aquitaine;17;4;21;152;Épargnes;874;8;882
75;Nouvelle-Aquitaine;17;3;08;153;Esnandes;2076;32;2108
75;Nouvelle-Aquitaine;17;4;19;154;Les Essards;712;8;720
75;Nouvelle-Aquitaine;17;2;26;155;Étaules;2618;43;2661
75;Nouvelle-Aquitaine;17;1;27;156;Expiremont;129;3;132
75;Nouvelle-Aquitaine;17;5;18;157;Fenioux;163;2;165
75;Nouvelle-Aquitaine;17;3;09;158;Ferrières;1066;8;1074
75;Nouvelle-Aquitaine;17;1;12;159;Fléac-sur-Seugne;365;7;372
75;Nouvelle-Aquitaine;17;4;21;160;Floirac;413;13;426
75;Nouvelle-Aquitaine;17;3;05;161;La Flotte;2785;40;2825
75;Nouvelle-Aquitaine;17;5;11;162;Fontaine-Chalendray;198;1;199
75;Nouvelle-Aquitaine;17;1;07;163;Fontaines-d'Ozillac;514;10;524
75;Nouvelle-Aquitaine;17;4;02;164;Fontcouverte;2326;54;2380
75;Nouvelle-Aquitaine;17;5;11;165;Fontenet;392;13;405
75;Nouvelle-Aquitaine;17;2;23;166;Forges;1316;14;1330
75;Nouvelle-Aquitaine;17;1;27;167;Le Fouilloux;771;11;782
75;Nouvelle-Aquitaine;17;2;03;168;Fouras;3934;75;4009
75;Nouvelle-Aquitaine;17;4;19;171;Geay;767;18;785
75;Nouvelle-Aquitaine;17;4;21;172;Gémozac;2906;30;2936
75;Nouvelle-Aquitaine;17;1;27;173;La Genétouze;234;6;240
75;Nouvelle-Aquitaine;17;2;25;174;Genouillé;909;9;918
75;Nouvelle-Aquitaine;17;1;07;175;Germignac;645;7;652
75;Nouvelle-Aquitaine;17;5;11;176;Gibourne;107;4;111
75;Nouvelle-Aquitaine;17;5;11;177;Le Gicq;118;0;118
75;Nouvelle-Aquitaine;17;1;12;178;Givrezac;70;1;71
75;Nouvelle-Aquitaine;17;4;24;179;Les Gonds;1772;85;1857
75;Nouvelle-Aquitaine;17;5;11;180;Gourvillette;89;3;92
75;Nouvelle-Aquitaine;17;5;18;181;Grandjean;310;6;316
75;Nouvelle-Aquitaine;17;3;09;182;La Grève-sur-Mignon;553;11;564
75;Nouvelle-Aquitaine;17;4;21;183;Grézac;938;13;951
75;Nouvelle-Aquitaine;17;2;10;184;La Gripperie-Saint-Symphorien;587;12;599
75;Nouvelle-Aquitaine;17;2;10;185;Le Gua;2100;32;2132
75;Nouvelle-Aquitaine;17;3;09;186;Le Gué-d'Alleré;963;11;974
75;Nouvelle-Aquitaine;17;1;07;187;Guitinières;513;17;530
75;Nouvelle-Aquitaine;17;5;11;188;Haimps;455;9;464
75;Nouvelle-Aquitaine;17;3;08;190;L'Houmeau;2865;56;2921
75;Nouvelle-Aquitaine;17;4;24;191;La Jard;427;9;436
75;Nouvelle-Aquitaine;17;1;07;192;Jarnac-Champagne;835;18;853
75;Nouvelle-Aquitaine;17;3;06;193;La Jarne;2541;54;2595
75;Nouvelle-Aquitaine;17;3;06;194;La Jarrie;3336;75;3411
75;Nouvelle-Aquitaine;17;5;18;195;La Jarrie-Audouin;274;5;279
75;Nouvelle-Aquitaine;17;4;21;196;Jazennes;545;6;551
75;Nouvelle-Aquitaine;17;1;07;197;Jonzac;3519;223;3742
75;Nouvelle-Aquitaine;17;5;02;198;Juicq;301;0;301
75;Nouvelle-Aquitaine;17;1;27;199;Jussas;158;2;160
75;Nouvelle-Aquitaine;17;3;08;200;Lagord;7098;155;7253
75;Nouvelle-Aquitaine;17;3;09;201;La Laigne;480;6;486
75;Nouvelle-Aquitaine;17;5;18;202;Landes;587;13;600
75;Nouvelle-Aquitaine;17;2;23;203;Landrais;729;9;738
75;Nouvelle-Aquitaine;17;1;07;204;Léoville;306;8;314
75;Nouvelle-Aquitaine;17;2;25;205;Loire-les-Marais;395;9;404
75;Nouvelle-Aquitaine;17;5;11;206;Loiré-sur-Nie;283;3;286
75;Nouvelle-Aquitaine;17;3;05;207;Loix;734;17;751
75;Nouvelle-Aquitaine;17;3;09;208;Longèves;1051;15;1066
75;Nouvelle-Aquitaine;17;1;07;209;Lonzac;269;4;273
75;Nouvelle-Aquitaine;17;1;12;210;Lorignac;505;4;509
75;Nouvelle-Aquitaine;17;5;18;211;Loulay;751;9;760
75;Nouvelle-Aquitaine;17;5;11;212;Louzignac;165;2;167
75;Nouvelle-Aquitaine;17;5;18;213;Lozay;134;4;138
75;Nouvelle-Aquitaine;17;4;24;214;Luchat;536;12;548
75;Nouvelle-Aquitaine;17;1;07;215;Lussac;47;0;47
75;Nouvelle-Aquitaine;17;2;25;216;Lussant;1012;14;1026
75;Nouvelle-Aquitaine;17;5;11;217;Macqueville;291;7;298
75;Nouvelle-Aquitaine;17;3;09;218;Marans;4505;64;4569
75;Nouvelle-Aquitaine;17;2;10;219;Marennes-Hiers-Brouage;6234;103;6337
75;Nouvelle-Aquitaine;17;1;12;220;Marignac;415;17;432
75;Nouvelle-Aquitaine;17;2;23;221;Marsais;930;21;951
75;Nouvelle-Aquitaine;17;3;08;222;Marsilly;3130;93;3223
75;Nouvelle-Aquitaine;17;5;11;223;Massac;181;2;183
75;Nouvelle-Aquitaine;17;5;11;224;Matha;2160;80;2240
75;Nouvelle-Aquitaine;17;2;26;225;Les Mathes;2110;32;2142
75;Nouvelle-Aquitaine;17;5;18;226;Mazeray;973;14;987
75;Nouvelle-Aquitaine;17;1;12;227;Mazerolles;221;3;224
75;Nouvelle-Aquitaine;17;4;22;228;Médis;2992;72;3064
75;Nouvelle-Aquitaine;17;1;27;229;Mérignac;219;3;222
75;Nouvelle-Aquitaine;17;2;21;230;Meschers-sur-Gironde;3123;72;3195
75;Nouvelle-Aquitaine;17;1;27;231;Messac;106;5;111
75;Nouvelle-Aquitaine;17;4;21;232;Meursac;1530;21;1551
75;Nouvelle-Aquitaine;17;1;07;233;Meux;325;1;326
75;Nouvelle-Aquitaine;17;5;18;234;Migré;344;5;349
75;Nouvelle-Aquitaine;17;4;02;235;Migron;721;14;735
75;Nouvelle-Aquitaine;17;1;12;236;Mirambeau;1500;29;1529
75;Nouvelle-Aquitaine;17;2;10;237;Moëze;585;4;589
75;Nouvelle-Aquitaine;17;5;11;239;Mons;442;8;450
75;Nouvelle-Aquitaine;17;1;27;240;Montendre;3226;51;3277
75;Nouvelle-Aquitaine;17;1;27;241;Montguyon;1565;19;1584
75;Nouvelle-Aquitaine;17;4;24;242;Montils;869;13;882
75;Nouvelle-Aquitaine;17;1;27;243;Montlieu-la-Garde;1229;10;1239
75;Nouvelle-Aquitaine;17;4;21;244;Montpellier-de-Médillan;690;8;698
75;Nouvelle-Aquitaine;17;3;06;245;Montroy;911;13;924
75;Nouvelle-Aquitaine;17;2;25;246;Moragne;517;7;524
75;Nouvelle-Aquitaine;17;2;26;247;Mornac-sur-Seudre;855;12;867
75;Nouvelle-Aquitaine;17;4;21;248;Mortagne-sur-Gironde;916;20;936
75;Nouvelle-Aquitaine;17;1;07;249;Mortiers;175;1;176
75;Nouvelle-Aquitaine;17;1;12;250;Mosnac;476;5;481
75;Nouvelle-Aquitaine;17;5;18;252;Le Mung;304;7;311
75;Nouvelle-Aquitaine;17;2;25;253;Muron;1349;16;1365
75;Nouvelle-Aquitaine;17;5;18;254;Nachamps;187;4;191
75;Nouvelle-Aquitaine;17;4;19;255;Nancras;798;12;810
75;Nouvelle-Aquitaine;17;5;02;256;Nantillé;324;12;336
75;Nouvelle-Aquitaine;17;5;11;257;Néré;683;6;689
75;Nouvelle-Aquitaine;17;1;07;258;Neuillac;302;5;307
75;Nouvelle-Aquitaine;17;1;07;259;Neulles;153;2;155
75;Nouvelle-Aquitaine;17;1;27;260;Neuvicq;466;5;471
75;Nouvelle-Aquitaine;17;5;11;261;Neuvicq-le-Château;312;6;318
75;Nouvelle-Aquitaine;17;4;19;262;Nieul-lès-Saintes;1262;22;1284
75;Nouvelle-Aquitaine;17;1;07;263;Nieul-le-Virouil;585;11;596
75;Nouvelle-Aquitaine;17;3;08;264;Nieul-sur-Mer;5859;148;6007
75;Nouvelle-Aquitaine;17;2;10;265;Nieulle-sur-Seudre;1208;20;1228
75;Nouvelle-Aquitaine;17;5;18;266;Les Nouillers;719;7;726
75;Nouvelle-Aquitaine;17;3;09;267;Nuaillé-d'Aunis;1165;15;1180
75;Nouvelle-Aquitaine;17;5;11;268;Nuaillé-sur-Boutonne;191;7;198
75;Nouvelle-Aquitaine;17;1;27;269;Orignolles;687;7;694
75;Nouvelle-Aquitaine;17;1;07;270;Ozillac;619;14;633
75;Nouvelle-Aquitaine;17;5;11;271;Paillé;322;6;328
75;Nouvelle-Aquitaine;17;1;24;273;Pérignac;1017;13;1030
75;Nouvelle-Aquitaine;17;3;01;274;Périgny;8684;188;8872
75;Nouvelle-Aquitaine;17;4;24;275;Pessines;774;26;800
75;Nouvelle-Aquitaine;17;1;27;276;Le Pin;75;1;76
75;Nouvelle-Aquitaine;17;5;18;277;Essouvert;1092;86;1178
75;Nouvelle-Aquitaine;17;4;24;278;Pisany;761;9;770
75;Nouvelle-Aquitaine;17;1;12;279;Plassac;626;13;639
75;Nouvelle-Aquitaine;17;4;19;280;Plassay;731;16;747
75;Nouvelle-Aquitaine;17;1;27;281;Polignac;159;3;162
75;Nouvelle-Aquitaine;17;1;27;282;Pommiers-Moulons;213;2;215
75;Nouvelle-Aquitaine;17;1;12;283;Pons;4203;249;4452
75;Nouvelle-Aquitaine;17;4;19;284;Pont-l'Abbé-d'Arnoult;1776;290;2066
75;Nouvelle-Aquitaine;17;4;19;285;Port-d'Envaux;1147;27;1174
75;Nouvelle-Aquitaine;17;3;05;286;Les Portes-en-Ré;594;10;604
75;Nouvelle-Aquitaine;17;1;27;287;Pouillac;249;0;249
75;Nouvelle-Aquitaine;17;5;11;288;Poursay-Garnaud;315;6;321
75;Nouvelle-Aquitaine;17;4;24;289;Préguillac;445;17;462
75;Nouvelle-Aquitaine;17;5;11;290;Prignac;294;9;303
75;Nouvelle-Aquitaine;17;3;01;291;Puilboreau;6556;124;6680
75;Nouvelle-Aquitaine;17;5;18;292;Puy-du-Lac;512;5;517
75;Nouvelle-Aquitaine;17;2;23;293;Puyravault;695;11;706
75;Nouvelle-Aquitaine;17;5;18;294;Puyrolland;201;0;201
75;Nouvelle-Aquitaine;17;1;07;295;Réaux sur Trèfle;794;16;810
75;Nouvelle-Aquitaine;17;4;24;296;Rétaud;1059;19;1078
75;Nouvelle-Aquitaine;17;3;05;297;Rivedoux-Plage;2305;43;2348
75;Nouvelle-Aquitaine;17;4;24;298;Rioux;986;18;1004
75;Nouvelle-Aquitaine;17;2;13;299;Rochefort;23584;682;24266
75;Nouvelle-Aquitaine;17;3;99;300;La Rochelle;77205;2128;79333
75;Nouvelle-Aquitaine;17;5;11;301;Romazières;70;1;71
75;Nouvelle-Aquitaine;17;4;19;302;Romegoux;593;9;602
75;Nouvelle-Aquitaine;17;3;09;303;La Ronde;1031;17;1048
75;Nouvelle-Aquitaine;17;4;24;304;Rouffiac;478;5;483
75;Nouvelle-Aquitaine;17;1;27;305;Rouffignac;414;9;423
75;Nouvelle-Aquitaine;17;2;17;306;Royan;18419;527;18946
75;Nouvelle-Aquitaine;17;4;22;307;Sablonceaux;1391;32;1423
75;Nouvelle-Aquitaine;17;2;10;308;Saint-Agnant;2700;61;2761
75;Nouvelle-Aquitaine;17;1;27;309;Saint-Aigulin;1895;39;1934
75;Nouvelle-Aquitaine;17;4;21;310;Saint-André-de-Lidon;1119;14;1133
75;Nouvelle-Aquitaine;17;2;26;311;Saint-Augustin;1381;24;1405
75;Nouvelle-Aquitaine;17;1;12;312;Saint-Bonnet-sur-Gironde;826;14;840
75;Nouvelle-Aquitaine;17;4;02;313;Saint-Bris-des-Bois;381;9;390
75;Nouvelle-Aquitaine;17;4;02;314;Saint-Césaire;894;16;910
75;Nouvelle-Aquitaine;17;3;06;315;Saint-Christophe;1362;28;1390
75;Nouvelle-Aquitaine;17;1;07;316;Saint-Ciers-Champagne;397;11;408
75;Nouvelle-Aquitaine;17;1;12;317;Saint-Ciers-du-Taillon;559;5;564
75;Nouvelle-Aquitaine;17;3;05;318;Saint-Clément-des-Baleines;682;11;693
75;Nouvelle-Aquitaine;17;1;27;319;Sainte-Colombe;107;1;108
75;Nouvelle-Aquitaine;17;2;25;320;Saint-Coutant-le-Grand;413;6;419
75;Nouvelle-Aquitaine;17;2;18;321;Saint-Crépin;361;3;364
75;Nouvelle-Aquitaine;17;3;09;322;Saint-Cyr-du-Doret;678;4;682
75;Nouvelle-Aquitaine;17;2;04;323;Saint-Denis-d'Oléron;1283;22;1305
75;Nouvelle-Aquitaine;17;1;07;324;Saint-Dizant-du-Bois;111;0;111
75;Nouvelle-Aquitaine;17;1;12;325;Saint-Dizant-du-Gua;538;3;541
75;Nouvelle-Aquitaine;17;1;07;326;Saint-Eugène;286;5;291
75;Nouvelle-Aquitaine;17;5;18;327;Saint-Félix;311;3;314
75;Nouvelle-Aquitaine;17;1;12;328;Saint-Fort-sur-Gironde;902;11;913
75;Nouvelle-Aquitaine;17;2;10;329;Saint-Froult;357;2;359
75;Nouvelle-Aquitaine;17;4;19;330;Sainte-Gemme;1340;15;1355
75;Nouvelle-Aquitaine;17;1;12;331;Saint-Genis-de-Saintonge;1250;50;1300
75;Nouvelle-Aquitaine;17;1;07;332;Saint-Georges-Antignac;390;6;396
75;Nouvelle-Aquitaine;17;2;17;333;Saint-Georges-de-Didonne;5342;116;5458
75;Nouvelle-Aquitaine;17;5;11;334;Saint-Georges-de-Longuepierre;223;4;227
75;Nouvelle-Aquitaine;17;1;12;335;Saint-Georges-des-Agoûts;288;3;291
75;Nouvelle-Aquitaine;17;4;19;336;Saint-Georges-des-Coteaux;2741;58;2799
75;Nouvelle-Aquitaine;17;2;04;337;Saint-Georges-d'Oléron;3742;54;3796
75;Nouvelle-Aquitaine;17;2;23;338;Saint-Georges-du-Bois;1765;33;1798
75;Nouvelle-Aquitaine;17;1;07;339;Saint-Germain-de-Lusignan;1278;123;1401
75;Nouvelle-Aquitaine;17;2;23;340;Saint-Pierre-La-Noue;1536;84;1620
75;Nouvelle-Aquitaine;17;1;07;341;Saint-Germain-de-Vibrac;181;2;183
75;Nouvelle-Aquitaine;17;1;12;342;Saint-Germain-du-Seudre;421;9;430
75;Nouvelle-Aquitaine;17;1;12;343;Saint-Grégoire-d'Ardennes;146;3;149
75;Nouvelle-Aquitaine;17;5;02;344;Saint-Hilaire-de-Villefranche;1319;15;1334
75;Nouvelle-Aquitaine;17;1;07;345;Saint-Hilaire-du-Bois;309;15;324
75;Nouvelle-Aquitaine;17;2;25;346;Saint-Hippolyte;1455;26;1481
75;Nouvelle-Aquitaine;17;5;18;347;Saint-Jean-d'Angély;6796;434;7230
75;Nouvelle-Aquitaine;17;2;10;348;Saint-Jean-d'Angle;691;7;698
75;Nouvelle-Aquitaine;17;3;09;349;Saint-Jean-de-Liversay;2975;43;3018
75;Nouvelle-Aquitaine;17;5;11;350;Saint-Julien-de-l'Escap;873;16;889
75;Nouvelle-Aquitaine;17;2;10;351;Saint-Just-Luzac;2026;33;2059
75;Nouvelle-Aquitaine;17;2;03;353;Saint-Laurent-de-la-Prée;2214;60;2274
75;Nouvelle-Aquitaine;17;1;12;354;Saint-Léger;645;12;657
75;Nouvelle-Aquitaine;17;1;07;355;Sainte-Lheurine;503;11;514
75;Nouvelle-Aquitaine;17;5;18;356;Saint-Loup;306;4;310
75;Nouvelle-Aquitaine;17;1;07;357;Saint-Maigrin;534;8;542
75;Nouvelle-Aquitaine;17;5;11;358;Saint-Mandé-sur-Brédoire;311;6;317
75;Nouvelle-Aquitaine;17;2;23;359;Saint-Mard;1206;20;1226
75;Nouvelle-Aquitaine;17;3;05;360;Sainte-Marie-de-Ré;3363;106;3469
75;Nouvelle-Aquitaine;17;5;11;361;Saint-Martial;113;5;118
75;Nouvelle-Aquitaine;17;1;12;362;Saint-Martial-de-Mirambeau;297;7;304
75;Nouvelle-Aquitaine;17;1;07;363;Saint-Martial-de-Vitaterne;545;14;559
75;Nouvelle-Aquitaine;17;1;07;364;Saint-Martial-sur-Né;437;14;451
75;Nouvelle-Aquitaine;17;1;27;365;Saint-Martin-d'Ary;467;9;476
75;Nouvelle-Aquitaine;17;1;27;366;Saint-Martin-de-Coux;487;4;491
75;Nouvelle-Aquitaine;17;5;11;367;Saint-Martin-de-Juillers;157;4;161
75;Nouvelle-Aquitaine;17;3;05;369;Saint-Martin-de-Ré;2215;20;2235
75;Nouvelle-Aquitaine;17;1;07;372;Saint-Médard;78;1;79
75;Nouvelle-Aquitaine;17;3;06;373;Saint-Médard-d'Aunis;2302;43;2345
75;Nouvelle-Aquitaine;17;5;02;374;Sainte-Même;243;2;245
75;Nouvelle-Aquitaine;17;2;25;375;Saint-Nazaire-sur-Charente;1201;25;1226
75;Nouvelle-Aquitaine;17;3;09;376;Saint-Ouen-d'Aunis;1897;32;1929
75;Nouvelle-Aquitaine;17;5;11;377;Saint-Ouen-la-Thène;125;6;131
75;Nouvelle-Aquitaine;17;1;27;378;Saint-Palais-de-Négrignac;434;6;440
75;Nouvelle-Aquitaine;17;1;12;379;Saint-Palais-de-Phiolin;207;3;210
75;Nouvelle-Aquitaine;17;2;26;380;Saint-Palais-sur-Mer;3907;85;3992
75;Nouvelle-Aquitaine;17;5;11;381;Saint-Pardoult;228;3;231
75;Nouvelle-Aquitaine;17;2;23;382;Saint-Pierre-d'Amilly;535;6;541
75;Nouvelle-Aquitaine;17;5;11;383;Saint-Pierre-de-Juillers;348;4;352
75;Nouvelle-Aquitaine;17;5;11;384;Saint-Pierre-de-l'Isle;259;4;263
75;Nouvelle-Aquitaine;17;2;04;385;Saint-Pierre-d'Oléron;6634;98;6732
75;Nouvelle-Aquitaine;17;1;27;386;Saint-Pierre-du-Palais;353;9;362
75;Nouvelle-Aquitaine;17;4;19;387;Saint-Porchaire;1896;30;1926
75;Nouvelle-Aquitaine;17;1;12;388;Saint-Quantin-de-Rançanne;256;7;263
75;Nouvelle-Aquitaine;17;4;19;389;Sainte-Radegonde;579;9;588
75;Nouvelle-Aquitaine;17;1;12;390;Sainte-Ramée;116;1;117
75;Nouvelle-Aquitaine;17;3;06;391;Saint-Rogatien;2352;49;2401
75;Nouvelle-Aquitaine;17;4;22;393;Saint-Romain-de-Benet;1733;27;1760
75;Nouvelle-Aquitaine;17;2;23;394;Saint-Saturnin-du-Bois;906;18;924
75;Nouvelle-Aquitaine;17;4;02;395;Saint-Sauvant;481;8;489
75;Nouvelle-Aquitaine;17;3;09;396;Saint-Sauveur-d'Aunis;1732;29;1761
75;Nouvelle-Aquitaine;17;5;18;397;Saint-Savinien;2446;106;2552
75;Nouvelle-Aquitaine;17;1;12;398;Saint-Seurin-de-Palenne;168;7;175
75;Nouvelle-Aquitaine;17;4;24;400;Saint-Sever-de-Saintonge;630;13;643
75;Nouvelle-Aquitaine;17;5;11;401;Saint-Séverin-sur-Boutonne;95;7;102
75;Nouvelle-Aquitaine;17;1;07;402;Saint-Sigismond-de-Clermont;155;3;158
75;Nouvelle-Aquitaine;17;1;07;403;Saint-Simon-de-Bordes;747;13;760
75;Nouvelle-Aquitaine;17;4;21;404;Saint-Simon-de-Pellouaille;659;19;678
75;Nouvelle-Aquitaine;17;1;12;405;Saint-Sorlin-de-Conac;199;2;201
75;Nouvelle-Aquitaine;17;2;10;406;Saint-Sornin;413;3;416
75;Nouvelle-Aquitaine;17;3;06;407;Sainte-Soulle;4846;99;4945
75;Nouvelle-Aquitaine;17;4;19;408;Saint-Sulpice-d'Arnoult;886;10;896
75;Nouvelle-Aquitaine;17;2;22;409;Saint-Sulpice-de-Royan;3309;65;3374
75;Nouvelle-Aquitaine;17;1;12;410;Saint-Thomas-de-Conac;575;9;584
75;Nouvelle-Aquitaine;17;2;04;411;Saint-Trojan-les-Bains;1145;21;1166
75;Nouvelle-Aquitaine;17;4;02;412;Saint-Vaize;675;8;683
75;Nouvelle-Aquitaine;17;3;03;413;Saint-Vivien;1359;21;1380
75;Nouvelle-Aquitaine;17;3;08;414;Saint-Xandre;5091;163;5254
75;Nouvelle-Aquitaine;17;4;20;415;Saintes;25287;1407;26694
75;Nouvelle-Aquitaine;17;5;11;416;Saleignes;59;2;61
75;Nouvelle-Aquitaine;17;1;12;417;Salignac-de-Mirambeau;165;1;166
75;Nouvelle-Aquitaine;17;1;24;418;Salignac-sur-Charente;605;16;621
75;Nouvelle-Aquitaine;17;3;03;420;Salles-sur-Mer;2263;62;2325
75;Nouvelle-Aquitaine;17;4;22;421;Saujon;7180;117;7297
75;Nouvelle-Aquitaine;17;5;11;422;Seigné;72;0;72
75;Nouvelle-Aquitaine;17;1;12;423;Semillac;74;1;75
75;Nouvelle-Aquitaine;17;1;12;424;Semoussac;382;3;385
75;Nouvelle-Aquitaine;17;4;22;425;Semussac;2405;45;2450
75;Nouvelle-Aquitaine;17;4;02;426;Le Seure;252;4;256
75;Nouvelle-Aquitaine;17;5;11;427;Siecq;216;5;221
75;Nouvelle-Aquitaine;17;5;11;428;Sonnac;493;10;503
75;Nouvelle-Aquitaine;17;2;25;429;Soubise;3047;30;3077
75;Nouvelle-Aquitaine;17;1;12;430;Soubran;401;7;408
75;Nouvelle-Aquitaine;17;4;19;431;Soulignonne;708;6;714
75;Nouvelle-Aquitaine;17;1;27;432;Souméras;365;6;371
75;Nouvelle-Aquitaine;17;1;27;433;Sousmoulins;213;7;220
75;Nouvelle-Aquitaine;17;2;23;434;Surgères;6786;170;6956
75;Nouvelle-Aquitaine;17;5;18;435;Taillant;176;1;177
75;Nouvelle-Aquitaine;17;5;18;436;Taillebourg;756;23;779
75;Nouvelle-Aquitaine;17;4;21;437;Talmont-sur-Gironde;98;1;99
75;Nouvelle-Aquitaine;17;4;21;438;Tanzac;303;7;310
75;Nouvelle-Aquitaine;17;3;09;439;Taugon;784;14;798
75;Nouvelle-Aquitaine;17;5;18;440;Ternant;374;8;382
75;Nouvelle-Aquitaine;17;4;24;441;Tesson;1125;24;1149
75;Nouvelle-Aquitaine;17;4;21;442;Thaims;382;3;385
75;Nouvelle-Aquitaine;17;3;06;443;Thairé;1723;44;1767
75;Nouvelle-Aquitaine;17;4;24;444;Thénac;1675;257;1932
75;Nouvelle-Aquitaine;17;4;24;445;Thézac;330;8;338
75;Nouvelle-Aquitaine;17;5;11;446;Thors;464;6;470
75;Nouvelle-Aquitaine;17;2;23;447;Le Thou;1987;31;2018
75;Nouvelle-Aquitaine;17;5;18;448;Tonnay-Boutonne;1170;14;1184
75;Nouvelle-Aquitaine;17;2;25;449;Tonnay-Charente;8097;139;8236
75;Nouvelle-Aquitaine;17;5;18;450;Torxé;230;3;233
75;Nouvelle-Aquitaine;17;5;11;451;Les Touches-de-Périgny;550;10;560
75;Nouvelle-Aquitaine;17;2;26;452;La Tremblade;4322;63;4385
75;Nouvelle-Aquitaine;17;4;19;453;Trizay;1470;33;1503
75;Nouvelle-Aquitaine;17;1;27;454;Tugéras-Saint-Maurice;375;6;381
75;Nouvelle-Aquitaine;17;4;19;455;La Vallée;670;11;681
75;Nouvelle-Aquitaine;17;2;18;457;La Devise;1191;18;1209
75;Nouvelle-Aquitaine;17;1;27;458;Vanzac;170;0;170
75;Nouvelle-Aquitaine;17;5;11;459;Varaize;561;10;571
75;Nouvelle-Aquitaine;17;4;24;460;Varzay;833;17;850
75;Nouvelle-Aquitaine;17;2;17;461;Vaux-sur-Mer;3926;81;4007
75;Nouvelle-Aquitaine;17;4;02;462;Vénérand;766;15;781
75;Nouvelle-Aquitaine;17;2;25;463;Vergeroux;1258;22;1280
75;Nouvelle-Aquitaine;17;5;18;464;Vergné;151;6;157
75;Nouvelle-Aquitaine;17;5;18;465;La Vergne;590;8;598
75;Nouvelle-Aquitaine;17;3;06;466;Vérines;2296;32;2328
75;Nouvelle-Aquitaine;17;5;11;467;Vervant;235;2;237
75;Nouvelle-Aquitaine;17;1;07;468;Vibrac;150;3;153
75;Nouvelle-Aquitaine;17;4;21;469;Villars-en-Pons;575;12;587
75;Nouvelle-Aquitaine;17;4;02;470;Villars-les-Bois;232;9;241
75;Nouvelle-Aquitaine;17;5;11;471;La Villedieu;210;3;213
75;Nouvelle-Aquitaine;17;3;09;472;Villedoux;2278;17;2295
75;Nouvelle-Aquitaine;17;5;11;473;Villemorin;117;0;117
75;Nouvelle-Aquitaine;17;5;18;474;Villeneuve-la-Comtesse;739;15;754
75;Nouvelle-Aquitaine;17;1;07;476;Villexavier;272;3;275
75;Nouvelle-Aquitaine;17;5;11;477;Villiers-Couture;110;1;111
75;Nouvelle-Aquitaine;17;5;11;478;Vinax;58;1;59
75;Nouvelle-Aquitaine;17;4;21;479;Virollet;294;4;298
75;Nouvelle-Aquitaine;17;2;23;480;Virson;766;10;776
75;Nouvelle-Aquitaine;17;5;18;481;Voissay;164;3;167
75;Nouvelle-Aquitaine;17;2;23;482;Vouhé;644;11;655
75;Nouvelle-Aquitaine;17;3;03;483;Yves;1490;26;1516
75;Nouvelle-Aquitaine;17;2;25;484;Port-des-Barques;1768;15;1783
75;Nouvelle-Aquitaine;17;2;04;485;Le Grand-Village-Plage;1070;13;1083
75;Nouvelle-Aquitaine;17;2;04;486;La Brée-les-Bains;684;6;690
24;Centre-Val de Loire;18;1;15;001;Achères;380;8;388
24;Centre-Val de Loire;18;2;08;002;Ainay-le-Vieil;191;4;195
24;Centre-Val de Loire;18;1;14;003;Les Aix-d'Angillon;1889;28;1917
24;Centre-Val de Loire;18;1;15;004;Allogny;1070;19;1089
24;Centre-Val de Loire;18;3;11;005;Allouis;1068;21;1089
24;Centre-Val de Loire;18;1;17;006;Annoix;237;2;239
24;Centre-Val de Loire;18;2;10;007;Apremont-sur-Allier;70;3;73
24;Centre-Val de Loire;18;1;17;008;Arçay;500;10;510
24;Centre-Val de Loire;18;2;08;009;Arcomps;283;11;294
24;Centre-Val de Loire;18;2;08;010;Ardenais;199;7;206
24;Centre-Val de Loire;18;3;01;011;Argent-sur-Sauldre;2063;40;2103
24;Centre-Val de Loire;18;1;02;012;Argenvières;440;5;445
24;Centre-Val de Loire;18;2;09;013;Arpheuilles;304;5;309
24;Centre-Val de Loire;18;1;16;014;Assigny;148;7;155
24;Centre-Val de Loire;18;3;01;015;Aubigny-sur-Nère;5502;128;5630
24;Centre-Val de Loire;18;1;14;016;Aubinges;400;3;403
24;Centre-Val de Loire;18;2;09;017;Augy-sur-Aubois;288;3;291
24;Centre-Val de Loire;18;1;02;018;Avord;2740;36;2776
24;Centre-Val de Loire;18;1;14;019;Azy;445;7;452
24;Centre-Val de Loire;18;1;16;020;Bannay;858;13;871
24;Centre-Val de Loire;18;2;09;021;Bannegon;273;4;277
24;Centre-Val de Loire;18;1;16;022;Barlieu;345;8;353
24;Centre-Val de Loire;18;1;02;023;Baugy;1665;54;1719
24;Centre-Val de Loire;18;2;08;024;Beddes;99;3;102
24;Centre-Val de Loire;18;1;02;025;Beffes;617;12;629
24;Centre-Val de Loire;18;1;16;026;Belleville-sur-Loire;1010;27;1037
24;Centre-Val de Loire;18;1;02;027;Bengy-sur-Craon;657;67;724
24;Centre-Val de Loire;18;3;11;028;Berry-Bouy;1183;37;1220
24;Centre-Val de Loire;18;2;09;029;Bessais-le-Fromental;301;4;305
24;Centre-Val de Loire;18;3;01;030;Blancafort;1018;22;1040
24;Centre-Val de Loire;18;2;10;031;Blet;568;5;573
24;Centre-Val de Loire;18;1;16;032;Boulleret;1396;36;1432
24;Centre-Val de Loire;18;1;98;033;Bourges;64541;2065;66606
24;Centre-Val de Loire;18;2;12;034;Bouzais;309;9;318
24;Centre-Val de Loire;18;1;14;035;Brécy;1043;24;1067
24;Centre-Val de Loire;18;3;11;036;Brinay;523;7;530
24;Centre-Val de Loire;18;3;01;037;Brinon-sur-Sauldre;974;14;988
24;Centre-Val de Loire;18;2;12;038;Bruère-Allichamps;567;4;571
24;Centre-Val de Loire;18;1;16;039;Bué;318;8;326
24;Centre-Val de Loire;18;2;09;040;Bussy;362;3;365
24;Centre-Val de Loire;18;2;08;041;La Celette;192;2;194
24;Centre-Val de Loire;18;2;12;042;La Celle;353;2;355
24;Centre-Val de Loire;18;2;08;043;La Celle-Condé;195;0;195
24;Centre-Val de Loire;18;3;11;044;Cerbois;416;4;420
24;Centre-Val de Loire;18;2;09;045;Chalivoy-Milon;418;8;426
24;Centre-Val de Loire;18;2;17;046;Chambon;169;3;172
24;Centre-Val de Loire;18;3;01;047;La Chapelle-d'Angillon;613;8;621
24;Centre-Val de Loire;18;2;10;048;La Chapelle-Hugon;381;5;386
24;Centre-Val de Loire;18;1;02;049;La Chapelle-Montlinard;468;8;476
24;Centre-Val de Loire;18;1;13;050;La Chapelle-Saint-Ursin;3663;77;3740
24;Centre-Val de Loire;18;1;14;051;La Chapelotte;136;3;139
24;Centre-Val de Loire;18;2;09;052;Charenton-du-Cher;1023;21;1044
24;Centre-Val de Loire;18;1;02;053;Charentonnay;293;8;301
24;Centre-Val de Loire;18;2;10;054;Charly;246;3;249
24;Centre-Val de Loire;18;1;07;055;Chârost;941;22;963
24;Centre-Val de Loire;18;1;02;056;Chassy;239;5;244
24;Centre-Val de Loire;18;2;08;057;Châteaumeillant;1751;20;1771
24;Centre-Val de Loire;18;2;17;058;Châteauneuf-sur-Cher;1457;19;1476
24;Centre-Val de Loire;18;2;08;059;Le Châtelet;943;12;955
24;Centre-Val de Loire;18;2;09;060;Chaumont;50;2;52
24;Centre-Val de Loire;18;1;02;061;Chaumoux-Marcilly;90;0;90
24;Centre-Val de Loire;18;2;10;062;Le Chautay;268;2;270
24;Centre-Val de Loire;18;2;17;063;Chavannes;162;6;168
24;Centre-Val de Loire;18;3;11;064;Chéry;216;7;223
24;Centre-Val de Loire;18;2;08;065;Chezal-Benoît;823;12;835
24;Centre-Val de Loire;18;1;07;066;Civray;906;15;921
24;Centre-Val de Loire;18;3;01;067;Clémont;710;9;719
24;Centre-Val de Loire;18;2;09;068;Cogny;34;2;36
24;Centre-Val de Loire;18;2;12;069;Colombiers;417;15;432
24;Centre-Val de Loire;18;1;16;070;Concressault;202;2;204
24;Centre-Val de Loire;18;2;09;071;Contres;33;0;33
24;Centre-Val de Loire;18;2;10;072;Cornusse;266;4;270
24;Centre-Val de Loire;18;2;17;073;Corquoy;203;8;211
24;Centre-Val de Loire;18;1;16;074;Couargues;200;4;204
24;Centre-Val de Loire;18;2;10;075;Cours-les-Barres;1013;26;1039
24;Centre-Val de Loire;18;2;09;076;Coust;442;8;450
24;Centre-Val de Loire;18;1;02;077;Couy;363;9;372
24;Centre-Val de Loire;18;2;17;078;Crézançay-sur-Cher;59;1;60
24;Centre-Val de Loire;18;1;16;079;Crézancy-en-Sancerre;454;6;460
24;Centre-Val de Loire;18;2;10;080;Croisy;152;2;154
24;Centre-Val de Loire;18;1;02;081;Crosses;401;3;404
24;Centre-Val de Loire;18;2;10;082;Cuffy;1032;30;1062
24;Centre-Val de Loire;18;2;08;083;Culan;750;7;757
24;Centre-Val de Loire;18;1;16;084;Dampierre-en-Crot;203;4;207
24;Centre-Val de Loire;18;3;19;085;Dampierre-en-Graçay;240;6;246
24;Centre-Val de Loire;18;2;12;086;Drevant;549;17;566
24;Centre-Val de Loire;18;2;09;087;Dun-sur-Auron;3655;76;3731
24;Centre-Val de Loire;18;3;01;088;Ennordres;212;7;219
24;Centre-Val de Loire;18;2;08;089;Épineuil-le-Fleuriel;434;10;444
24;Centre-Val de Loire;18;1;02;090;Étréchy;427;10;437
24;Centre-Val de Loire;18;2;12;091;Farges-Allichamps;249;6;255
24;Centre-Val de Loire;18;1;02;092;Farges-en-Septaine;999;24;1023
24;Centre-Val de Loire;18;2;08;093;Faverdines;139;3;142
24;Centre-Val de Loire;18;1;16;094;Feux;337;8;345
24;Centre-Val de Loire;18;2;10;095;Flavigny;180;4;184
24;Centre-Val de Loire;18;3;11;096;Foëcy;2099;25;2124
24;Centre-Val de Loire;18;1;15;097;Fussy;1964;32;1996
24;Centre-Val de Loire;18;1;16;098;Gardefort;129;4;133
24;Centre-Val de Loire;18;1;02;099;Garigny;223;3;226
24;Centre-Val de Loire;18;3;19;100;Genouilly;676;16;692
24;Centre-Val de Loire;18;2;10;101;Germigny-l'Exempt;296;10;306
24;Centre-Val de Loire;18;2;09;102;Givardon;301;2;303
24;Centre-Val de Loire;18;3;19;103;Graçay;1432;14;1446
24;Centre-Val de Loire;18;1;02;104;Groises;133;2;135
24;Centre-Val de Loire;18;1;02;105;Gron;458;17;475
24;Centre-Val de Loire;18;2;09;106;Grossouvre;266;3;269
24;Centre-Val de Loire;18;2;12;107;La Groutte;124;8;132
24;Centre-Val de Loire;18;2;10;108;La Guerche-sur-l'Aubois;3177;35;3212
24;Centre-Val de Loire;18;1;14;109;Henrichemont;1729;21;1750
24;Centre-Val de Loire;18;1;02;110;Herry;967;24;991
24;Centre-Val de Loire;18;1;14;111;Humbligny;182;1;183
24;Centre-Val de Loire;18;2;08;112;Ids-Saint-Roch;286;1;287
24;Centre-Val de Loire;18;2;10;113;Ignol;181;3;184
24;Centre-Val de Loire;18;2;08;114;Ineuil;226;4;230
24;Centre-Val de Loire;18;3;01;115;Ivoy-le-Pré;790;8;798
24;Centre-Val de Loire;18;1;16;116;Jalognes;277;2;279
24;Centre-Val de Loire;18;1;16;117;Jars;503;5;508
24;Centre-Val de Loire;18;2;10;118;Jouet-sur-l'Aubois;1322;35;1357
24;Centre-Val de Loire;18;1;02;119;Jussy-Champagne;203;5;208
24;Centre-Val de Loire;18;1;02;120;Jussy-le-Chaudrier;593;13;606
24;Centre-Val de Loire;18;2;09;121;Lantan;92;2;94
24;Centre-Val de Loire;18;1;17;122;Lapan;215;2;217
24;Centre-Val de Loire;18;3;11;124;Lazenay;312;3;315
24;Centre-Val de Loire;18;1;16;125;Léré;1082;23;1105
24;Centre-Val de Loire;18;1;17;126;Levet;1379;42;1421
24;Centre-Val de Loire;18;2;08;127;Lignières;1358;27;1385
24;Centre-Val de Loire;18;3;11;128;Limeux;165;0;165
24;Centre-Val de Loire;18;1;17;129;Lissay-Lochy;229;6;235
24;Centre-Val de Loire;18;2;08;130;Loye-sur-Arnon;299;6;305
24;Centre-Val de Loire;18;2;10;131;Lugny-Bourbonnais;34;0;34
24;Centre-Val de Loire;18;1;02;132;Lugny-Champagne;137;1;138
24;Centre-Val de Loire;18;1;07;133;Lunery;1585;15;1600
24;Centre-Val de Loire;18;3;11;134;Lury-sur-Arnon;659;16;675
24;Centre-Val de Loire;18;2;08;135;Maisonnais;240;5;245
24;Centre-Val de Loire;18;2;12;136;Marçais;296;5;301
24;Centre-Val de Loire;18;1;07;137;Mareuil-sur-Arnon;505;10;515
24;Centre-Val de Loire;18;1;13;138;Marmagne;1922;57;1979
24;Centre-Val de Loire;18;1;02;139;Marseilles-lès-Aubigny;655;9;664
24;Centre-Val de Loire;18;3;11;140;Massay;1365;24;1389
24;Centre-Val de Loire;18;3;11;141;Mehun-sur-Yèvre;6555;128;6683
24;Centre-Val de Loire;18;2;12;142;Meillant;686;17;703
24;Centre-Val de Loire;18;2;10;143;Menetou-Couture;379;7;386
24;Centre-Val de Loire;18;1;16;144;Menetou-Râtel;467;10;477
24;Centre-Val de Loire;18;1;15;145;Menetou-Salon;1612;40;1652
24;Centre-Val de Loire;18;1;16;146;Ménétréol-sous-Sancerre;316;13;329
24;Centre-Val de Loire;18;3;01;147;Ménétréol-sur-Sauldre;204;3;207
24;Centre-Val de Loire;18;3;11;148;Méreau;2606;62;2668
24;Centre-Val de Loire;18;3;01;149;Méry-ès-Bois;575;13;588
24;Centre-Val de Loire;18;3;19;150;Méry-sur-Cher;694;15;709
24;Centre-Val de Loire;18;1;14;151;Montigny;352;12;364
24;Centre-Val de Loire;18;2;08;152;Montlouis;109;2;111
24;Centre-Val de Loire;18;2;08;153;Morlac;332;3;335
24;Centre-Val de Loire;18;2;10;154;Mornay-Berry;175;4;179
24;Centre-Val de Loire;18;2;09;155;Mornay-sur-Allier;430;9;439
24;Centre-Val de Loire;18;1;14;156;Morogues;436;9;445
24;Centre-Val de Loire;18;1;07;157;Morthomiers;763;24;787
24;Centre-Val de Loire;18;1;02;158;Moulins-sur-Yèvre;847;19;866
24;Centre-Val de Loire;18;3;01;159;Nançay;820;29;849
24;Centre-Val de Loire;18;2;10;160;Nérondes;1466;30;1496
24;Centre-Val de Loire;18;2;09;161;Neuilly-en-Dun;219;2;221
24;Centre-Val de Loire;18;1;14;162;Neuilly-en-Sancerre;255;1;256
24;Centre-Val de Loire;18;1;14;163;Neuvy-Deux-Clochers;271;5;276
24;Centre-Val de Loire;18;2;09;164;Neuvy-le-Barrois;132;3;135
24;Centre-Val de Loire;18;3;01;165;Neuvy-sur-Barangeon;1108;30;1138
24;Centre-Val de Loire;18;1;02;166;Nohant-en-Goût;574;10;584
24;Centre-Val de Loire;18;3;19;167;Nohant-en-Graçay;300;2;302
24;Centre-Val de Loire;18;1;16;168;Le Noyer;217;2;219
24;Centre-Val de Loire;18;2;12;169;Nozières;213;7;220
24;Centre-Val de Loire;18;3;01;170;Oizon;668;14;682
24;Centre-Val de Loire;18;2;12;171;Orcenais;252;4;256
24;Centre-Val de Loire;18;2;12;172;Orval;1798;44;1842
24;Centre-Val de Loire;18;2;09;173;Osmery;246;2;248
24;Centre-Val de Loire;18;1;02;174;Osmoy;263;3;266
24;Centre-Val de Loire;18;2;10;175;Ourouer-les-Bourdelins;614;3;617
24;Centre-Val de Loire;18;1;14;176;Parassy;405;5;410
24;Centre-Val de Loire;18;2;09;177;Parnay;57;0;57
24;Centre-Val de Loire;18;2;08;178;La Perche;198;3;201
24;Centre-Val de Loire;18;1;15;179;Pigny;1005;20;1025
24;Centre-Val de Loire;18;1;17;180;Plaimpied-Givaudins;2069;68;2137
24;Centre-Val de Loire;18;1;07;181;Plou;539;8;547
24;Centre-Val de Loire;18;1;07;182;Poisieux;218;5;223
24;Centre-Val de Loire;18;2;09;183;Le Pondy;148;3;151
24;Centre-Val de Loire;18;1;02;184;Précy;348;1;349
24;Centre-Val de Loire;18;3;01;185;Presly;234;1;235
24;Centre-Val de Loire;18;3;11;186;Preuilly;422;8;430
24;Centre-Val de Loire;18;2;08;187;Préveranges;512;9;521
24;Centre-Val de Loire;18;1;07;188;Primelles;249;5;254
24;Centre-Val de Loire;18;1;15;189;Quantilly;479;4;483
24;Centre-Val de Loire;18;3;11;190;Quincy;859;18;877
24;Centre-Val de Loire;18;2;09;191;Raymond;179;2;181
24;Centre-Val de Loire;18;2;08;192;Reigny;237;3;240
24;Centre-Val de Loire;18;2;08;193;Rezay;204;5;209
24;Centre-Val de Loire;18;1;14;194;Rians;971;19;990
24;Centre-Val de Loire;18;2;09;195;Sagonne;191;5;196
24;Centre-Val de Loire;18;2;09;196;Saint-Aignan-des-Noyers;82;2;84
24;Centre-Val de Loire;18;2;12;197;Saint-Amand-Montrond;9488;282;9770
24;Centre-Val de Loire;18;1;07;198;Saint-Ambroix;371;16;387
24;Centre-Val de Loire;18;2;08;199;Saint-Baudel;252;4;256
24;Centre-Val de Loire;18;1;16;200;Saint-Bouize;311;15;326
24;Centre-Val de Loire;18;1;17;201;Saint-Caprais;771;15;786
24;Centre-Val de Loire;18;1;14;202;Saint-Céols;13;0;13
24;Centre-Val de Loire;18;2;08;203;Saint-Christophe-le-Chaudry;97;1;98
24;Centre-Val de Loire;18;2;09;204;Saint-Denis-de-Palin;290;8;298
24;Centre-Val de Loire;18;1;13;205;Saint-Doulchard;9607;239;9846
24;Centre-Val de Loire;18;1;15;206;Saint-Éloy-de-Gy;1549;53;1602
24;Centre-Val de Loire;18;1;07;207;Saint-Florent-sur-Cher;6442;101;6543
24;Centre-Val de Loire;18;1;16;208;Sainte-Gemme-en-Sancerrois;411;7;418
24;Centre-Val de Loire;18;2;08;209;Saint-Georges-de-Poisieux;447;15;462
24;Centre-Val de Loire;18;3;19;210;Saint-Georges-sur-la-Prée;607;10;617
24;Centre-Val de Loire;18;1;15;211;Saint-Georges-sur-Moulon;681;12;693
24;Centre-Val de Loire;18;2;09;212;Saint-Germain-des-Bois;637;15;652
24;Centre-Val de Loire;18;1;14;213;Saint-Germain-du-Puy;5041;116;5157
24;Centre-Val de Loire;18;3;19;214;Saint-Hilaire-de-Court;594;2;596
24;Centre-Val de Loire;18;2;10;215;Saint-Hilaire-de-Gondilly;154;2;156
24;Centre-Val de Loire;18;2;08;216;Saint-Hilaire-en-Lignières;486;13;499
24;Centre-Val de Loire;18;2;08;217;Saint-Jeanvrin;147;4;151
24;Centre-Val de Loire;18;1;17;218;Saint-Just;657;5;662
24;Centre-Val de Loire;18;3;15;219;Saint-Laurent;508;11;519
24;Centre-Val de Loire;18;1;02;220;Saint-Léger-le-Petit;349;4;353
24;Centre-Val de Loire;18;2;17;221;Saint-Loup-des-Chaumes;299;2;301
24;Centre-Val de Loire;18;1;15;223;Saint-Martin-d'Auxigny;2447;39;2486
24;Centre-Val de Loire;18;1;02;224;Saint-Martin-des-Champs;297;9;306
24;Centre-Val de Loire;18;2;08;225;Saint-Maur;277;9;286
24;Centre-Val de Loire;18;1;14;226;Saint-Michel-de-Volangis;451;15;466
24;Centre-Val de Loire;18;3;01;227;Sainte-Montaine;172;3;175
24;Centre-Val de Loire;18;3;19;228;Saint-Outrille;218;3;221
24;Centre-Val de Loire;18;1;15;229;Saint-Palais;611;19;630
24;Centre-Val de Loire;18;2;08;230;Saint-Pierre-les-Bois;283;11;294
24;Centre-Val de Loire;18;2;09;231;Saint-Pierre-les-Étieux;742;18;760
24;Centre-Val de Loire;18;2;08;232;Saint-Priest-la-Marche;241;3;244
24;Centre-Val de Loire;18;1;16;233;Saint-Satur;1400;48;1448
24;Centre-Val de Loire;18;2;08;234;Saint-Saturnin;426;8;434
24;Centre-Val de Loire;18;1;14;235;Sainte-Solange;1126;18;1144
24;Centre-Val de Loire;18;2;17;236;Saint-Symphorien;133;2;135
24;Centre-Val de Loire;18;3;11;237;Sainte-Thorette;478;4;482
24;Centre-Val de Loire;18;2;08;238;Saint-Vitte;128;3;131
24;Centre-Val de Loire;18;1;02;240;Sancergues;644;7;651
24;Centre-Val de Loire;18;1;16;241;Sancerre;1349;30;1379
24;Centre-Val de Loire;18;2;09;242;Sancoins;2984;33;3017
24;Centre-Val de Loire;18;1;16;243;Santranges;400;8;408
24;Centre-Val de Loire;18;1;07;244;Saugy;79;0;79
24;Centre-Val de Loire;18;2;08;245;Saulzais-le-Potier;487;9;496
24;Centre-Val de Loire;18;1;16;246;Savigny-en-Sancerre;1107;22;1129
24;Centre-Val de Loire;18;1;02;247;Savigny-en-Septaine;725;15;740
24;Centre-Val de Loire;18;1;17;248;Senneçay;468;6;474
24;Centre-Val de Loire;18;1;16;249;Sens-Beaujeu;402;14;416
24;Centre-Val de Loire;18;2;17;250;Serruelles;68;2;70
24;Centre-Val de Loire;18;1;02;251;Sévry;58;2;60
24;Centre-Val de Loire;18;2;08;252;Sidiailles;295;5;300
24;Centre-Val de Loire;18;1;14;253;Soulangis;476;13;489
24;Centre-Val de Loire;18;1;17;254;Soye-en-Septaine;602;16;618
24;Centre-Val de Loire;18;1;07;255;Le Subdray;1012;204;1216
24;Centre-Val de Loire;18;1;16;256;Subligny;337;7;344
24;Centre-Val de Loire;18;1;16;257;Sury-près-Léré;680;14;694
24;Centre-Val de Loire;18;1;16;258;Sury-en-Vaux;695;16;711
24;Centre-Val de Loire;18;1;16;259;Sury-ès-Bois;278;3;281
24;Centre-Val de Loire;18;2;10;260;Tendron;88;2;90
24;Centre-Val de Loire;18;2;09;261;Thaumiers;410;7;417
24;Centre-Val de Loire;18;1;16;262;Thauvenay;327;8;335
24;Centre-Val de Loire;18;3;19;263;Thénioux;663;3;666
24;Centre-Val de Loire;18;1;16;264;Thou;79;2;81
24;Centre-Val de Loire;18;2;10;265;Torteron;793;13;806
24;Centre-Val de Loire;18;2;08;266;Touchay;239;6;245
24;Centre-Val de Loire;18;1;17;267;Trouy;3953;116;4069
24;Centre-Val de Loire;18;2;17;268;Uzay-le-Venon;404;10;414
24;Centre-Val de Loire;18;1;16;269;Vailly-sur-Sauldre;652;13;665
24;Centre-Val de Loire;18;2;17;270;Vallenay;717;20;737
24;Centre-Val de Loire;18;1;15;271;Vasselay;1501;34;1535
24;Centre-Val de Loire;18;1;16;272;Veaugues;632;22;654
24;Centre-Val de Loire;18;2;17;273;Venesmes;817;16;833
24;Centre-Val de Loire;18;1;16;274;Verdigny;306;3;309
24;Centre-Val de Loire;18;2;09;275;Vereaux;142;7;149
24;Centre-Val de Loire;18;2;09;276;Vernais;189;1;190
24;Centre-Val de Loire;18;2;09;277;Verneuil;35;0;35
24;Centre-Val de Loire;18;2;08;278;Vesdun;554;10;564
24;Centre-Val de Loire;18;3;99;279;Vierzon;25464;522;25986
24;Centre-Val de Loire;18;1;15;280;Vignoux-sous-les-Aix;717;21;738
24;Centre-Val de Loire;18;3;15;281;Vignoux-sur-Barangeon;2126;38;2164
24;Centre-Val de Loire;18;1;02;282;Villabon;581;12;593
24;Centre-Val de Loire;18;2;08;283;Villecelin;84;0;84
24;Centre-Val de Loire;18;1;16;284;Villegenon;214;4;218
24;Centre-Val de Loire;18;1;07;285;Villeneuve-sur-Cher;420;6;426
24;Centre-Val de Loire;18;1;02;286;Villequiers;464;9;473
24;Centre-Val de Loire;18;1;16;287;Vinon;292;9;301
24;Centre-Val de Loire;18;1;17;288;Vorly;243;7;250
24;Centre-Val de Loire;18;1;02;289;Vornay;591;17;608
24;Centre-Val de Loire;18;3;15;290;Vouzeron;587;10;597
75;Nouvelle-Aquitaine;19;2;15;001;Affieux;359;14;373
75;Nouvelle-Aquitaine;19;3;17;002;Aix;396;8;404
75;Nouvelle-Aquitaine;19;1;10;003;Albignac;239;9;248
75;Nouvelle-Aquitaine;19;2;02;004;Albussac;737;10;747
75;Nouvelle-Aquitaine;19;1;01;005;Allassac;3968;102;4070
75;Nouvelle-Aquitaine;19;3;12;006;Alleyrat;104;0;104
75;Nouvelle-Aquitaine;19;1;02;007;Altillac;840;24;864
75;Nouvelle-Aquitaine;19;3;12;008;Ambrugeat;208;4;212
75;Nouvelle-Aquitaine;19;2;11;009;Les Angles-sur-Corrèze;122;2;124
75;Nouvelle-Aquitaine;19;2;02;010;Argentat-sur-Dordogne;2896;112;3008
75;Nouvelle-Aquitaine;19;1;18;011;Arnac-Pompadour;1136;12;1148
75;Nouvelle-Aquitaine;19;1;10;012;Astaillac;219;5;224
75;Nouvelle-Aquitaine;19;1;10;013;Aubazines;887;21;908
75;Nouvelle-Aquitaine;19;2;02;014;Auriac;225;5;230
75;Nouvelle-Aquitaine;19;1;19;015;Ayen;701;7;708
75;Nouvelle-Aquitaine;19;2;11;016;Bar;304;9;313
75;Nouvelle-Aquitaine;19;2;02;017;Bassignac-le-Bas;87;1;88
75;Nouvelle-Aquitaine;19;2;02;018;Bassignac-le-Haut;158;4;162
75;Nouvelle-Aquitaine;19;1;10;019;Beaulieu-sur-Dordogne;1284;20;1304
75;Nouvelle-Aquitaine;19;2;15;020;Beaumont;110;8;118
75;Nouvelle-Aquitaine;19;3;12;021;Bellechassagne;91;3;94
75;Nouvelle-Aquitaine;19;1;18;022;Benayes;223;5;228
75;Nouvelle-Aquitaine;19;1;10;023;Beynat;1250;20;1270
75;Nouvelle-Aquitaine;19;1;18;024;Beyssac;598;23;621
75;Nouvelle-Aquitaine;19;1;18;025;Beyssenac;359;4;363
75;Nouvelle-Aquitaine;19;1;10;026;Bilhac;250;4;254
75;Nouvelle-Aquitaine;19;2;12;027;Bonnefond;115;0;115
75;Nouvelle-Aquitaine;19;3;08;028;Bort-les-Orgues;2648;100;2748
75;Nouvelle-Aquitaine;19;1;10;029;Branceilles;279;5;284
75;Nouvelle-Aquitaine;19;1;19;030;Brignac-la-Plaine;962;17;979
75;Nouvelle-Aquitaine;19;1;99;031;Brive-la-Gaillarde;46330;1285;47615
75;Nouvelle-Aquitaine;19;3;12;033;Bugeat;793;12;805
75;Nouvelle-Aquitaine;19;2;02;034;Camps-Saint-Mathurin-Léobazel;220;11;231
75;Nouvelle-Aquitaine;19;1;19;035;Chabrignac;547;19;566
75;Nouvelle-Aquitaine;19;2;15;036;Chamberet;1388;15;1403
75;Nouvelle-Aquitaine;19;2;15;037;Chamboulive;1182;28;1210
75;Nouvelle-Aquitaine;19;2;11;038;Chameyrat;1521;54;1575
75;Nouvelle-Aquitaine;19;3;07;039;Champagnac-la-Noaille;227;7;234
75;Nouvelle-Aquitaine;19;2;14;040;Champagnac-la-Prune;155;5;160
75;Nouvelle-Aquitaine;19;2;14;041;Chanac-les-Mines;436;18;454
75;Nouvelle-Aquitaine;19;2;15;042;Chanteix;625;13;638
75;Nouvelle-Aquitaine;19;1;05;043;La Chapelle-aux-Brocs;442;9;451
75;Nouvelle-Aquitaine;19;1;10;044;La Chapelle-aux-Saints;279;10;289
75;Nouvelle-Aquitaine;19;2;02;045;La Chapelle-Saint-Géraud;197;6;203
75;Nouvelle-Aquitaine;19;3;07;046;Chapelle-Spinasse;113;1;114
75;Nouvelle-Aquitaine;19;1;13;047;Chartrier-Ferrière;364;6;370
75;Nouvelle-Aquitaine;19;2;14;048;Le Chastang;356;12;368
75;Nouvelle-Aquitaine;19;1;13;049;Chasteaux;743;20;763
75;Nouvelle-Aquitaine;19;1;10;050;Chauffour-sur-Vell;411;10;421
75;Nouvelle-Aquitaine;19;3;07;051;Chaumeil;163;4;167
75;Nouvelle-Aquitaine;19;3;12;052;Chavanac;50;1;51
75;Nouvelle-Aquitaine;19;3;12;053;Chaveroche;258;4;262
75;Nouvelle-Aquitaine;19;1;10;054;Chenailler-Mascheix;209;4;213
75;Nouvelle-Aquitaine;19;3;08;055;Chirac-Bellevue;292;12;304
75;Nouvelle-Aquitaine;19;2;14;056;Clergoux;405;12;417
75;Nouvelle-Aquitaine;19;1;10;057;Collonges-la-Rouge;483;19;502
75;Nouvelle-Aquitaine;19;3;12;058;Combressol;341;16;357
75;Nouvelle-Aquitaine;19;1;19;059;Concèze;392;9;401
75;Nouvelle-Aquitaine;19;2;18;060;Condat-sur-Ganaveix;688;12;700
75;Nouvelle-Aquitaine;19;2;14;061;Cornil;1308;12;1320
75;Nouvelle-Aquitaine;19;2;11;062;Corrèze;1140;48;1188
75;Nouvelle-Aquitaine;19;1;05;063;Cosnac;2974;79;3053
75;Nouvelle-Aquitaine;19;3;17;064;Couffy-sur-Sarsonne;72;2;74
75;Nouvelle-Aquitaine;19;3;17;065;Courteix;71;0;71
75;Nouvelle-Aquitaine;19;1;13;066;Cublac;1736;36;1772
75;Nouvelle-Aquitaine;19;1;10;067;Curemonte;208;9;217
75;Nouvelle-Aquitaine;19;1;09;068;Dampniat;710;6;716
75;Nouvelle-Aquitaine;19;2;02;069;Darazac;140;3;143
75;Nouvelle-Aquitaine;19;3;12;070;Darnets;336;12;348
75;Nouvelle-Aquitaine;19;3;12;071;Davignac;200;3;203
75;Nouvelle-Aquitaine;19;1;01;072;Donzenac;2678;72;2750
75;Nouvelle-Aquitaine;19;3;07;073;Égletons;4295;731;5026
75;Nouvelle-Aquitaine;19;2;15;074;L'Église-aux-Bois;54;0;54
75;Nouvelle-Aquitaine;19;2;14;075;Espagnac;381;14;395
75;Nouvelle-Aquitaine;19;2;18;076;Espartignac;420;9;429
75;Nouvelle-Aquitaine;19;1;13;077;Estivals;130;2;132
75;Nouvelle-Aquitaine;19;1;01;078;Estivaux;419;8;427
75;Nouvelle-Aquitaine;19;2;18;079;Eyburie;493;10;503
75;Nouvelle-Aquitaine;19;3;17;080;Eygurande;688;12;700
75;Nouvelle-Aquitaine;19;2;14;081;Eyrein;506;15;521
75;Nouvelle-Aquitaine;19;2;11;082;Favars;1097;22;1119
75;Nouvelle-Aquitaine;19;3;17;083;Feyt;134;2;136
75;Nouvelle-Aquitaine;19;2;02;084;Forgès;265;12;277
75;Nouvelle-Aquitaine;19;2;11;085;Gimel-les-Cascades;789;16;805
75;Nouvelle-Aquitaine;19;2;02;086;Goulles;333;6;339
75;Nouvelle-Aquitaine;19;2;12;087;Gourdon-Murat;94;3;97
75;Nouvelle-Aquitaine;19;2;12;088;Grandsaigne;52;1;53
75;Nouvelle-Aquitaine;19;2;14;089;Gros-Chastang;187;3;190
75;Nouvelle-Aquitaine;19;2;14;090;Gumond;94;7;101
75;Nouvelle-Aquitaine;19;2;02;091;Hautefage;317;13;330
75;Nouvelle-Aquitaine;19;3;07;092;Le Jardin;77;1;78
75;Nouvelle-Aquitaine;19;1;13;093;Jugeals-Nazareth;964;34;998
75;Nouvelle-Aquitaine;19;1;19;094;Juillac;1114;26;1140
75;Nouvelle-Aquitaine;19;2;15;095;Lacelle;136;1;137
75;Nouvelle-Aquitaine;19;2;14;096;Ladignac-sur-Rondelles;408;11;419
75;Nouvelle-Aquitaine;19;3;07;097;Lafage-sur-Sombre;134;1;135
75;Nouvelle-Aquitaine;19;2;14;098;Lagarde-Marc-la-Tour;971;21;992
75;Nouvelle-Aquitaine;19;1;10;099;Lagleygeolle;220;10;230
75;Nouvelle-Aquitaine;19;2;15;100;Lagraulière;1097;23;1120
75;Nouvelle-Aquitaine;19;2;14;101;Laguenne-sur-Avalouze;1542;47;1589
75;Nouvelle-Aquitaine;19;3;08;102;Lamazière-Basse;297;2;299
75;Nouvelle-Aquitaine;19;3;17;103;Lamazière-Haute;67;2;69
75;Nouvelle-Aquitaine;19;2;18;104;Lamongerie;115;1;116
75;Nouvelle-Aquitaine;19;1;10;105;Lanteuil;487;14;501
75;Nouvelle-Aquitaine;19;3;07;106;Lapleau;373;2;375
75;Nouvelle-Aquitaine;19;1;13;107;Larche;1617;45;1662
75;Nouvelle-Aquitaine;19;3;17;108;Laroche-près-Feyt;60;2;62
75;Nouvelle-Aquitaine;19;1;19;109;Lascaux;222;7;229
75;Nouvelle-Aquitaine;19;3;08;110;Latronche;132;0;132
75;Nouvelle-Aquitaine;19;3;07;111;Laval-sur-Luzège;99;0;99
75;Nouvelle-Aquitaine;19;2;12;112;Lestards;109;0;109
75;Nouvelle-Aquitaine;19;3;08;113;Liginiac;644;38;682
75;Nouvelle-Aquitaine;19;3;12;114;Lignareix;164;10;174
75;Nouvelle-Aquitaine;19;1;10;115;Ligneyrac;301;8;309
75;Nouvelle-Aquitaine;19;1;10;116;Liourdres;253;5;258
75;Nouvelle-Aquitaine;19;1;13;117;Lissac-sur-Couze;698;21;719
75;Nouvelle-Aquitaine;19;2;15;118;Le Lonzac;810;10;820
75;Nouvelle-Aquitaine;19;1;10;119;Lostanges;147;1;148
75;Nouvelle-Aquitaine;19;1;19;120;Louignac;239;1;240
75;Nouvelle-Aquitaine;19;1;18;121;Lubersac;2236;43;2279
75;Nouvelle-Aquitaine;19;2;15;122;Madranges;192;10;202
75;Nouvelle-Aquitaine;19;1;09;123;Malemort;7984;165;8149
75;Nouvelle-Aquitaine;19;1;13;124;Mansac;1449;22;1471
75;Nouvelle-Aquitaine;19;3;07;125;Marcillac-la-Croisille;784;17;801
75;Nouvelle-Aquitaine;19;1;10;126;Marcillac-la-Croze;172;0;172
75;Nouvelle-Aquitaine;19;3;08;128;Margerides;307;6;313
75;Nouvelle-Aquitaine;19;2;18;129;Masseret;664;8;672
75;Nouvelle-Aquitaine;19;3;12;130;Maussac;442;10;452
75;Nouvelle-Aquitaine;19;2;18;131;Meilhards;538;23;561
75;Nouvelle-Aquitaine;19;1;10;132;Ménoire;130;1;131
75;Nouvelle-Aquitaine;19;2;02;133;Mercœur;242;1;243
75;Nouvelle-Aquitaine;19;3;17;134;Merlines;705;21;726
75;Nouvelle-Aquitaine;19;3;08;135;Mestes;348;6;354
75;Nouvelle-Aquitaine;19;3;12;136;Meymac;2308;202;2510
75;Nouvelle-Aquitaine;19;3;11;137;Meyrignac-l'Église;63;0;63
75;Nouvelle-Aquitaine;19;1;10;138;Meyssac;1264;52;1316
75;Nouvelle-Aquitaine;19;3;12;139;Millevaches;76;1;77
75;Nouvelle-Aquitaine;19;2;02;140;Monceaux-sur-Dordogne;635;19;654
75;Nouvelle-Aquitaine;19;3;17;141;Monestier-Merlines;284;6;290
75;Nouvelle-Aquitaine;19;3;08;142;Monestier-Port-Dieu;98;3;101
75;Nouvelle-Aquitaine;19;3;07;143;Montaignac-Saint-Hippolyte;597;14;611
75;Nouvelle-Aquitaine;19;1;18;144;Montgibaud;235;5;240
75;Nouvelle-Aquitaine;19;3;07;145;Moustier-Ventadour;445;77;522
75;Nouvelle-Aquitaine;19;2;11;146;Naves;2336;213;2549
75;Nouvelle-Aquitaine;19;1;13;147;Nespouls;635;14;649
75;Nouvelle-Aquitaine;19;3;08;148;Neuvic;1659;252;1911
75;Nouvelle-Aquitaine;19;2;02;149;Neuville;200;4;204
75;Nouvelle-Aquitaine;19;1;10;150;Noailhac;363;16;379
75;Nouvelle-Aquitaine;19;1;13;151;Noailles;935;18;953
75;Nouvelle-Aquitaine;19;1;10;152;Nonards;436;8;444
75;Nouvelle-Aquitaine;19;1;19;153;Objat;3624;94;3718
75;Nouvelle-Aquitaine;19;2;01;154;Orgnac-sur-Vézère;318;9;327
75;Nouvelle-Aquitaine;19;2;11;155;Orliac-de-Bar;264;5;269
75;Nouvelle-Aquitaine;19;1;10;156;Palazinges;161;2;163
75;Nouvelle-Aquitaine;19;3;08;157;Palisse;222;2;224
75;Nouvelle-Aquitaine;19;2;14;158;Pandrignes;167;4;171
75;Nouvelle-Aquitaine;19;3;12;159;Péret-Bel-Air;89;1;90
75;Nouvelle-Aquitaine;19;3;12;160;Pérols-sur-Vézère;192;2;194
75;Nouvelle-Aquitaine;19;1;19;161;Perpezac-le-Blanc;464;6;470
75;Nouvelle-Aquitaine;19;2;01;162;Perpezac-le-Noir;1219;17;1236
75;Nouvelle-Aquitaine;19;1;10;163;Le Pescher;292;7;299
75;Nouvelle-Aquitaine;19;3;12;164;Peyrelevade;830;11;841
75;Nouvelle-Aquitaine;19;2;15;165;Peyrissac;122;3;125
75;Nouvelle-Aquitaine;19;2;15;166;Pierrefitte;93;0;93
75;Nouvelle-Aquitaine;19;3;08;167;Confolent-Port-Dieu;43;0;43
75;Nouvelle-Aquitaine;19;2;12;168;Pradines;84;4;88
75;Nouvelle-Aquitaine;19;1;10;169;Puy-d'Arnac;290;4;294
75;Nouvelle-Aquitaine;19;1;10;170;Queyssac-les-Vignes;210;9;219
75;Nouvelle-Aquitaine;19;2;02;171;Reygade;188;3;191
75;Nouvelle-Aquitaine;19;2;15;172;Rilhac-Treignac;113;5;118
75;Nouvelle-Aquitaine;19;2;02;173;Rilhac-Xaintrie;305;11;316
75;Nouvelle-Aquitaine;19;2;14;174;La Roche-Canillac;131;1;132
75;Nouvelle-Aquitaine;19;3;08;175;Roche-le-Peyroux;94;0;94
75;Nouvelle-Aquitaine;19;3;07;176;Rosiers-d'Égletons;1086;34;1120
75;Nouvelle-Aquitaine;19;1;19;177;Rosiers-de-Juillac;176;4;180
75;Nouvelle-Aquitaine;19;1;01;178;Sadroc;966;23;989
75;Nouvelle-Aquitaine;19;1;10;179;Saillac;200;6;206
75;Nouvelle-Aquitaine;19;3;12;180;Saint-Angel;704;18;722
75;Nouvelle-Aquitaine;19;2;11;181;Saint-Augustin;420;7;427
75;Nouvelle-Aquitaine;19;1;19;182;Saint-Aulaire;763;23;786
75;Nouvelle-Aquitaine;19;1;10;184;Saint-Bazile-de-Meyssac;128;4;132
75;Nouvelle-Aquitaine;19;2;02;186;Saint-Bonnet-Elvert;213;4;217
75;Nouvelle-Aquitaine;19;1;19;187;Saint-Bonnet-la-Rivière;402;5;407
75;Nouvelle-Aquitaine;19;1;01;188;Saint-Bonnet-l'Enfantier;413;6;419
75;Nouvelle-Aquitaine;19;2;02;189;Saint-Bonnet-les-Tours-de-Merle;43;1;44
75;Nouvelle-Aquitaine;19;3;08;190;Saint-Bonnet-près-Bort;190;5;195
75;Nouvelle-Aquitaine;19;1;13;191;Saint-Cernin-de-Larche;646;12;658
75;Nouvelle-Aquitaine;19;2;02;192;Saint-Chamant;499;6;505
75;Nouvelle-Aquitaine;19;2;02;193;Saint-Cirgues-la-Loutre;174;5;179
75;Nouvelle-Aquitaine;19;2;15;194;Saint-Clément;1322;36;1358
75;Nouvelle-Aquitaine;19;1;19;195;Saint-Cyprien;379;6;385
75;Nouvelle-Aquitaine;19;1;19;196;Saint-Cyr-la-Roche;481;19;500
75;Nouvelle-Aquitaine;19;1;18;198;Saint-Éloy-les-Tuileries;104;0;104
75;Nouvelle-Aquitaine;19;3;08;199;Saint-Étienne-aux-Clos;240;5;245
75;Nouvelle-Aquitaine;19;3;08;200;Saint-Étienne-la-Geneste;89;8;97
75;Nouvelle-Aquitaine;19;3;08;201;Saint-Exupéry-les-Roches;594;13;607
75;Nouvelle-Aquitaine;19;1;01;202;Sainte-Féréole;2007;44;2051
75;Nouvelle-Aquitaine;19;2;14;203;Sainte-Fortunade;1779;92;1871
75;Nouvelle-Aquitaine;19;3;08;204;Saint-Fréjoux;274;3;277
75;Nouvelle-Aquitaine;19;2;02;205;Saint-Geniez-ô-Merle;88;2;90
75;Nouvelle-Aquitaine;19;3;12;206;Saint-Germain-Lavolps;88;2;90
75;Nouvelle-Aquitaine;19;2;11;207;Saint-Germain-les-Vergnes;1129;32;1161
75;Nouvelle-Aquitaine;19;3;07;208;Saint-Hilaire-Foissac;185;3;188
75;Nouvelle-Aquitaine;19;2;15;209;Saint-Hilaire-les-Courbes;165;2;167
75;Nouvelle-Aquitaine;19;3;08;210;Saint-Hilaire-Luc;66;0;66
75;Nouvelle-Aquitaine;19;2;11;211;Saint-Hilaire-Peyroux;1004;20;1024
75;Nouvelle-Aquitaine;19;2;02;212;Saint-Hilaire-Taurieux;104;6;110
75;Nouvelle-Aquitaine;19;2;15;213;Saint-Jal;624;17;641
75;Nouvelle-Aquitaine;19;2;02;214;Saint-Julien-aux-Bois;452;3;455
75;Nouvelle-Aquitaine;19;2;02;215;Saint-Julien-le-Pèlerin;122;2;124
75;Nouvelle-Aquitaine;19;1;18;216;Saint-Julien-le-Vendômois;247;3;250
75;Nouvelle-Aquitaine;19;1;10;217;Saint-Julien-Maumont;154;5;159
75;Nouvelle-Aquitaine;19;3;08;219;Sainte-Marie-Lapanouze;55;1;56
75;Nouvelle-Aquitaine;19;2;14;220;Saint-Martial-de-Gimel;481;10;491
75;Nouvelle-Aquitaine;19;2;02;221;Saint-Martial-Entraygues;87;2;89
75;Nouvelle-Aquitaine;19;2;14;222;Saint-Martin-la-Méanne;340;12;352
75;Nouvelle-Aquitaine;19;1;18;223;Saint-Martin-Sepert;268;2;270
75;Nouvelle-Aquitaine;19;3;07;225;Saint-Merd-de-Lapleau;171;2;173
75;Nouvelle-Aquitaine;19;3;12;226;Saint-Merd-les-Oussines;129;3;132
75;Nouvelle-Aquitaine;19;2;11;227;Saint-Mexant;1319;35;1354
75;Nouvelle-Aquitaine;19;3;08;228;Saint-Pantaléon-de-Lapleau;67;1;68
75;Nouvelle-Aquitaine;19;1;13;229;Saint-Pantaléon-de-Larche;4751;92;4843
75;Nouvelle-Aquitaine;19;1;18;230;Saint-Pardoux-Corbier;399;8;407
75;Nouvelle-Aquitaine;19;2;14;231;Saint-Pardoux-la-Croisille;177;2;179
75;Nouvelle-Aquitaine;19;3;17;232;Saint-Pardoux-le-Neuf;77;2;79
75;Nouvelle-Aquitaine;19;3;12;233;Saint-Pardoux-le-Vieux;295;14;309
75;Nouvelle-Aquitaine;19;1;01;234;Saint-Pardoux-l'Ortigier;480;6;486
75;Nouvelle-Aquitaine;19;2;14;235;Saint-Paul;234;6;240
75;Nouvelle-Aquitaine;19;2;14;236;Saint-Priest-de-Gimel;482;10;492
75;Nouvelle-Aquitaine;19;2;02;237;Saint-Privat;1056;22;1078
75;Nouvelle-Aquitaine;19;3;12;238;Saint-Rémy;222;8;230
75;Nouvelle-Aquitaine;19;1;19;239;Saint-Robert;295;7;302
75;Nouvelle-Aquitaine;19;2;15;240;Saint-Salvadour;290;14;304
75;Nouvelle-Aquitaine;19;3;12;241;Saint-Setiers;285;6;291
75;Nouvelle-Aquitaine;19;1;19;242;Saint-Solve;458;17;475
75;Nouvelle-Aquitaine;19;1;18;243;Saint-Sornin-Lavolps;851;17;868
75;Nouvelle-Aquitaine;19;3;12;244;Saint-Sulpice-les-Bois;85;1;86
75;Nouvelle-Aquitaine;19;2;02;245;Saint-Sylvain;133;5;138
75;Nouvelle-Aquitaine;19;1;01;246;Saint-Viance;1877;42;1919
75;Nouvelle-Aquitaine;19;3;08;247;Saint-Victour;194;8;202
75;Nouvelle-Aquitaine;19;2;18;248;Saint-Ybard;701;13;714
75;Nouvelle-Aquitaine;19;3;07;249;Saint-Yrieix-le-Déjalat;342;9;351
75;Nouvelle-Aquitaine;19;2;18;250;Salon-la-Tour;670;6;676
75;Nouvelle-Aquitaine;19;3;07;251;Sarran;275;7;282
75;Nouvelle-Aquitaine;19;3;08;252;Sarroux - Saint Julien;845;16;861
75;Nouvelle-Aquitaine;19;1;19;253;Segonzac;223;2;225
75;Nouvelle-Aquitaine;19;1;18;254;Ségur-le-Château;193;1;194
75;Nouvelle-Aquitaine;19;2;15;255;Seilhac;1778;37;1815
75;Nouvelle-Aquitaine;19;3;08;256;Sérandon;346;6;352
75;Nouvelle-Aquitaine;19;1;10;257;Sérilhac;272;7;279
75;Nouvelle-Aquitaine;19;2;02;258;Servières-le-Château;608;10;618
75;Nouvelle-Aquitaine;19;2;02;259;Sexcles;234;4;238
75;Nouvelle-Aquitaine;19;1;10;260;Sioniac;217;7;224
75;Nouvelle-Aquitaine;19;3;12;261;Sornac;746;15;761
75;Nouvelle-Aquitaine;19;2;15;262;Soudaine-Lavinadière;155;16;171
75;Nouvelle-Aquitaine;19;3;12;263;Soudeilles;294;11;305
75;Nouvelle-Aquitaine;19;3;07;264;Soursac;506;4;510
75;Nouvelle-Aquitaine;19;2;12;265;Tarnac;344;8;352
75;Nouvelle-Aquitaine;19;3;08;266;Thalamy;98;4;102
75;Nouvelle-Aquitaine;19;2;12;268;Toy-Viam;38;0;38
75;Nouvelle-Aquitaine;19;2;15;269;Treignac;1297;80;1377
75;Nouvelle-Aquitaine;19;1;01;270;Troche;551;6;557
75;Nouvelle-Aquitaine;19;1;10;271;Tudeils;241;3;244
75;Nouvelle-Aquitaine;19;2;16;272;Tulle;14812;663;15475
75;Nouvelle-Aquitaine;19;1;13;273;Turenne;811;20;831
75;Nouvelle-Aquitaine;19;1;09;274;Ussac;4215;115;4330
75;Nouvelle-Aquitaine;19;3;17;275;Ussel;9358;368;9726
75;Nouvelle-Aquitaine;19;2;18;276;Uzerche;2794;59;2853
75;Nouvelle-Aquitaine;19;3;08;277;Valiergues;143;5;148
75;Nouvelle-Aquitaine;19;1;09;278;Varetz;2457;43;2500
75;Nouvelle-Aquitaine;19;1;19;279;Vars-sur-Roseix;387;10;397
75;Nouvelle-Aquitaine;19;1;10;280;Végennes;180;4;184
75;Nouvelle-Aquitaine;19;2;15;281;Veix;72;7;79
75;Nouvelle-Aquitaine;19;3;08;283;Veyrières;75;1;76
75;Nouvelle-Aquitaine;19;2;12;284;Viam;87;3;90
75;Nouvelle-Aquitaine;19;2;01;285;Vigeois;1255;29;1284
75;Nouvelle-Aquitaine;19;1;19;286;Vignols;535;9;544
75;Nouvelle-Aquitaine;19;2;07;287;Vitrac-sur-Montane;270;6;276
75;Nouvelle-Aquitaine;19;1;19;288;Voutezac;1242;164;1406
75;Nouvelle-Aquitaine;19;1;19;289;Yssandon;668;8;676
27;Bourgogne-Franche-Comté;21;1;20;001;Agencourt;462;52;514
27;Bourgogne-Franche-Comté;21;2;23;002;Agey;266;3;269
27;Bourgogne-Franche-Comté;21;2;14;003;Ahuy;1464;27;1491
27;Bourgogne-Franche-Comté;21;3;05;004;Aignay-le-Duc;269;7;276
27;Bourgogne-Franche-Comté;21;2;15;005;Aiserey;1470;17;1487
27;Bourgogne-Franche-Comté;21;3;05;006;Aisey-sur-Seine;172;1;173
27;Bourgogne-Franche-Comté;21;3;22;007;Aisy-sous-Thil;226;30;256
27;Bourgogne-Franche-Comté;21;3;19;008;Alise-Sainte-Reine;572;7;579
27;Bourgogne-Franche-Comté;21;1;01;009;Allerey;175;1;176
27;Bourgogne-Franche-Comté;21;1;17;010;Aloxe-Corton;136;6;142
27;Bourgogne-Franche-Comté;21;3;05;011;Ampilly-les-Bordes;82;0;82
27;Bourgogne-Franche-Comté;21;3;05;012;Ampilly-le-Sec;344;13;357
27;Bourgogne-Franche-Comté;21;2;23;013;Ancey;450;7;457
27;Bourgogne-Franche-Comté;21;1;01;014;Antheuil;62;0;62
27;Bourgogne-Franche-Comté;21;1;01;015;Antigny-la-Ville;92;0;92
27;Bourgogne-Franche-Comté;21;2;21;016;Arceau;966;19;985
27;Bourgogne-Franche-Comté;21;1;20;017;Arcenant;507;18;525
27;Bourgogne-Franche-Comté;21;2;23;018;Arcey;54;1;55
27;Bourgogne-Franche-Comté;21;1;01;020;Arconcey;224;8;232
27;Bourgogne-Franche-Comté;21;2;21;021;Arc-sur-Tille;2629;49;2678
27;Bourgogne-Franche-Comté;21;1;20;022;Argilly;536;13;549
27;Bourgogne-Franche-Comté;21;1;01;023;Arnay-le-Duc;1384;31;1415
27;Bourgogne-Franche-Comté;21;3;22;024;Arnay-sous-Vitteaux;111;0;111
27;Bourgogne-Franche-Comté;21;3;19;025;Arrans;67;2;69
27;Bourgogne-Franche-Comté;21;3;19;026;Asnières-en-Montagne;189;9;198
27;Bourgogne-Franche-Comté;21;2;14;027;Asnières-lès-Dijon;1312;26;1338
27;Bourgogne-Franche-Comté;21;2;02;028;Athée;781;10;791
27;Bourgogne-Franche-Comté;21;3;19;029;Athie;76;1;77
27;Bourgogne-Franche-Comté;21;1;01;030;Aubaine;88;3;91
27;Bourgogne-Franche-Comté;21;1;04;031;Aubigny-en-Plaine;529;5;534
27;Bourgogne-Franche-Comté;21;1;01;032;Aubigny-la-Ronce;167;5;172
27;Bourgogne-Franche-Comté;21;2;23;033;Aubigny-lès-Sombernon;151;5;156
27;Bourgogne-Franche-Comté;21;3;05;034;Autricourt;131;2;133
27;Bourgogne-Franche-Comté;21;1;04;035;Auvillars-sur-Saône;331;4;335
27;Bourgogne-Franche-Comté;21;1;01;036;Auxant;78;3;81
27;Bourgogne-Franche-Comté;21;1;17;037;Auxey-Duresses;297;12;309
27;Bourgogne-Franche-Comté;21;2;02;038;Auxonne;7614;85;7699
27;Bourgogne-Franche-Comté;21;2;16;039;Avelanges;37;0;37
27;Bourgogne-Franche-Comté;21;3;22;040;Avosnes;95;5;100
27;Bourgogne-Franche-Comté;21;2;16;041;Avot;184;2;186
27;Bourgogne-Franche-Comté;21;1;04;042;Bagnot;161;4;165
27;Bourgogne-Franche-Comté;21;3;05;043;Baigneux-les-Juifs;223;19;242
27;Bourgogne-Franche-Comté;21;3;05;044;Balot;99;1;100
27;Bourgogne-Franche-Comté;21;2;23;045;Barbirey-sur-Ouche;211;8;219
27;Bourgogne-Franche-Comté;21;1;01;046;Bard-le-Régulier;70;2;72
27;Bourgogne-Franche-Comté;21;3;22;047;Bard-lès-Époisses;69;1;70
27;Bourgogne-Franche-Comté;21;1;20;048;Barges;651;10;661
27;Bourgogne-Franche-Comté;21;2;16;049;Barjon;42;2;44
27;Bourgogne-Franche-Comté;21;1;01;050;Baubigny;207;6;213
27;Bourgogne-Franche-Comté;21;2;23;051;Baulme-la-Roche;85;3;88
27;Bourgogne-Franche-Comté;21;3;05;052;Beaulieu;25;4;29
27;Bourgogne-Franche-Comté;21;2;21;053;Beaumont-sur-Vingeanne;202;4;206
27;Bourgogne-Franche-Comté;21;1;03;054;Beaune;20551;759;21310
27;Bourgogne-Franche-Comté;21;3;05;055;Beaunotte;15;0;15
27;Bourgogne-Franche-Comté;21;2;21;056;Beire-le-Châtel;875;10;885
27;Bourgogne-Franche-Comté;21;2;15;057;Beire-le-Fort;352;5;357
27;Bourgogne-Franche-Comté;21;3;05;058;Belan-sur-Ource;248;5;253
27;Bourgogne-Franche-Comté;21;2;14;059;Bellefond;885;24;909
27;Bourgogne-Franche-Comté;21;2;21;060;Belleneuve;1618;18;1636
27;Bourgogne-Franche-Comté;21;3;05;061;Bellenod-sur-Seine;67;2;69
27;Bourgogne-Franche-Comté;21;1;01;062;Bellenot-sous-Pouilly;220;9;229
27;Bourgogne-Franche-Comté;21;3;05;063;Beneuvre;90;5;95
27;Bourgogne-Franche-Comté;21;3;19;064;Benoisey;112;0;112
27;Bourgogne-Franche-Comté;21;1;01;065;Bessey-en-Chaume;127;4;131
27;Bourgogne-Franche-Comté;21;1;01;066;Bessey-la-Cour;53;1;54
27;Bourgogne-Franche-Comté;21;2;15;067;Bessey-lès-Cîteaux;689;9;698
27;Bourgogne-Franche-Comté;21;1;01;068;Beurey-Bauguay;104;7;111
27;Bourgogne-Franche-Comté;21;3;22;069;Beurizot;121;1;122
27;Bourgogne-Franche-Comté;21;1;18;070;Bévy;139;4;143
27;Bourgogne-Franche-Comté;21;2;21;071;Bèze;701;20;721
27;Bourgogne-Franche-Comté;21;2;21;072;Bézouotte;193;4;197
27;Bourgogne-Franche-Comté;21;2;02;074;Billey;255;4;259
27;Bourgogne-Franche-Comté;21;3;05;075;Billy-lès-Chanceaux;68;1;69
27;Bourgogne-Franche-Comté;21;2;02;076;Binges;827;8;835
27;Bourgogne-Franche-Comté;21;3;05;077;Bissey-la-Côte;127;2;129
27;Bourgogne-Franche-Comté;21;3;05;078;Bissey-la-Pierre;76;2;78
27;Bourgogne-Franche-Comté;21;2;21;079;Blagny-sur-Vingeanne;130;0;130
27;Bourgogne-Franche-Comté;21;2;23;080;Blaisy-Bas;647;13;660
27;Bourgogne-Franche-Comté;21;2;23;081;Blaisy-Haut;128;1;129
27;Bourgogne-Franche-Comté;21;1;01;082;Blancey;64;2;66
27;Bourgogne-Franche-Comté;21;1;01;083;Blanot;124;1;125
27;Bourgogne-Franche-Comté;21;3;19;084;Source-Seine;63;4;67
27;Bourgogne-Franche-Comté;21;2;14;085;Bligny-le-Sec;140;3;143
27;Bourgogne-Franche-Comté;21;1;17;086;Bligny-lès-Beaune;1239;29;1268
27;Bourgogne-Franche-Comté;21;1;01;087;Bligny-sur-Ouche;811;11;822
27;Bourgogne-Franche-Comté;21;1;20;088;Boncourt-le-Bois;281;7;288
27;Bourgogne-Franche-Comté;21;1;04;089;Bonnencontre;437;6;443
27;Bourgogne-Franche-Comté;21;3;05;090;Boudreville;61;3;64
27;Bourgogne-Franche-Comté;21;1;01;091;Bouhey;44;0;44
27;Bourgogne-Franche-Comté;21;1;17;092;Bouilland;222;5;227
27;Bourgogne-Franche-Comté;21;3;05;093;Bouix;152;4;156
27;Bourgogne-Franche-Comté;21;2;21;094;Bourberain;411;4;415
27;Bourgogne-Franche-Comté;21;1;04;095;Bousselange;47;1;48
27;Bourgogne-Franche-Comté;21;2;16;096;Boussenois;107;1;108
27;Bourgogne-Franche-Comté;21;3;22;097;Boussey;38;2;40
27;Bourgogne-Franche-Comté;21;3;19;098;Boux-sous-Salmaise;125;2;127
27;Bourgogne-Franche-Comté;21;1;17;099;Bouze-lès-Beaune;311;6;317
27;Bourgogne-Franche-Comté;21;3;22;100;Brain;34;0;34
27;Bourgogne-Franche-Comté;21;3;22;101;Braux;166;4;170
27;Bourgogne-Franche-Comté;21;1;01;102;Brazey-en-Morvan;142;3;145
27;Bourgogne-Franche-Comté;21;1;04;103;Brazey-en-Plaine;2357;43;2400
27;Bourgogne-Franche-Comté;21;3;05;104;Brémur-et-Vaurois;44;0;44
27;Bourgogne-Franche-Comté;21;2;07;105;Bressey-sur-Tille;1127;12;1139
27;Bourgogne-Franche-Comté;21;2;18;106;Bretenière;929;12;941
27;Bourgogne-Franche-Comté;21;2;14;107;Bretigny;904;24;928
27;Bourgogne-Franche-Comté;21;3;22;108;Brianny;114;1;115
27;Bourgogne-Franche-Comté;21;3;05;109;Brion-sur-Ource;223;7;230
27;Bourgogne-Franche-Comté;21;1;18;110;Brochon;652;131;783
27;Bourgogne-Franche-Comté;21;2;14;111;Brognon;317;3;320
27;Bourgogne-Franche-Comté;21;1;04;112;Broin;415;9;424
27;Bourgogne-Franche-Comté;21;1;20;113;Broindon;198;1;199
27;Bourgogne-Franche-Comté;21;3;19;114;Buffon;159;1;160
27;Bourgogne-Franche-Comté;21;3;05;115;Buncey;369;7;376
27;Bourgogne-Franche-Comté;21;3;05;116;Bure-les-Templiers;134;0;134
27;Bourgogne-Franche-Comté;21;3;05;117;Busseaut;48;2;50
27;Bourgogne-Franche-Comté;21;2;16;118;Busserotte-et-Montenaille;21;3;24
27;Bourgogne-Franche-Comté;21;2;16;119;Bussières;43;0;43
27;Bourgogne-Franche-Comté;21;1;01;120;La Bussière-sur-Ouche;160;2;162
27;Bourgogne-Franche-Comté;21;2;23;121;Bussy-la-Pesle;78;1;79
27;Bourgogne-Franche-Comté;21;3;19;122;Bussy-le-Grand;315;8;323
27;Bourgogne-Franche-Comté;21;3;05;123;Buxerolles;32;5;37
27;Bourgogne-Franche-Comté;21;1;01;124;Censerey;175;6;181
27;Bourgogne-Franche-Comté;21;3;05;125;Cérilly;222;8;230
27;Bourgogne-Franche-Comté;21;2;15;126;Cessey-sur-Tille;617;7;624
27;Bourgogne-Franche-Comté;21;2;16;127;Chaignay;524;8;532
27;Bourgogne-Franche-Comté;21;1;01;128;Chailly-sur-Armançon;242;11;253
27;Bourgogne-Franche-Comté;21;3;05;129;Chambain;22;0;22
27;Bourgogne-Franche-Comté;21;2;15;130;Chambeire;392;4;396
27;Bourgogne-Franche-Comté;21;1;04;131;Chamblanc;464;63;527
27;Bourgogne-Franche-Comté;21;1;18;132;Chambœuf;392;6;398
27;Bourgogne-Franche-Comté;21;1;18;133;Chambolle-Musigny;293;7;300
27;Bourgogne-Franche-Comté;21;3;05;134;Chamesson;242;9;251
27;Bourgogne-Franche-Comté;21;2;21;135;Champagne-sur-Vingeanne;311;8;319
27;Bourgogne-Franche-Comté;21;2;14;136;Champagny;26;0;26
27;Bourgogne-Franche-Comté;21;3;19;137;Champ-d'Oiseau;99;1;100
27;Bourgogne-Franche-Comté;21;2;02;138;Champdôtre;597;8;605
27;Bourgogne-Franche-Comté;21;3;22;139;Champeau-en-Morvan;224;5;229
27;Bourgogne-Franche-Comté;21;1;01;140;Champignolles;75;1;76
27;Bourgogne-Franche-Comté;21;3;22;141;Champrenault;35;1;36
27;Bourgogne-Franche-Comté;21;2;16;142;Chanceaux;213;4;217
27;Bourgogne-Franche-Comté;21;3;05;143;Channay;63;3;66
27;Bourgogne-Franche-Comté;21;3;19;144;Charencey;37;0;37
27;Bourgogne-Franche-Comté;21;3;22;145;Charigny;37;1;38
27;Bourgogne-Franche-Comté;21;2;21;146;Charmes;127;3;130
27;Bourgogne-Franche-Comté;21;3;22;147;Charny;35;1;36
27;Bourgogne-Franche-Comté;21;1;04;148;Charrey-sur-Saône;346;1;347
27;Bourgogne-Franche-Comté;21;3;05;149;Charrey-sur-Seine;140;4;144
27;Bourgogne-Franche-Comté;21;1;17;150;Chassagne-Montrachet;300;11;311
27;Bourgogne-Franche-Comté;21;3;22;151;Chassey;87;5;92
27;Bourgogne-Franche-Comté;21;1;01;152;Châteauneuf;79;2;81
27;Bourgogne-Franche-Comté;21;1;01;153;Châtellenot;155;6;161
27;Bourgogne-Franche-Comté;21;3;05;154;Châtillon-sur-Seine;5347;350;5697
27;Bourgogne-Franche-Comté;21;1;01;155;Chaudenay-la-Ville;41;6;47
27;Bourgogne-Franche-Comté;21;1;01;156;Chaudenay-le-Château;49;0;49
27;Bourgogne-Franche-Comté;21;3;05;157;Chaugey;16;0;16
27;Bourgogne-Franche-Comté;21;2;21;158;Chaume-et-Courchamp;179;5;184
27;Bourgogne-Franche-Comté;21;3;05;159;La Chaume;99;4;103
27;Bourgogne-Franche-Comté;21;3;05;160;Chaume-lès-Baigneux;99;1;100
27;Bourgogne-Franche-Comté;21;3;05;161;Chaumont-le-Bois;79;5;84
27;Bourgogne-Franche-Comté;21;1;20;162;Chaux;483;8;491
27;Bourgogne-Franche-Comté;21;2;16;163;Chazeuil;192;5;197
27;Bourgogne-Franche-Comté;21;1;01;164;Chazilly;143;3;146
27;Bourgogne-Franche-Comté;21;3;05;165;Chemin-d'Aisey;74;4;78
27;Bourgogne-Franche-Comté;21;2;06;166;Chenôve;14025;191;14216
27;Bourgogne-Franche-Comté;21;2;21;167;Cheuge;123;4;127
27;Bourgogne-Franche-Comté;21;3;22;168;Chevannay;40;0;40
27;Bourgogne-Franche-Comté;21;1;18;169;Chevannes;161;4;165
27;Bourgogne-Franche-Comté;21;1;17;170;Chevigny-en-Valière;378;5;383
27;Bourgogne-Franche-Comté;21;2;07;171;Chevigny-Saint-Sauveur;11123;210;11333
27;Bourgogne-Franche-Comté;21;1;04;172;Chivres;304;6;310
27;Bourgogne-Franche-Comté;21;1;17;173;Chorey-les-Beaune;639;15;654
27;Bourgogne-Franche-Comté;21;2;02;175;Cirey-lès-Pontailler;193;1;194
27;Bourgogne-Franche-Comté;21;1;01;176;Civry-en-Montagne;123;2;125
27;Bourgogne-Franche-Comté;21;3;22;177;Clamerey;180;1;181
27;Bourgogne-Franche-Comté;21;1;18;178;Valforêt;306;10;316
27;Bourgogne-Franche-Comté;21;2;14;179;Clénay;898;10;908
27;Bourgogne-Franche-Comté;21;2;02;180;Cléry;153;4;157
27;Bourgogne-Franche-Comté;21;1;01;181;Clomot;141;2;143
27;Bourgogne-Franche-Comté;21;1;18;182;Collonges-lès-Bévy;95;1;96
27;Bourgogne-Franche-Comté;21;2;15;183;Collonges-et-Premières;1055;13;1068
27;Bourgogne-Franche-Comté;21;1;01;184;Colombier;70;0;70
27;Bourgogne-Franche-Comté;21;1;17;185;Combertault;529;20;549
27;Bourgogne-Franche-Comté;21;1;20;186;Comblanchien;616;17;633
27;Bourgogne-Franche-Comté;21;1;01;187;Commarin;123;4;127
27;Bourgogne-Franche-Comté;21;1;17;189;Corberon;436;9;445
27;Bourgogne-Franche-Comté;21;1;17;190;Corcelles-les-Arts;442;19;461
27;Bourgogne-Franche-Comté;21;1;20;191;Corcelles-lès-Cîteaux;811;24;835
27;Bourgogne-Franche-Comté;21;2;13;192;Corcelles-les-Monts;625;10;635
27;Bourgogne-Franche-Comté;21;1;17;193;Corgengoux;366;16;382
27;Bourgogne-Franche-Comté;21;1;20;194;Corgoloin;936;12;948
27;Bourgogne-Franche-Comté;21;1;01;195;Cormot-Vauchignon;219;4;223
27;Bourgogne-Franche-Comté;21;1;17;196;Corpeau;977;16;993
27;Bourgogne-Franche-Comté;21;3;19;197;Corpoyer-la-Chapelle;32;0;32
27;Bourgogne-Franche-Comté;21;3;22;198;Corrombles;255;3;258
27;Bourgogne-Franche-Comté;21;3;22;199;Corsaint;160;2;162
27;Bourgogne-Franche-Comté;21;1;18;200;Couchey;1110;25;1135
27;Bourgogne-Franche-Comté;21;3;05;201;Coulmier-le-Sec;247;5;252
27;Bourgogne-Franche-Comté;21;3;05;202;Courban;148;1;149
27;Bourgogne-Franche-Comté;21;3;22;203;Courcelles-Frémoy;122;2;124
27;Bourgogne-Franche-Comté;21;3;19;204;Courcelles-lès-Montbard;86;1;87
27;Bourgogne-Franche-Comté;21;3;22;205;Courcelles-lès-Semur;240;6;246
27;Bourgogne-Franche-Comté;21;2;16;207;Courlon;79;4;83
27;Bourgogne-Franche-Comté;21;2;16;208;Courtivron;166;4;170
27;Bourgogne-Franche-Comté;21;2;21;209;Couternon;1912;41;1953
27;Bourgogne-Franche-Comté;21;1;01;210;Créancey;526;5;531
27;Bourgogne-Franche-Comté;21;2;16;211;Crécey-sur-Tille;131;2;133
27;Bourgogne-Franche-Comté;21;3;19;212;Crépand;322;4;326
27;Bourgogne-Franche-Comté;21;1;01;214;Crugey;170;4;174
27;Bourgogne-Franche-Comté;21;2;21;215;Cuiserey;185;0;185
27;Bourgogne-Franche-Comté;21;1;01;216;Culètre;105;2;107
27;Bourgogne-Franche-Comté;21;1;18;217;Curley;133;4;137
27;Bourgogne-Franche-Comté;21;2;14;218;Curtil-Saint-Seine;116;0;116
27;Bourgogne-Franche-Comté;21;1;18;219;Curtil-Vergy;141;0;141
27;Bourgogne-Franche-Comté;21;2;16;220;Cussey-les-Forges;144;3;147
27;Bourgogne-Franche-Comté;21;1;01;221;Cussy-la-Colonne;40;2;42
27;Bourgogne-Franche-Comté;21;1;01;222;Cussy-le-Châtel;118;3;121
27;Bourgogne-Franche-Comté;21;2;14;223;Daix;1537;36;1573
27;Bourgogne-Franche-Comté;21;3;22;224;Dampierre-en-Montagne;65;4;69
27;Bourgogne-Franche-Comté;21;2;21;225;Dampierre-et-Flée;131;2;133
27;Bourgogne-Franche-Comté;21;3;19;226;Darcey;343;11;354
27;Bourgogne-Franche-Comté;21;2;14;227;Darois;505;7;512
27;Bourgogne-Franche-Comté;21;1;18;228;Détain-et-Bruant;143;0;143
27;Bourgogne-Franche-Comté;21;1;01;229;Diancey;91;2;93
27;Bourgogne-Franche-Comté;21;2;16;230;Diénay;377;8;385
27;Bourgogne-Franche-Comté;21;2;99;231;Dijon;158002;3378;161380
27;Bourgogne-Franche-Comté;21;3;22;232;Dompierre-en-Morvan;203;5;208
27;Bourgogne-Franche-Comté;21;2;02;233;Drambon;200;1;201
27;Bourgogne-Franche-Comté;21;2;23;234;Drée;61;3;64
27;Bourgogne-Franche-Comté;21;3;05;235;Duesme;53;1;54
27;Bourgogne-Franche-Comté;21;1;17;236;Ébaty;253;6;259
27;Bourgogne-Franche-Comté;21;3;05;237;Échalot;95;3;98
27;Bourgogne-Franche-Comté;21;2;23;238;Échannay;132;2;134
27;Bourgogne-Franche-Comté;21;1;04;239;Échenon;781;11;792
27;Bourgogne-Franche-Comté;21;2;16;240;Échevannes;313;2;315
27;Bourgogne-Franche-Comté;21;1;17;241;Échevronne;292;16;308
27;Bourgogne-Franche-Comté;21;2;15;242;Échigey;298;4;302
27;Bourgogne-Franche-Comté;21;1;01;243;Écutigny;73;4;77
27;Bourgogne-Franche-Comté;21;1;01;244;Éguilly;67;0;67
27;Bourgogne-Franche-Comté;21;2;16;245;Épagny;318;3;321
27;Bourgogne-Franche-Comté;21;1;20;246;Épernay-sous-Gevrey;182;3;185
27;Bourgogne-Franche-Comté;21;3;22;247;Époisses;798;13;811
27;Bourgogne-Franche-Comté;21;3;19;248;Éringes;61;1;62
27;Bourgogne-Franche-Comté;21;1;04;249;Esbarres;677;20;697
27;Bourgogne-Franche-Comté;21;3;05;250;Essarois;86;2;88
27;Bourgogne-Franche-Comté;21;1;01;251;Essey;280;27;307
27;Bourgogne-Franche-Comté;21;3;19;252;Étais;79;4;83
27;Bourgogne-Franche-Comté;21;3;05;253;Étalante;138;4;142
27;Bourgogne-Franche-Comté;21;1;18;254;L'Étang-Vergy;208;10;218
27;Bourgogne-Franche-Comté;21;2;14;255;Étaules;325;3;328
27;Bourgogne-Franche-Comté;21;2;02;256;Étevaux;314;7;321
27;Bourgogne-Franche-Comté;21;3;05;257;Étormay;68;2;70
27;Bourgogne-Franche-Comté;21;3;05;258;Étrochey;225;3;228
27;Bourgogne-Franche-Comté;21;3;19;259;Fain-lès-Montbard;287;10;297
27;Bourgogne-Franche-Comté;21;3;19;260;Fain-lès-Moutiers;152;4;156
27;Bourgogne-Franche-Comté;21;2;15;261;Fauverney;619;11;630
27;Bourgogne-Franche-Comté;21;3;05;262;Faverolles-lès-Lucey;30;0;30
27;Bourgogne-Franche-Comté;21;2;18;263;Fénay;1660;41;1701
27;Bourgogne-Franche-Comté;21;1;01;264;Le Fête;43;0;43
27;Bourgogne-Franche-Comté;21;1;18;265;Fixin;750;21;771
27;Bourgogne-Franche-Comté;21;2;14;266;Flacey;192;1;193
27;Bourgogne-Franche-Comté;21;1;20;267;Flagey-Echézeaux;495;13;508
27;Bourgogne-Franche-Comté;21;2;02;268;Flagey-lès-Auxonne;190;3;193
27;Bourgogne-Franche-Comté;21;2;02;269;Flammerans;445;9;454
27;Bourgogne-Franche-Comté;21;2;13;270;Flavignerot;206;7;213
27;Bourgogne-Franche-Comté;21;3;19;271;Flavigny-sur-Ozerain;283;3;286
27;Bourgogne-Franche-Comté;21;3;22;272;Le Val-Larrey;267;4;271
27;Bourgogne-Franche-Comté;21;2;23;273;Fleurey-sur-Ouche;1402;18;1420
27;Bourgogne-Franche-Comté;21;1;01;274;Foissy;165;3;168
27;Bourgogne-Franche-Comté;21;2;16;275;Foncegrive;133;3;136
27;Bourgogne-Franche-Comté;21;3;05;276;Fontaines-en-Duesmois;118;4;122
27;Bourgogne-Franche-Comté;21;2;21;277;Fontaine-Française;886;19;905
27;Bourgogne-Franche-Comté;21;2;14;278;Fontaine-lès-Dijon;8800;204;9004
27;Bourgogne-Franche-Comté;21;3;19;279;Fontaines-les-Sèches;25;0;25
27;Bourgogne-Franche-Comté;21;3;22;280;Fontangy;133;6;139
27;Bourgogne-Franche-Comté;21;2;21;281;Fontenelle;170;2;172
27;Bourgogne-Franche-Comté;21;3;22;282;Forléans;101;2;103
27;Bourgogne-Franche-Comté;21;2;16;283;Fraignot-et-Vesvrotte;65;1;66
27;Bourgogne-Franche-Comté;21;2;16;284;Francheville;292;4;296
27;Bourgogne-Franche-Comté;21;1;04;285;Franxault;497;5;502
27;Bourgogne-Franche-Comté;21;2;16;286;Frénois;88;1;89
27;Bourgogne-Franche-Comté;21;3;19;287;Fresnes;159;7;166
27;Bourgogne-Franche-Comté;21;3;19;288;Frôlois;162;1;163
27;Bourgogne-Franche-Comté;21;1;20;289;Fussey;118;8;126
27;Bourgogne-Franche-Comté;21;2;16;290;Gemeaux;901;13;914
27;Bourgogne-Franche-Comté;21;3;22;291;Genay;365;10;375
27;Bourgogne-Franche-Comté;21;2;15;292;Genlis;5231;44;5275
27;Bourgogne-Franche-Comté;21;2;23;293;Gergueil;118;0;118
27;Bourgogne-Franche-Comté;21;1;20;294;Gerland;433;5;438
27;Bourgogne-Franche-Comté;21;1;18;295;Gevrey-Chambertin;3048;41;3089
27;Bourgogne-Franche-Comté;21;3;05;296;Gevrolles;177;1;178
27;Bourgogne-Franche-Comté;21;1;20;297;Gilly-lès-Cîteaux;720;6;726
27;Bourgogne-Franche-Comté;21;3;22;298;Gissey-le-Vieil;108;3;111
27;Bourgogne-Franche-Comté;21;3;19;299;Gissey-sous-Flavigny;88;1;89
27;Bourgogne-Franche-Comté;21;2;23;300;Gissey-sur-Ouche;354;9;363
27;Bourgogne-Franche-Comté;21;1;04;301;Glanon;267;2;269
27;Bourgogne-Franche-Comté;21;3;05;302;Gomméville;124;2;126
27;Bourgogne-Franche-Comté;21;3;05;303;Les Goulles;9;0;9
27;Bourgogne-Franche-Comté;21;2;16;304;Grancey-le-Château-Neuvelle;255;9;264
27;Bourgogne-Franche-Comté;21;3;05;305;Grancey-sur-Ource;196;2;198
27;Bourgogne-Franche-Comté;21;2;23;306;Grenant-lès-Sombernon;210;3;213
27;Bourgogne-Franche-Comté;21;3;19;307;Grésigny-Sainte-Reine;142;2;144
27;Bourgogne-Franche-Comté;21;3;19;308;Grignon;203;12;215
27;Bourgogne-Franche-Comté;21;3;05;309;Griselles;83;3;86
27;Bourgogne-Franche-Comté;21;2;23;310;Grosbois-en-Montagne;113;2;115
27;Bourgogne-Franche-Comté;21;1;04;311;Grosbois-lès-Tichey;73;1;74
27;Bourgogne-Franche-Comté;21;3;05;312;Gurgy-la-Ville;26;3;29
27;Bourgogne-Franche-Comté;21;3;05;313;Gurgy-le-Château;46;0;46
27;Bourgogne-Franche-Comté;21;3;19;314;Hauteroche;79;2;81
27;Bourgogne-Franche-Comté;21;2;14;315;Hauteville-lès-Dijon;1227;16;1243
27;Bourgogne-Franche-Comté;21;2;02;316;Heuilley-sur-Saône;327;5;332
27;Bourgogne-Franche-Comté;21;2;16;317;Is-sur-Tille;4405;57;4462
27;Bourgogne-Franche-Comté;21;2;15;319;Izeure;894;13;907
27;Bourgogne-Franche-Comté;21;2;15;320;Izier;790;14;804
27;Bourgogne-Franche-Comté;21;3;19;321;Jailly-les-Moulins;77;2;79
27;Bourgogne-Franche-Comté;21;1;04;322;Jallanges;313;14;327
27;Bourgogne-Franche-Comté;21;2;21;323;Jancigny;138;4;142
27;Bourgogne-Franche-Comté;21;3;22;324;Jeux-lès-Bard;51;1;52
27;Bourgogne-Franche-Comté;21;1;01;325;Jouey;183;2;185
27;Bourgogne-Franche-Comté;21;3;05;326;Jours-lès-Baigneux;73;4;77
27;Bourgogne-Franche-Comté;21;1;01;327;Val-Mont;255;4;259
27;Bourgogne-Franche-Comté;21;3;22;328;Juillenay;47;0;47
27;Bourgogne-Franche-Comté;21;3;22;329;Juilly;42;2;44
27;Bourgogne-Franche-Comté;21;2;15;330;Labergement-Foigney;373;3;376
27;Bourgogne-Franche-Comté;21;2;02;331;Labergement-lès-Auxonne;330;4;334
27;Bourgogne-Franche-Comté;21;1;04;332;Labergement-lès-Seurre;996;22;1018
27;Bourgogne-Franche-Comté;21;1;04;333;Labruyère;228;5;233
27;Bourgogne-Franche-Comté;21;1;01;334;Lacanche;512;12;524
27;Bourgogne-Franche-Comté;21;3;22;335;Lacour-d'Arcenay;115;3;118
27;Bourgogne-Franche-Comté;21;3;05;336;Laignes;673;13;686
27;Bourgogne-Franche-Comté;21;2;02;337;Lamarche-sur-Saône;1350;13;1363
27;Bourgogne-Franche-Comté;21;2;16;338;Lamargelle;163;3;166
27;Bourgogne-Franche-Comté;21;2;23;339;Lantenay;511;19;530
27;Bourgogne-Franche-Comté;21;1;04;340;Lanthes;250;5;255
27;Bourgogne-Franche-Comté;21;3;22;341;Lantilly;105;4;109
27;Bourgogne-Franche-Comté;21;1;04;342;Laperrière-sur-Saône;437;9;446
27;Bourgogne-Franche-Comté;21;3;05;343;Larrey;95;1;96
27;Bourgogne-Franche-Comté;21;1;04;344;Lechâtelet;216;5;221
27;Bourgogne-Franche-Comté;21;2;16;345;Léry;188;3;191
27;Bourgogne-Franche-Comté;21;3;05;346;Leuglay;299;3;302
27;Bourgogne-Franche-Comté;21;1;17;347;Levernois;337;17;354
27;Bourgogne-Franche-Comté;21;2;21;348;Licey-sur-Vingeanne;102;1;103
27;Bourgogne-Franche-Comté;21;1;01;349;Liernais;491;8;499
27;Bourgogne-Franche-Comté;21;3;05;350;Lignerolles;54;1;55
27;Bourgogne-Franche-Comté;21;2;15;351;Longchamp;1164;120;1284
27;Bourgogne-Franche-Comté;21;2;15;352;Longeault-Pluvault;1137;16;1153
27;Bourgogne-Franche-Comté;21;2;15;353;Longecourt-en-Plaine;1237;27;1264
27;Bourgogne-Franche-Comté;21;1;01;354;Longecourt-lès-Culêtre;53;0;53
27;Bourgogne-Franche-Comté;21;2;18;355;Longvic;8545;127;8672
27;Bourgogne-Franche-Comté;21;1;04;356;Losne;1596;36;1632
27;Bourgogne-Franche-Comté;21;3;05;357;Louesme;113;3;116
27;Bourgogne-Franche-Comté;21;3;19;358;Lucenay-le-Duc;183;4;187
27;Bourgogne-Franche-Comté;21;3;05;359;Lucey;58;3;61
27;Bourgogne-Franche-Comté;21;1;01;360;Lusigny-sur-Ouche;116;3;119
27;Bourgogne-Franche-Comté;21;2;16;361;Lux;516;12;528
27;Bourgogne-Franche-Comté;21;1;01;362;Maconge;132;3;135
27;Bourgogne-Franche-Comté;21;1;01;363;Magnien;318;6;324
27;Bourgogne-Franche-Comté;21;3;05;364;Magny-Lambert;83;3;86
27;Bourgogne-Franche-Comté;21;3;22;365;Magny-la-Ville;79;0;79
27;Bourgogne-Franche-Comté;21;1;04;366;Magny-lès-Aubigny;214;3;217
27;Bourgogne-Franche-Comté;21;2;02;367;Magny-Montarlot;260;2;262
27;Bourgogne-Franche-Comté;21;1;20;368;Magny-lès-Villers;244;13;257
27;Bourgogne-Franche-Comté;21;2;21;369;Magny-Saint-Médard;316;4;320
27;Bourgogne-Franche-Comté;21;2;07;370;Magny-sur-Tille;902;18;920
27;Bourgogne-Franche-Comté;21;2;02;371;Les Maillys;808;19;827
27;Bourgogne-Franche-Comté;21;3;05;372;Maisey-le-Duc;83;5;88
27;Bourgogne-Franche-Comté;21;2;23;373;Mâlain;783;15;798
27;Bourgogne-Franche-Comté;21;1;01;374;Maligny;191;6;197
27;Bourgogne-Franche-Comté;21;1;01;375;Manlay;187;5;192
27;Bourgogne-Franche-Comté;21;2;02;376;Marandeuil;104;1;105
27;Bourgogne-Franche-Comté;21;3;22;377;Marcellois;47;0;47
27;Bourgogne-Franche-Comté;21;3;05;378;Marcenay;93;2;95
27;Bourgogne-Franche-Comté;21;1;01;379;Marcheseuil;160;1;161
27;Bourgogne-Franche-Comté;21;3;22;380;Marcigny-sous-Thil;56;2;58
27;Bourgogne-Franche-Comté;21;3;22;381;Marcilly-et-Dracy;92;4;96
27;Bourgogne-Franche-Comté;21;1;01;382;Marcilly-Ogny;192;3;195
27;Bourgogne-Franche-Comté;21;2;16;383;Marcilly-sur-Tille;1688;21;1709
27;Bourgogne-Franche-Comté;21;1;20;384;Marey-lès-Fussey;56;5;61
27;Bourgogne-Franche-Comté;21;2;16;385;Marey-sur-Tille;325;8;333
27;Bourgogne-Franche-Comté;21;3;19;386;Marigny-le-Cahouët;323;12;335
27;Bourgogne-Franche-Comté;21;1;17;387;Marigny-lès-Reullée;220;5;225
27;Bourgogne-Franche-Comté;21;2;15;388;Marliens;596;11;607
27;Bourgogne-Franche-Comté;21;3;19;389;Marmagne;207;1;208
27;Bourgogne-Franche-Comté;21;2;06;390;Marsannay-la-Côte;5311;76;5387
27;Bourgogne-Franche-Comté;21;2;16;391;Marsannay-le-Bois;843;10;853
27;Bourgogne-Franche-Comté;21;1;01;392;Martrois;60;1;61
27;Bourgogne-Franche-Comté;21;3;05;393;Massingy;153;8;161
27;Bourgogne-Franche-Comté;21;3;22;394;Massingy-lès-Semur;158;4;162
27;Bourgogne-Franche-Comté;21;3;22;395;Massingy-lès-Vitteaux;91;1;92
27;Bourgogne-Franche-Comté;21;3;05;396;Mauvilly;69;2;71
27;Bourgogne-Franche-Comté;21;1;17;397;Mavilly-Mandelot;179;3;182
27;Bourgogne-Franche-Comté;21;2;02;398;Maxilly-sur-Saône;361;8;369
27;Bourgogne-Franche-Comté;21;1;01;399;Meilly-sur-Rouvres;213;2;215
27;Bourgogne-Franche-Comté;21;2;16;400;Le Meix;48;0;48
27;Bourgogne-Franche-Comté;21;1;17;401;Meloisey;320;5;325
27;Bourgogne-Franche-Comté;21;3;05;402;Menesble;9;0;9
27;Bourgogne-Franche-Comté;21;1;01;403;Ménessaire;86;1;87
27;Bourgogne-Franche-Comté;21;3;19;404;Ménétreux-le-Pitois;420;16;436
27;Bourgogne-Franche-Comté;21;1;17;405;Merceuil;807;22;829
27;Bourgogne-Franche-Comté;21;2;23;406;Mesmont;248;2;250
27;Bourgogne-Franche-Comté;21;1;18;407;Messanges;236;11;247
27;Bourgogne-Franche-Comté;21;2;14;408;Messigny-et-Vantoux;1690;29;1719
27;Bourgogne-Franche-Comté;21;1;20;409;Meuilley;462;13;475
27;Bourgogne-Franche-Comté;21;3;05;410;Meulson;30;2;32
27;Bourgogne-Franche-Comté;21;1;17;411;Meursanges;567;18;585
27;Bourgogne-Franche-Comté;21;1;17;412;Meursault;1408;45;1453
27;Bourgogne-Franche-Comté;21;3;22;413;Millery;397;15;412
27;Bourgogne-Franche-Comté;21;1;01;414;Mimeure;315;9;324
27;Bourgogne-Franche-Comté;21;3;05;415;Minot;178;5;183
27;Bourgogne-Franche-Comté;21;2;21;416;Mirebeau-sur-Bèze;2008;37;2045
27;Bourgogne-Franche-Comté;21;3;22;417;Missery;108;0;108
27;Bourgogne-Franche-Comté;21;3;05;418;Moitron;59;4;63
27;Bourgogne-Franche-Comté;21;3;05;419;Molesme;264;5;269
27;Bourgogne-Franche-Comté;21;1;01;420;Molinot;161;3;164
27;Bourgogne-Franche-Comté;21;2;16;421;Moloy;233;3;236
27;Bourgogne-Franche-Comté;21;3;22;422;Molphey;130;4;134
27;Bourgogne-Franche-Comté;21;1;17;423;Montagny-lès-Beaune;747;23;770
27;Bourgogne-Franche-Comté;21;1;04;424;Montagny-lès-Seurre;111;2;113
27;Bourgogne-Franche-Comté;21;3;19;425;Montbard;4848;132;4980
27;Bourgogne-Franche-Comté;21;3;22;426;Montberthault;206;3;209
27;Bourgogne-Franche-Comté;21;1;01;427;Montceau-et-Écharnant;188;5;193
27;Bourgogne-Franche-Comté;21;1;17;428;Monthelie;166;4;170
27;Bourgogne-Franche-Comté;21;3;19;429;Montigny-Montfort;296;6;302
27;Bourgogne-Franche-Comté;21;3;22;430;Montigny-Saint-Barthélemy;85;5;90
27;Bourgogne-Franche-Comté;21;3;22;431;Montigny-sur-Armançon;147;5;152
27;Bourgogne-Franche-Comté;21;3;05;432;Montigny-sur-Aube;253;4;257
27;Bourgogne-Franche-Comté;21;2;21;433;Montigny-Mornay-Villeneuve-sur-Vingeanne;386;7;393
27;Bourgogne-Franche-Comté;21;3;22;434;Montlay-en-Auxois;192;1;193
27;Bourgogne-Franche-Comté;21;3;05;435;Montliot-et-Courcelles;301;6;307
27;Bourgogne-Franche-Comté;21;1;04;436;Montmain;156;3;159
27;Bourgogne-Franche-Comté;21;2;02;437;Montmançon;243;5;248
27;Bourgogne-Franche-Comté;21;3;05;438;Montmoyen;74;3;77
27;Bourgogne-Franche-Comté;21;2;23;439;Montoillot;88;0;88
27;Bourgogne-Franche-Comté;21;1;04;440;Montot;194;5;199
27;Bourgogne-Franche-Comté;21;1;01;441;Mont-Saint-Jean;239;7;246
27;Bourgogne-Franche-Comté;21;1;18;442;Morey-Saint-Denis;664;11;675
27;Bourgogne-Franche-Comté;21;3;05;444;Mosson;69;0;69
27;Bourgogne-Franche-Comté;21;3;22;445;La Motte-Ternant;144;2;146
27;Bourgogne-Franche-Comté;21;3;19;446;Moutiers-Saint-Jean;261;5;266
27;Bourgogne-Franche-Comté;21;1;01;447;Musigny;81;0;81
27;Bourgogne-Franche-Comté;21;3;19;448;Mussy-la-Fosse;87;1;88
27;Bourgogne-Franche-Comté;21;3;22;449;Nan-sous-Thil;182;3;185
27;Bourgogne-Franche-Comté;21;1;17;450;Nantoux;166;5;171
27;Bourgogne-Franche-Comté;21;3;19;451;Nesle-et-Massoult;76;3;79
27;Bourgogne-Franche-Comté;21;2;07;452;Neuilly-Crimolois;3036;34;3070
27;Bourgogne-Franche-Comté;21;3;05;454;Nicey;111;0;111
27;Bourgogne-Franche-Comté;21;3;05;455;Nod-sur-Seine;199;8;207
27;Bourgogne-Franche-Comté;21;3;19;456;Nogent-lès-Montbard;153;8;161
27;Bourgogne-Franche-Comté;21;3;22;457;Noidan;73;5;78
27;Bourgogne-Franche-Comté;21;1;20;458;Noiron-sous-Gevrey;1153;16;1169
27;Bourgogne-Franche-Comté;21;2;21;459;Noiron-sur-Bèze;233;5;238
27;Bourgogne-Franche-Comté;21;3;05;460;Noiron-sur-Seine;65;1;66
27;Bourgogne-Franche-Comté;21;1;01;461;Nolay;1435;22;1457
27;Bourgogne-Franche-Comté;21;2;14;462;Norges-la-Ville;948;18;966
27;Bourgogne-Franche-Comté;21;3;22;463;Normier;56;1;57
27;Bourgogne-Franche-Comté;21;1;20;464;Nuits-Saint-Georges;5362;91;5453
27;Bourgogne-Franche-Comté;21;3;05;465;Obtrée;77;1;78
27;Bourgogne-Franche-Comté;21;3;05;466;Oigny;40;4;44
27;Bourgogne-Franche-Comté;21;2;21;467;Oisilly;128;4;132
27;Bourgogne-Franche-Comté;21;2;21;468;Orain;88;1;89
27;Bourgogne-Franche-Comté;21;2;14;469;Orgeux;459;13;472
27;Bourgogne-Franche-Comté;21;3;05;470;Origny;51;3;54
27;Bourgogne-Franche-Comté;21;3;05;471;Orret;15;0;15
27;Bourgogne-Franche-Comté;21;2;16;472;Orville;170;1;171
27;Bourgogne-Franche-Comté;21;2;18;473;Ouges;1604;11;1615
27;Bourgogne-Franche-Comté;21;1;04;474;Pagny-la-Ville;415;11;426
27;Bourgogne-Franche-Comté;21;1;04;475;Pagny-le-Château;506;10;516
27;Bourgogne-Franche-Comté;21;1;01;476;Painblanc;163;5;168
27;Bourgogne-Franche-Comté;21;2;14;477;Panges;83;2;85
27;Bourgogne-Franche-Comté;21;2;23;478;Pasques;285;5;290
27;Bourgogne-Franche-Comté;21;2;16;479;Pellerey;90;1;91
27;Bourgogne-Franche-Comté;21;1;17;480;Pernand-Vergelesses;236;9;245
27;Bourgogne-Franche-Comté;21;2;18;481;Perrigny-lès-Dijon;2138;33;2171
27;Bourgogne-Franche-Comté;21;2;02;482;Perrigny-sur-l'Ognon;635;15;650
27;Bourgogne-Franche-Comté;21;2;16;483;Pichanges;294;5;299
27;Bourgogne-Franche-Comté;21;3;19;484;Planay;65;5;70
27;Bourgogne-Franche-Comté;21;2;23;485;Plombières-lès-Dijon;2542;46;2588
27;Bourgogne-Franche-Comté;21;2;15;487;Pluvet;411;3;414
27;Bourgogne-Franche-Comté;21;3;05;488;Poinçon-lès-Larrey;192;2;194
27;Bourgogne-Franche-Comté;21;2;16;489;Poiseul-la-Grange;55;4;59
27;Bourgogne-Franche-Comté;21;3;05;490;Poiseul-la-Ville-et-Laperrière;157;7;164
27;Bourgogne-Franche-Comté;21;2;16;491;Poiseul-lès-Saulx;69;1;70
27;Bourgogne-Franche-Comté;21;1;17;492;Pommard;454;12;466
27;Bourgogne-Franche-Comté;21;2;02;493;Poncey-lès-Athée;571;7;578
27;Bourgogne-Franche-Comté;21;2;16;494;Poncey-sur-l'Ignon;83;0;83
27;Bourgogne-Franche-Comté;21;2;02;495;Pont;155;1;156
27;Bourgogne-Franche-Comté;21;2;02;496;Pontailler-sur-Saône;1301;20;1321
27;Bourgogne-Franche-Comté;21;3;22;497;Pont-et-Massène;173;15;188
27;Bourgogne-Franche-Comté;21;3;22;498;Posanges;49;2;51
27;Bourgogne-Franche-Comté;21;3;05;499;Pothières;203;4;207
27;Bourgogne-Franche-Comté;21;3;19;500;Pouillenay;551;9;560
27;Bourgogne-Franche-Comté;21;1;01;501;Pouilly-en-Auxois;1537;119;1656
27;Bourgogne-Franche-Comté;21;1;04;502;Pouilly-sur-Saône;602;7;609
27;Bourgogne-Franche-Comté;21;2;21;503;Pouilly-sur-Vingeanne;132;4;136
27;Bourgogne-Franche-Comté;21;2;23;504;Prâlon;91;3;94
27;Bourgogne-Franche-Comté;21;3;22;505;Précy-sous-Thil;710;10;720
27;Bourgogne-Franche-Comté;21;1;20;506;Premeaux-Prissey;373;5;378
27;Bourgogne-Franche-Comté;21;2;14;508;Prenois;446;8;454
27;Bourgogne-Franche-Comté;21;3;05;510;Prusly-sur-Ource;155;1;156
27;Bourgogne-Franche-Comté;21;3;05;511;Puits;128;4;132
27;Bourgogne-Franche-Comté;21;1;17;512;Puligny-Montrachet;383;10;393
27;Bourgogne-Franche-Comté;21;3;05;514;Quemigny-sur-Seine;102;3;105
27;Bourgogne-Franche-Comté;21;2;07;515;Quetigny;9099;381;9480
27;Bourgogne-Franche-Comté;21;3;19;516;Quincerot;77;4;81
27;Bourgogne-Franche-Comté;21;1;20;517;Quincey;507;12;519
27;Bourgogne-Franche-Comté;21;3;19;518;Quincy-le-Vicomte;204;2;206
27;Bourgogne-Franche-Comté;21;3;05;519;Recey-sur-Ource;351;8;359
27;Bourgogne-Franche-Comté;21;2;23;520;Remilly-en-Montagne;151;0;151
27;Bourgogne-Franche-Comté;21;2;21;521;Remilly-sur-Tille;892;11;903
27;Bourgogne-Franche-Comté;21;2;21;522;Renève;447;5;452
27;Bourgogne-Franche-Comté;21;1;18;523;Reulle-Vergy;150;2;152
27;Bourgogne-Franche-Comté;21;3;05;524;Riel-les-Eaux;92;0;92
27;Bourgogne-Franche-Comté;21;3;22;525;La Roche-en-Brenil;889;14;903
27;Bourgogne-Franche-Comté;21;3;05;526;Rochefort-sur-Brévon;41;0;41
27;Bourgogne-Franche-Comté;21;1;01;527;La Rochepot;285;9;294
27;Bourgogne-Franche-Comté;21;3;19;528;La Roche-Vanneau;141;2;143
27;Bourgogne-Franche-Comté;21;3;22;529;Roilly;49;1;50
27;Bourgogne-Franche-Comté;21;3;19;530;Rougemont;149;1;150
27;Bourgogne-Franche-Comté;21;3;22;531;Rouvray;484;5;489
27;Bourgogne-Franche-Comté;21;2;15;532;Rouvres-en-Plaine;1155;11;1166
27;Bourgogne-Franche-Comté;21;1;01;533;Rouvres-sous-Meilly;87;3;90
27;Bourgogne-Franche-Comté;21;1;17;534;Ruffey-lès-Beaune;731;42;773
27;Bourgogne-Franche-Comté;21;2;14;535;Ruffey-lès-Echirey;1328;10;1338
27;Bourgogne-Franche-Comté;21;2;16;536;Sacquenay;291;11;302
27;Bourgogne-Franche-Comté;21;3;22;537;Saffres;115;2;117
27;Bourgogne-Franche-Comté;21;3;22;538;Saint-Andeux;118;4;122
27;Bourgogne-Franche-Comté;21;2;23;539;Saint-Anthot;56;1;57
27;Bourgogne-Franche-Comté;21;2;21;540;Saint-Apollinaire;7546;101;7647
27;Bourgogne-Franche-Comté;21;1;17;541;Saint-Aubin;221;8;229
27;Bourgogne-Franche-Comté;21;1;20;542;Saint-Bernard;450;0;450
27;Bourgogne-Franche-Comté;21;3;05;543;Saint-Broing-les-Moines;193;8;201
27;Bourgogne-Franche-Comté;21;3;22;544;Sainte-Colombe-en-Auxois;58;6;64
27;Bourgogne-Franche-Comté;21;3;05;545;Sainte-Colombe-sur-Seine;929;15;944
27;Bourgogne-Franche-Comté;21;3;22;546;Saint-Didier;207;4;211
27;Bourgogne-Franche-Comté;21;3;22;547;Saint-Euphrône;199;3;202
27;Bourgogne-Franche-Comté;21;3;22;548;Saint-Germain-de-Modéon;182;3;185
27;Bourgogne-Franche-Comté;21;3;05;549;Saint-Germain-le-Rocheux;82;4;86
27;Bourgogne-Franche-Comté;21;3;19;550;Saint-Germain-lès-Senailly;131;5;136
27;Bourgogne-Franche-Comté;21;3;22;552;Saint-Hélier;36;1;37
27;Bourgogne-Franche-Comté;21;2;23;553;Saint-Jean-de-Bœuf;109;3;112
27;Bourgogne-Franche-Comté;21;1;04;554;Saint-Jean-de-Losne;1063;7;1070
27;Bourgogne-Franche-Comté;21;2;14;555;Saint-Julien;1500;21;1521
27;Bourgogne-Franche-Comté;21;2;02;556;Saint-Léger-Triey;243;3;246
27;Bourgogne-Franche-Comté;21;3;05;557;Saint-Marc-sur-Seine;109;3;112
27;Bourgogne-Franche-Comté;21;1;17;558;Sainte-Marie-la-Blanche;900;31;931
27;Bourgogne-Franche-Comté;21;2;23;559;Sainte-Marie-sur-Ouche;692;11;703
27;Bourgogne-Franche-Comté;21;1;01;560;Saint-Martin-de-la-Mer;300;2;302
27;Bourgogne-Franche-Comté;21;2;14;561;Saint-Martin-du-Mont;453;1;454
27;Bourgogne-Franche-Comté;21;2;21;562;Saint-Maurice-sur-Vingeanne;198;6;204
27;Bourgogne-Franche-Comté;21;3;22;563;Saint-Mesmin;121;2;123
27;Bourgogne-Franche-Comté;21;1;20;564;Saint-Nicolas-lès-Cîteaux;407;9;416
27;Bourgogne-Franche-Comté;21;1;20;565;Saint-Philibert;508;8;516
27;Bourgogne-Franche-Comté;21;1;01;566;Saint-Pierre-en-Vaux;142;3;145
27;Bourgogne-Franche-Comté;21;1;01;567;Saint-Prix-lès-Arnay;215;5;220
27;Bourgogne-Franche-Comté;21;3;19;568;Saint-Rémy;691;11;702
27;Bourgogne-Franche-Comté;21;1;17;569;Saint-Romain;220;6;226
27;Bourgogne-Franche-Comté;21;1;01;570;Sainte-Sabine;169;16;185
27;Bourgogne-Franche-Comté;21;2;02;571;Saint-Sauveur;238;2;240
27;Bourgogne-Franche-Comté;21;1;04;572;Saint-Seine-en-Bâche;399;5;404
27;Bourgogne-Franche-Comté;21;2;14;573;Saint-Seine-l'Abbaye;372;3;375
27;Bourgogne-Franche-Comté;21;2;21;574;Saint-Seine-sur-Vingeanne;386;9;395
27;Bourgogne-Franche-Comté;21;1;04;575;Saint-Symphorien-sur-Saône;344;4;348
27;Bourgogne-Franche-Comté;21;3;22;576;Saint-Thibault;161;4;165
27;Bourgogne-Franche-Comté;21;1;04;577;Saint-Usage;1344;25;1369
27;Bourgogne-Franche-Comté;21;2;23;578;Saint-Victor-sur-Ouche;322;4;326
27;Bourgogne-Franche-Comté;21;2;16;579;Salives;208;6;214
27;Bourgogne-Franche-Comté;21;3;19;580;Salmaise;135;2;137
27;Bourgogne-Franche-Comté;21;1;04;581;Samerey;145;2;147
27;Bourgogne-Franche-Comté;21;1;17;582;Santenay;908;12;920
27;Bourgogne-Franche-Comté;21;1;01;583;Santosse;55;2;57
27;Bourgogne-Franche-Comté;21;3;22;584;Saulieu;2372;109;2481
27;Bourgogne-Franche-Comté;21;1;20;585;Saulon-la-Chapelle;969;14;983
27;Bourgogne-Franche-Comté;21;1;20;586;Saulon-la-Rue;718;10;728
27;Bourgogne-Franche-Comté;21;2;16;587;Saulx-le-Duc;246;4;250
27;Bourgogne-Franche-Comté;21;1;01;588;Saussey;68;1;69
27;Bourgogne-Franche-Comté;21;2;14;589;Saussy;102;1;103
27;Bourgogne-Franche-Comté;21;1;17;590;Savigny-lès-Beaune;1288;41;1329
27;Bourgogne-Franche-Comté;21;2;14;591;Savigny-le-Sec;861;14;875
27;Bourgogne-Franche-Comté;21;2;23;592;Savigny-sous-Mâlain;228;11;239
27;Bourgogne-Franche-Comté;21;1;01;593;Savilly;79;1;80
27;Bourgogne-Franche-Comté;21;3;05;594;Savoisy;193;3;196
27;Bourgogne-Franche-Comté;21;2;21;595;Savolles;163;4;167
27;Bourgogne-Franche-Comté;21;1;20;596;Savouges;385;6;391
27;Bourgogne-Franche-Comté;21;1;18;597;Segrois;53;1;54
27;Bourgogne-Franche-Comté;21;3;19;598;Seigny;174;2;176
27;Bourgogne-Franche-Comté;21;2;16;599;Selongey;2407;34;2441
27;Bourgogne-Franche-Comté;21;1;01;600;Semarey;124;4;128
27;Bourgogne-Franche-Comté;21;1;18;601;Semezanges;96;4;100
27;Bourgogne-Franche-Comté;21;3;05;602;Semond;26;0;26
27;Bourgogne-Franche-Comté;21;3;22;603;Semur-en-Auxois;4120;353;4473
27;Bourgogne-Franche-Comté;21;3;19;604;Senailly;140;4;144
27;Bourgogne-Franche-Comté;21;2;07;605;Sennecey-lès-Dijon;1966;52;2018
27;Bourgogne-Franche-Comté;21;1;17;606;Ladoix-Serrigny;1809;46;1855
27;Bourgogne-Franche-Comté;21;1;04;607;Seurre;2310;22;2332
27;Bourgogne-Franche-Comté;21;3;22;608;Sincey-lès-Rouvray;98;4;102
27;Bourgogne-Franche-Comté;21;2;02;609;Soirans;497;7;504
27;Bourgogne-Franche-Comté;21;2;02;610;Soissons-sur-Nacey;362;7;369
27;Bourgogne-Franche-Comté;21;2;23;611;Sombernon;915;13;928
27;Bourgogne-Franche-Comté;21;3;22;612;Souhey;87;1;88
27;Bourgogne-Franche-Comté;21;3;22;613;Soussey-sur-Brionne;157;8;165
27;Bourgogne-Franche-Comté;21;2;16;614;Spoy;399;4;403
27;Bourgogne-Franche-Comté;21;1;01;615;Sussey;241;8;249
27;Bourgogne-Franche-Comté;21;1;17;616;Tailly;190;7;197
27;Bourgogne-Franche-Comté;21;2;23;617;Talant;11713;226;11939
27;Bourgogne-Franche-Comté;21;2;02;618;Talmay;579;8;587
27;Bourgogne-Franche-Comté;21;2;21;619;Tanay;218;6;224
27;Bourgogne-Franche-Comté;21;2;16;620;Tarsul;159;5;164
27;Bourgogne-Franche-Comté;21;2;15;622;Tart-le-Bas;255;4;259
27;Bourgogne-Franche-Comté;21;2;15;623;Tart;1578;34;1612
27;Bourgogne-Franche-Comté;21;2;02;624;Tellecey;141;1;142
27;Bourgogne-Franche-Comté;21;1;18;625;Ternant;81;3;84
27;Bourgogne-Franche-Comté;21;3;05;626;Terrefondrée;60;2;62
27;Bourgogne-Franche-Comté;21;3;19;627;Thenissey;95;9;104
27;Bourgogne-Franche-Comté;21;3;05;628;Thoires;65;0;65
27;Bourgogne-Franche-Comté;21;3;22;629;Thoisy-la-Berchère;305;5;310
27;Bourgogne-Franche-Comté;21;1;01;630;Thoisy-le-Désert;213;8;221
27;Bourgogne-Franche-Comté;21;1;01;631;Thomirey;54;0;54
27;Bourgogne-Franche-Comté;21;2;15;632;Thorey-en-Plaine;1040;31;1071
27;Bourgogne-Franche-Comté;21;3;22;633;Thorey-sous-Charny;188;1;189
27;Bourgogne-Franche-Comté;21;1;01;634;Thorey-sur-Ouche;137;0;137
27;Bourgogne-Franche-Comté;21;3;22;635;Thoste;104;6;110
27;Bourgogne-Franche-Comté;21;1;01;636;Thury;254;8;262
27;Bourgogne-Franche-Comté;21;1;04;637;Tichey;213;3;216
27;Bourgogne-Franche-Comté;21;2;16;638;Til-Châtel;1138;7;1145
27;Bourgogne-Franche-Comté;21;2;02;639;Tillenay;746;14;760
27;Bourgogne-Franche-Comté;21;3;22;640;Torcy-et-Pouligny;215;5;220
27;Bourgogne-Franche-Comté;21;3;19;641;Touillon;457;12;469
27;Bourgogne-Franche-Comté;21;3;22;642;Toutry;423;8;431
27;Bourgogne-Franche-Comté;21;2;02;643;Tréclun;445;8;453
27;Bourgogne-Franche-Comté;21;2;21;644;Trochères;170;4;174
27;Bourgogne-Franche-Comté;21;1;04;645;Trouhans;598;16;614
27;Bourgogne-Franche-Comté;21;2;14;646;Trouhaut;123;3;126
27;Bourgogne-Franche-Comté;21;1;04;647;Trugny;119;1;120
27;Bourgogne-Franche-Comté;21;2;14;648;Turcey;175;1;176
27;Bourgogne-Franche-Comté;21;3;22;649;Uncey-le-Franc;53;0;53
27;Bourgogne-Franche-Comté;21;1;18;650;Urcy;149;4;153
27;Bourgogne-Franche-Comté;21;2;14;651;Val-Suzon;202;4;206
27;Bourgogne-Franche-Comté;21;1;01;652;Vandenesse-en-Auxois;297;7;304
27;Bourgogne-Franche-Comté;21;3;05;653;Vannaire;51;2;53
27;Bourgogne-Franche-Comté;21;3;05;655;Vanvey;232;10;242
27;Bourgogne-Franche-Comté;21;2;15;656;Varanges;697;11;708
27;Bourgogne-Franche-Comté;21;2;21;657;Varois-et-Chaignot;1944;49;1993
27;Bourgogne-Franche-Comté;21;2;16;659;Vaux-Saules;168;10;178
27;Bourgogne-Franche-Comté;21;1;01;660;Veilly;49;1;50
27;Bourgogne-Franche-Comté;21;2;23;661;Velars-sur-Ouche;1744;26;1770
27;Bourgogne-Franche-Comté;21;3;22;662;Velogny;33;0;33
27;Bourgogne-Franche-Comté;21;3;19;663;Venarey-les-Laumes;2846;37;2883
27;Bourgogne-Franche-Comté;21;3;19;664;Verdonnet;82;4;86
27;Bourgogne-Franche-Comté;21;2;16;665;Vernois-lès-Vesvres;170;0;170
27;Bourgogne-Franche-Comté;21;2;16;666;Vernot;94;3;97
27;Bourgogne-Franche-Comté;21;2;16;667;Véronnes;399;7;406
27;Bourgogne-Franche-Comté;21;2;23;669;Verrey-sous-Drée;81;0;81
27;Bourgogne-Franche-Comté;21;3;19;670;Verrey-sous-Salmaise;281;4;285
27;Bourgogne-Franche-Comté;21;3;05;671;Vertault;52;1;53
27;Bourgogne-Franche-Comté;21;3;22;672;Vesvres;28;1;29
27;Bourgogne-Franche-Comté;21;1;01;673;Veuvey-sur-Ouche;215;2;217
27;Bourgogne-Franche-Comté;21;3;05;674;Veuxhaulles-sur-Aube;201;3;204
27;Bourgogne-Franche-Comté;21;1;01;675;Vianges;39;1;40
27;Bourgogne-Franche-Comté;21;3;22;676;Vic-de-Chassenay;215;5;220
27;Bourgogne-Franche-Comté;21;1;01;677;Vic-des-Prés;116;1;117
27;Bourgogne-Franche-Comté;21;3;22;678;Vic-sous-Thil;185;3;188
27;Bourgogne-Franche-Comté;21;2;23;679;Vieilmoulin;129;2;131
27;Bourgogne-Franche-Comté;21;2;02;680;Vielverge;504;7;511
27;Bourgogne-Franche-Comté;21;3;22;681;Vieux-Château;86;1;87
27;Bourgogne-Franche-Comté;21;2;21;682;Viévigne;269;1;270
27;Bourgogne-Franche-Comté;21;1;01;683;Viévy;356;3;359
27;Bourgogne-Franche-Comté;21;1;17;684;Vignoles;951;49;1000
27;Bourgogne-Franche-Comté;21;3;05;685;Villaines-en-Duesmois;252;6;258
27;Bourgogne-Franche-Comté;21;3;19;686;Villaines-les-Prévôtes;144;2;146
27;Bourgogne-Franche-Comté;21;3;22;687;Villargoix;139;5;144
27;Bourgogne-Franche-Comté;21;1;20;688;Villars-Fontaine;113;4;117
27;Bourgogne-Franche-Comté;21;3;22;689;Villars-et-Villenotte;168;7;175
27;Bourgogne-Franche-Comté;21;3;22;690;Villeberny;92;2;94
27;Bourgogne-Franche-Comté;21;1;20;691;Villebichot;396;7;403
27;Bourgogne-Franche-Comté;21;2;16;692;Villecomte;252;4;256
27;Bourgogne-Franche-Comté;21;3;05;693;Villedieu;69;1;70
27;Bourgogne-Franche-Comté;21;3;22;694;Villeferry;26;0;26
27;Bourgogne-Franche-Comté;21;3;19;695;La Villeneuve-les-Convers;60;1;61
27;Bourgogne-Franche-Comté;21;3;22;696;Villeneuve-sous-Charigny;96;2;98
27;Bourgogne-Franche-Comté;21;1;20;698;Villers-la-Faye;385;9;394
27;Bourgogne-Franche-Comté;21;2;02;699;Villers-les-Pots;1167;13;1180
27;Bourgogne-Franche-Comté;21;3;05;700;Villers-Patras;86;3;89
27;Bourgogne-Franche-Comté;21;2;02;701;Villers-Rotin;126;5;131
27;Bourgogne-Franche-Comté;21;2;16;702;Villey-sur-Tille;266;7;273
27;Bourgogne-Franche-Comté;21;1;01;703;Villiers-en-Morvan;48;0;48
27;Bourgogne-Franche-Comté;21;3;05;704;Villiers-le-Duc;100;0;100
27;Bourgogne-Franche-Comté;21;2;14;705;Villotte-Saint-Seine;77;1;78
27;Bourgogne-Franche-Comté;21;3;05;706;Villotte-sur-Ource;104;1;105
27;Bourgogne-Franche-Comté;21;3;22;707;Villy-en-Auxois;217;4;221
27;Bourgogne-Franche-Comté;21;1;20;708;Villy-le-Moutier;331;12;343
27;Bourgogne-Franche-Comté;21;3;19;709;Viserny;178;2;180
27;Bourgogne-Franche-Comté;21;3;22;710;Vitteaux;1064;18;1082
27;Bourgogne-Franche-Comté;21;3;05;711;Vix;102;4;106
27;Bourgogne-Franche-Comté;21;1;17;712;Volnay;233;15;248
27;Bourgogne-Franche-Comté;21;2;02;713;Vonges;342;5;347
27;Bourgogne-Franche-Comté;21;1;20;714;Vosne-Romanée;339;9;348
27;Bourgogne-Franche-Comté;21;1;01;715;Voudenay;192;1;193
27;Bourgogne-Franche-Comté;21;1;20;716;Vougeot;171;5;176
27;Bourgogne-Franche-Comté;21;3;05;717;Voulaines-les-Templiers;276;11;287
53;Bretagne;22;4;10;001;Allineuc;599;18;617
53;Bretagne;22;4;06;002;Andel;1144;36;1180
53;Bretagne;22;1;04;003;Aucaleuc;928;77;1005
53;Bretagne;22;2;01;004;Bégard;4809;92;4901
53;Bretagne;22;2;03;005;Belle-Isle-en-Terre;1026;16;1042
53;Bretagne;22;3;01;006;Berhet;268;9;277
53;Bretagne;22;1;08;008;Bobital;1125;40;1165
53;Bretagne;22;4;13;009;Le Bodéo;160;1;161
53;Bretagne;22;2;15;011;Boqueho;1062;27;1089
53;Bretagne;22;4;17;012;La Bouillie;881;17;898
53;Bretagne;22;2;03;013;Bourbriac;2122;44;2166
53;Bretagne;22;1;14;014;Bourseul;1165;29;1194
53;Bretagne;22;4;16;015;Bréhand;1680;30;1710
53;Bretagne;22;4;11;016;Île-de-Bréhat;352;6;358
53;Bretagne;22;2;01;018;Brélidy;295;5;300
53;Bretagne;22;2;15;019;Bringolo;488;13;501
53;Bretagne;22;1;02;020;Broons;2902;68;2970
53;Bretagne;22;1;08;021;Brusvily;1176;25;1201
53;Bretagne;22;2;03;023;Bulat-Pestivien;421;1;422
53;Bretagne;22;2;03;024;Calanhel;227;1;228
53;Bretagne;22;2;03;025;Callac;2229;33;2262
53;Bretagne;22;1;08;026;Calorguen;744;8;752
53;Bretagne;22;4;09;027;Le Cambout;417;12;429
53;Bretagne;22;3;27;028;Camlez;841;25;866
53;Bretagne;22;2;23;029;Canihuel;348;13;361
53;Bretagne;22;3;01;030;Caouënnec-Lanvézéac;889;21;910
53;Bretagne;22;2;03;031;Carnoët;653;9;662
53;Bretagne;22;1;02;032;Caulnes;2495;144;2639
53;Bretagne;22;4;10;033;Caurel;359;11;370
53;Bretagne;22;3;01;034;Cavan;1532;58;1590
53;Bretagne;22;1;08;035;Les Champs-Géraux;1036;15;1051
53;Bretagne;22;1;02;036;La Chapelle-Blanche;210;4;214
53;Bretagne;22;2;03;037;La Chapelle-Neuve;386;4;390
53;Bretagne;22;4;09;039;La Chèze;554;27;581
53;Bretagne;22;2;03;040;Coadout;582;9;591
53;Bretagne;22;3;01;041;Coatascorn;263;3;266
53;Bretagne;22;3;27;042;Coatréven;495;15;510
53;Bretagne;22;4;09;043;Coëtlogon;211;5;216
53;Bretagne;22;4;06;044;Coëtmieux;1781;50;1831
53;Bretagne;22;2;15;045;Cohiniac;345;7;352
53;Bretagne;22;4;16;046;Le Mené;6396;115;6511
53;Bretagne;22;4;10;047;Corlay;934;18;952
53;Bretagne;22;1;14;048;Corseul;2197;47;2244
53;Bretagne;22;1;14;049;Créhen;1629;44;1673
53;Bretagne;22;1;04;050;Dinan;14407;587;14994
53;Bretagne;22;2;03;052;Duault;370;7;377
53;Bretagne;22;4;02;053;Éréac;682;13;695
53;Bretagne;22;4;17;054;Erquy;3922;92;4014
53;Bretagne;22;4;22;055;Binic-Étables-sur-Mer;6934;215;7149
53;Bretagne;22;1;08;056;Évran;1757;26;1783
53;Bretagne;22;2;22;057;Le Faouët;399;12;411
53;Bretagne;22;4;15;059;Le Fœil;1412;40;1452
53;Bretagne;22;4;10;060;Gausson;605;19;624
53;Bretagne;22;2;23;061;Glomel;1363;40;1403
53;Bretagne;22;4;02;062;Gomené;544;10;554
53;Bretagne;22;2;22;063;Gommenec'h;555;9;564
53;Bretagne;22;2;23;064;Gouarec;948;30;978
53;Bretagne;22;2;05;065;Goudelin;1729;36;1765
53;Bretagne;22;2;05;067;Grâces;2545;59;2604
53;Bretagne;22;4;10;068;Grâce-Uzel;430;8;438
53;Bretagne;22;1;02;069;Guenroc;217;5;222
53;Bretagne;22;2;05;070;Guingamp;7069;553;7622
53;Bretagne;22;1;02;071;Guitté;714;9;723
53;Bretagne;22;2;03;072;Gurunhuel;407;9;416
53;Bretagne;22;4;15;073;La Harmoye;375;16;391
53;Bretagne;22;4;10;074;Le Haut-Corlay;644;17;661
53;Bretagne;22;4;10;075;Hémonstoir;720;7;727
53;Bretagne;22;4;17;076;Hénanbihen;1325;36;1361
53;Bretagne;22;4;06;077;Hénansal;1195;15;1210
53;Bretagne;22;4;13;079;Hénon;2268;36;2304
53;Bretagne;22;4;26;081;Hillion;4183;97;4280
53;Bretagne;22;1;08;082;Le Hinglé;906;32;938
53;Bretagne;22;4;02;083;Illifaut;679;12;691
53;Bretagne;22;4;16;084;Jugon-les-Lacs - Commune nouvelle;2520;51;2571
53;Bretagne;22;3;27;085;Kerbors;289;8;297
53;Bretagne;22;2;11;086;Kerfot;658;12;670
53;Bretagne;22;2;23;087;Kergrist-Moëlou;653;25;678
53;Bretagne;22;2;03;088;Kerien;253;3;256
53;Bretagne;22;3;12;090;Kermaria-Sulard;1067;20;1087
53;Bretagne;22;2;01;091;Kermoroc'h;442;9;451
53;Bretagne;22;2;03;092;Kerpert;269;3;272
53;Bretagne;22;4;89;093;Lamballe-Armor;16688;470;17158
53;Bretagne;22;1;19;094;Lancieux;1558;63;1621
53;Bretagne;22;2;01;095;Landebaëron;180;10;190
53;Bretagne;22;1;14;096;Landébia;459;3;462
53;Bretagne;22;1;14;097;La Landec;726;18;744
53;Bretagne;22;4;06;098;Landéhen;1425;34;1459
53;Bretagne;22;4;15;099;Lanfains;1098;17;1115
53;Bretagne;22;3;27;101;Langoat;1133;25;1158
53;Bretagne;22;1;19;103;Langrolay-sur-Rance;958;39;997
53;Bretagne;22;1;14;104;Languédias;526;28;554
53;Bretagne;22;1;14;105;Languenan;1146;23;1169
53;Bretagne;22;4;26;106;Langueux;7801;263;8064
53;Bretagne;22;2;23;107;Bon Repos sur Blavet;1256;39;1295
53;Bretagne;22;2;11;108;Lanleff;122;2;124
53;Bretagne;22;2;11;109;Lanloup;210;5;215
53;Bretagne;22;3;27;110;Lanmérin;601;12;613
53;Bretagne;22;3;27;111;Lanmodez;404;7;411
53;Bretagne;22;2;22;112;Lannebert;437;5;442
53;Bretagne;22;3;07;113;Lannion;20210;936;21146
53;Bretagne;22;4;02;114;Lanrelas;847;17;864
53;Bretagne;22;2;23;115;Lanrivain;441;16;457
53;Bretagne;22;2;15;116;Lanrodec;1351;23;1374
53;Bretagne;22;4;22;117;Lantic;1716;33;1749
53;Bretagne;22;1;08;118;Lanvallay;4195;96;4291
53;Bretagne;22;3;20;119;Lanvellec;591;10;601
53;Bretagne;22;2;22;121;Lanvollon;1780;29;1809
53;Bretagne;22;4;02;122;Laurenan;735;12;747
53;Bretagne;22;2;23;124;Lescouët-Gouarec;218;8;226
53;Bretagne;22;4;15;126;Le Leslay;158;1;159
53;Bretagne;22;3;27;127;Lézardrieux;1480;38;1518
53;Bretagne;22;2;23;128;Locarn;410;15;425
53;Bretagne;22;2;03;129;Loc-Envel;67;3;70
53;Bretagne;22;3;20;131;Loguivy-Plougras;813;13;826
53;Bretagne;22;2;03;132;Lohuec;252;4;256
53;Bretagne;22;4;02;133;Loscouët-sur-Meu;626;15;641
53;Bretagne;22;3;12;134;Louannec;3077;117;3194
53;Bretagne;22;2;03;135;Louargat;2329;45;2374
53;Bretagne;22;4;09;136;Loudéac;9605;384;9989
53;Bretagne;22;2;23;137;Maël-Carhaix;1469;30;1499
53;Bretagne;22;2;03;138;Maël-Pestivien;360;5;365
53;Bretagne;22;2;03;139;Magoar;89;1;90
53;Bretagne;22;4;06;140;La Malhoure;598;16;614
53;Bretagne;22;3;01;141;Mantallot;237;6;243
53;Bretagne;22;1;17;143;Matignon;1697;23;1720
53;Bretagne;22;4;21;144;La Méaugon;1326;34;1360
53;Bretagne;22;1;02;145;Mégrit;836;11;847
53;Bretagne;22;2;23;146;Mellionnec;391;17;408
53;Bretagne;22;4;02;147;Merdrignac;2937;230;3167
53;Bretagne;22;4;02;148;Mérillac;234;4;238
53;Bretagne;22;4;10;149;Merléac;431;17;448
53;Bretagne;22;2;05;150;Le Merzer;947;27;974
53;Bretagne;22;3;27;152;Minihy-Tréguier;1262;41;1303
53;Bretagne;22;4;13;153;Moncontour;790;17;807
53;Bretagne;22;4;10;155;La Motte;2141;32;2173
53;Bretagne;22;2;03;156;Moustéru;649;15;664
53;Bretagne;22;2;23;157;Le Moustoir;670;17;687
53;Bretagne;22;4;10;158;Guerlédan;2439;64;2503
53;Bretagne;22;4;06;160;Noyal;946;18;964
53;Bretagne;22;2;05;161;Pabu;2748;107;2855
53;Bretagne;22;2;11;162;Paimpol;7179;335;7514
53;Bretagne;22;2;23;163;Paule;691;20;711
53;Bretagne;22;2;01;164;Pédernec;1839;26;1865
53;Bretagne;22;4;16;165;Penguily;607;19;626
53;Bretagne;22;3;27;166;Penvénan;2494;63;2557
53;Bretagne;22;3;12;168;Perros-Guirec;7089;196;7285
53;Bretagne;22;2;23;169;Peumerit-Quintin;173;4;177
53;Bretagne;22;4;15;170;Plaine-Haute;1633;34;1667
53;Bretagne;22;4;13;171;Plaintel;4441;91;4532
53;Bretagne;22;1;14;172;Plancoët;2981;54;3035
53;Bretagne;22;1;17;174;Pléboulle;869;5;874
53;Bretagne;22;4;16;175;Plédéliac;1464;20;1484
53;Bretagne;22;4;21;176;Plédran;6839;111;6950
53;Bretagne;22;2;22;177;Pléguien;1353;29;1382
53;Bretagne;22;2;11;178;Pléhédel;1325;34;1359
53;Bretagne;22;1;17;179;Fréhel;1602;27;1629
53;Bretagne;22;1;14;180;Plélan-le-Petit;1901;31;1932
53;Bretagne;22;2;23;181;Plélauff;629;27;656
53;Bretagne;22;2;15;182;Plélo;3242;75;3317
53;Bretagne;22;4;09;183;Plémet;3697;126;3823
53;Bretagne;22;4;13;184;Plémy;1587;30;1617
53;Bretagne;22;4;16;185;Plénée-Jugon;2429;73;2502
53;Bretagne;22;4;17;186;Pléneuf-Val-André;4083;129;4212
53;Bretagne;22;4;18;187;Plérin;14309;487;14796
53;Bretagne;22;2;15;188;Plerneuf;1090;10;1100
53;Bretagne;22;2;03;189;Plésidy;580;10;590
53;Bretagne;22;1;19;190;Pleslin-Trigavou;3775;76;3851
53;Bretagne;22;4;16;193;Plestan;1617;25;1642
53;Bretagne;22;3;20;194;Plestin-les-Grèves;3620;98;3718
53;Bretagne;22;3;27;195;Pleubian;2298;42;2340
53;Bretagne;22;3;27;196;Pleudaniel;936;21;957
53;Bretagne;22;1;08;197;Pleudihen-sur-Rance;2968;80;3048
53;Bretagne;22;3;12;198;Pleumeur-Bodou;3857;165;4022
53;Bretagne;22;3;27;199;Pleumeur-Gautier;1197;19;1216
53;Bretagne;22;1;14;200;Pléven;593;11;604
53;Bretagne;22;1;17;201;Plévenon;754;13;767
53;Bretagne;22;2;23;202;Plévin;754;15;769
53;Bretagne;22;4;13;203;Plœuc-L'Hermitage;4103;77;4180
53;Bretagne;22;2;01;204;Ploëzal;1232;20;1252
53;Bretagne;22;1;14;205;Plorec-sur-Arguenon;417;3;420
53;Bretagne;22;2;15;206;Châtelaudren-Plouagat;3916;55;3971
53;Bretagne;22;3;20;207;Plouaret;2176;45;2221
53;Bretagne;22;1;08;208;Plouasne;1711;33;1744
53;Bretagne;22;1;19;209;Beaussais-sur-Mer;3757;63;3820
53;Bretagne;22;2;11;210;Ploubazlanec;3039;125;3164
53;Bretagne;22;3;20;211;Ploubezre;3687;117;3804
53;Bretagne;22;2;01;212;Plouëc-du-Trieux;1140;33;1173
53;Bretagne;22;1;19;213;Plouër-sur-Rance;3551;108;3659
53;Bretagne;22;2;11;214;Plouézec;3140;56;3196
53;Bretagne;22;4;21;215;Ploufragan;11383;356;11739
53;Bretagne;22;2;03;216;Plougonver;731;12;743
53;Bretagne;22;3;20;217;Plougras;408;14;422
53;Bretagne;22;3;27;218;Plougrescant;1166;36;1202
53;Bretagne;22;4;10;219;Plouguenast-Langast;2448;59;2507
53;Bretagne;22;2;23;220;Plouguernével;1643;53;1696
53;Bretagne;22;3;27;221;Plouguiel;1733;37;1770
53;Bretagne;22;2;22;222;Plouha;4541;88;4629
53;Bretagne;22;2;05;223;Plouisy;1989;268;2257
53;Bretagne;22;3;07;224;Ploulec'h;1579;57;1636
53;Bretagne;22;2;05;225;Ploumagoar;5409;113;5522
53;Bretagne;22;3;20;226;Ploumilliau;2464;57;2521
53;Bretagne;22;3;20;227;Plounérin;776;11;787
53;Bretagne;22;3;20;228;Plounévez-Moëdec;1462;29;1491
53;Bretagne;22;2;23;229;Plounévez-Quintin;1071;25;1096
53;Bretagne;22;2;03;231;Plourac'h;317;4;321
53;Bretagne;22;4;22;232;Plourhan;1991;39;2030
53;Bretagne;22;2;11;233;Plourivo;2263;55;2318
53;Bretagne;22;2;15;234;Plouvara;1160;22;1182
53;Bretagne;22;3;20;235;Plouzélambre;237;4;241
53;Bretagne;22;2;22;236;Pludual;715;7;722
53;Bretagne;22;1;14;237;Pluduno;2188;65;2253
53;Bretagne;22;3;20;238;Plufur;531;12;543
53;Bretagne;22;1;02;239;Plumaudan;1333;37;1370
53;Bretagne;22;1;02;240;Plumaugat;1077;15;1092
53;Bretagne;22;4;09;241;Plumieux;1024;30;1054
53;Bretagne;22;4;17;242;Plurien;1559;23;1582
53;Bretagne;22;2;03;243;Plusquellec;539;17;556
53;Bretagne;22;4;10;244;Plussulien;484;18;502
53;Bretagne;22;3;01;245;Pluzunet;966;14;980
53;Bretagne;22;4;06;246;Pommeret;2103;32;2135
53;Bretagne;22;2;05;248;Pommerit-le-Vicomte;1807;37;1844
53;Bretagne;22;2;03;249;Pont-Melvez;611;10;621
53;Bretagne;22;2;01;250;Pontrieux;1009;25;1034
53;Bretagne;22;4;18;251;Pordic;7300;208;7508
53;Bretagne;22;3;01;254;Prat;1117;22;1139
53;Bretagne;22;4;09;255;La Prénessaye;879;21;900
53;Bretagne;22;2;01;256;Quemper-Guézennec;1078;26;1104
53;Bretagne;22;3;01;257;Quemperven;381;8;389
53;Bretagne;22;4;13;258;Quessoy;3856;225;4081
53;Bretagne;22;1;04;259;Quévert;3976;111;4087
53;Bretagne;22;4;10;260;Le Quillio;556;7;563
53;Bretagne;22;4;06;261;Quintenic;362;11;373
53;Bretagne;22;4;15;262;Quintin;2867;200;3067
53;Bretagne;22;1;08;263;Le Quiou;333;3;336
53;Bretagne;22;3;27;264;La Roche-Jaudy;2713;576;3289
53;Bretagne;22;3;07;265;Rospez;1763;56;1819
53;Bretagne;22;2;23;266;Rostrenen;3056;324;3380
53;Bretagne;22;4;02;267;Rouillac;392;3;395
53;Bretagne;22;1;17;268;Ruca;600;10;610
53;Bretagne;22;2;01;269;Runan;250;6;256
53;Bretagne;22;2;03;271;Saint-Adrien;353;7;360
53;Bretagne;22;2;05;272;Saint-Agathon;2289;53;2342
53;Bretagne;22;4;17;273;Saint-Alban;2176;32;2208
53;Bretagne;22;1;08;274;Saint-André-des-Eaux;372;6;378
53;Bretagne;22;4;09;275;Saint-Barnabé;1238;25;1263
53;Bretagne;22;4;15;276;Saint-Bihy;269;0;269
53;Bretagne;22;4;15;277;Saint-Brandan;2309;49;2358
53;Bretagne;22;4;99;278;Saint-Brieuc;43605;1494;45099
53;Bretagne;22;4;10;279;Saint-Caradec;1119;37;1156
53;Bretagne;22;1;08;280;Saint-Carné;1051;36;1087
53;Bretagne;22;4;13;281;Saint-Carreuc;1519;25;1544
53;Bretagne;22;1;17;282;Saint-Cast-le-Guildo;3308;77;3385
53;Bretagne;22;2;01;283;Saint-Clet;877;26;903
53;Bretagne;22;2;23;284;Saint-Connan;290;9;299
53;Bretagne;22;4;10;285;Saint-Connec;258;8;266
53;Bretagne;22;4;17;286;Saint-Denoual;474;14;488
53;Bretagne;22;4;21;287;Saint-Donan;1453;36;1489
53;Bretagne;22;4;09;288;Saint-Étienne-du-Gué-de-l'Isle;351;6;357
53;Bretagne;22;2;15;289;Saint-Fiacre;213;1;214
53;Bretagne;22;4;15;291;Saint-Gildas;251;8;259
53;Bretagne;22;2;22;293;Saint-Gilles-les-Bois;408;13;421
53;Bretagne;22;2;23;294;Saint-Gilles-Pligeaux;305;6;311
53;Bretagne;22;4;10;295;Saint-Gilles-Vieux-Marché;358;8;366
53;Bretagne;22;4;16;296;Saint-Glen;646;11;657
53;Bretagne;22;1;08;299;Saint-Hélen;1512;43;1555
53;Bretagne;22;4;10;300;Saint-Hervé;392;9;401
53;Bretagne;22;1;14;302;Saint-Jacut-de-la-Mer;911;19;930
53;Bretagne;22;2;15;304;Saint-Jean-Kerdaniel;650;9;659
53;Bretagne;22;1;02;305;Saint-Jouan-de-l'Isle;495;5;500
53;Bretagne;22;1;08;306;Saint-Judoce;555;14;569
53;Bretagne;22;4;21;307;Saint-Julien;2029;50;2079
53;Bretagne;22;1;08;308;Saint-Juvat;646;18;664
53;Bretagne;22;4;02;309;Saint-Launeuc;195;4;199
53;Bretagne;22;2;01;310;Saint-Laurent;468;15;483
53;Bretagne;22;1;14;311;Saint-Lormel;874;35;909
53;Bretagne;22;1;02;312;Saint-Maden;226;8;234
53;Bretagne;22;4;10;313;Saint-Martin-des-Prés;306;11;317
53;Bretagne;22;4;09;314;Saint-Maudan;403;7;410
53;Bretagne;22;1;14;315;Saint-Maudez;284;11;295
53;Bretagne;22;4;10;316;Saint-Mayeux;469;11;480
53;Bretagne;22;1;14;317;Saint-Méloir-des-Bois;265;2;267
53;Bretagne;22;1;14;318;Saint-Michel-de-Plélan;307;8;315
53;Bretagne;22;3;20;319;Saint-Michel-en-Grève;456;13;469
53;Bretagne;22;2;03;320;Saint-Nicodème;168;3;171
53;Bretagne;22;2;23;321;Saint-Nicolas-du-Pélem;1594;45;1639
53;Bretagne;22;2;15;322;Saint-Péver;387;8;395
53;Bretagne;22;1;17;323;Saint-Pôtan;815;13;828
53;Bretagne;22;3;12;324;Saint-Quay-Perros;1290;55;1345
53;Bretagne;22;4;22;325;Saint-Quay-Portrieux;3121;222;3343
53;Bretagne;22;4;06;326;Saint-Rieul;546;5;551
53;Bretagne;22;1;19;327;Saint-Samson-sur-Rance;1637;27;1664
53;Bretagne;22;2;03;328;Saint-Servais;408;6;414
53;Bretagne;22;4;10;330;Saint-Thélo;395;12;407
53;Bretagne;22;2;23;331;Sainte-Tréphine;185;2;187
53;Bretagne;22;4;16;332;Saint-Trimoël;521;9;530
53;Bretagne;22;4;02;333;Saint-Vran;761;29;790
53;Bretagne;22;2;23;334;Saint-Igeaux;127;7;134
53;Bretagne;22;2;03;335;Senven-Léhart;236;0;236
53;Bretagne;22;4;02;337;Sévignac;1107;25;1132
53;Bretagne;22;2;01;338;Squiffiec;760;26;786
53;Bretagne;22;1;19;339;Taden;2524;76;2600
53;Bretagne;22;3;01;340;Tonquédec;1196;27;1223
53;Bretagne;22;4;16;341;Tramain;692;10;702
53;Bretagne;22;1;14;342;Trébédan;427;9;436
53;Bretagne;22;3;12;343;Trébeurden;3641;126;3767
53;Bretagne;22;2;23;344;Trébrivan;748;16;764
53;Bretagne;22;4;16;345;Trébry;784;15;799
53;Bretagne;22;4;13;346;Trédaniel;900;24;924
53;Bretagne;22;3;27;347;Trédarzec;1060;19;1079
53;Bretagne;22;4;02;348;Trédias;495;9;504
53;Bretagne;22;3;20;349;Trédrez-Locquémeau;1449;39;1488
53;Bretagne;22;3;20;350;Tréduder;195;3;198
53;Bretagne;22;2;23;351;Treffrin;544;13;557
53;Bretagne;22;1;08;352;Tréfumel;274;2;276
53;Bretagne;22;3;12;353;Trégastel;2535;74;2609
53;Bretagne;22;2;03;354;Tréglamus;1074;23;1097
53;Bretagne;22;2;15;356;Trégomeur;943;24;967
53;Bretagne;22;2;01;358;Trégonneau;578;7;585
53;Bretagne;22;3;20;359;Trégrom;416;6;422
53;Bretagne;22;4;26;360;Trégueux;8459;166;8625
53;Bretagne;22;2;22;361;Tréguidel;627;12;639
53;Bretagne;22;3;27;362;Tréguier;2416;267;2683
53;Bretagne;22;3;12;363;Trélévern;1243;32;1275
53;Bretagne;22;1;04;364;Trélivan;2862;82;2944
53;Bretagne;22;2;23;365;Trémargat;187;14;201
53;Bretagne;22;3;20;366;Trémel;405;5;410
53;Bretagne;22;1;19;368;Tréméreuc;711;28;739
53;Bretagne;22;4;02;369;Trémeur;783;17;800
53;Bretagne;22;2;22;370;Tréméven;348;8;356
53;Bretagne;22;4;02;371;Trémorel;1142;20;1162
53;Bretagne;22;4;18;372;Trémuson;2148;36;2184
53;Bretagne;22;2;23;373;Tréogan;102;4;106
53;Bretagne;22;2;22;375;Tressignaux;695;11;706
53;Bretagne;22;4;10;376;Trévé;1692;31;1723
53;Bretagne;22;4;22;377;Tréveneuc;797;21;818
53;Bretagne;22;2;22;378;Trévérec;216;7;223
53;Bretagne;22;3;12;379;Trévou-Tréguignec;1483;41;1524
53;Bretagne;22;1;08;380;Trévron;685;14;699
53;Bretagne;22;3;27;381;Trézény;351;8;359
53;Bretagne;22;3;27;383;Troguéry;224;6;230
53;Bretagne;22;4;10;384;Uzel;1053;25;1078
53;Bretagne;22;1;19;385;La Vicomté-sur-Rance;1092;24;1116
53;Bretagne;22;4;15;386;Le Vieux-Bourg;776;20;796
53;Bretagne;22;3;20;387;Le Vieux-Marché;1285;30;1315
53;Bretagne;22;1;04;388;Vildé-Guingalan;1239;21;1260
53;Bretagne;22;4;26;389;Yffiniac;4990;104;5094
53;Bretagne;22;2;11;390;Yvias;777;18;795
53;Bretagne;22;1;02;391;Yvignac-la-Tour;1129;16;1145
75;Nouvelle-Aquitaine;23;2;01;001;Ahun;1410;230;1640
75;Nouvelle-Aquitaine;23;2;14;002;Ajain;1075;15;1090
75;Nouvelle-Aquitaine;23;1;02;003;Alleyrat;139;0;139
75;Nouvelle-Aquitaine;23;2;14;004;Anzême;555;9;564
75;Nouvelle-Aquitaine;23;1;08;005;Arfeuille-Châtain;198;4;202
75;Nouvelle-Aquitaine;23;2;11;006;Arrènes;212;2;214
75;Nouvelle-Aquitaine;23;2;01;007;Ars;236;10;246
75;Nouvelle-Aquitaine;23;1;02;008;Aubusson;3248;183;3431
75;Nouvelle-Aquitaine;23;1;08;009;Auge;93;0;93
75;Nouvelle-Aquitaine;23;2;11;010;Augères;118;2;120
75;Nouvelle-Aquitaine;23;2;11;011;Aulon;160;4;164
75;Nouvelle-Aquitaine;23;2;05;012;Auriat;109;2;111
75;Nouvelle-Aquitaine;23;1;03;013;Auzances;1208;25;1233
75;Nouvelle-Aquitaine;23;2;11;014;Azat-Châtenet;121;3;124
75;Nouvelle-Aquitaine;23;2;07;015;Azerables;813;16;829
75;Nouvelle-Aquitaine;23;2;01;016;Banize;182;2;184
75;Nouvelle-Aquitaine;23;1;03;017;Basville;164;2;166
75;Nouvelle-Aquitaine;23;2;07;018;Bazelat;247;11;258
75;Nouvelle-Aquitaine;23;1;03;019;Beissat;25;0;25
75;Nouvelle-Aquitaine;23;1;02;020;Bellegarde-en-Marche;410;7;417
75;Nouvelle-Aquitaine;23;2;11;021;Bénévent-l'Abbaye;765;11;776
75;Nouvelle-Aquitaine;23;1;06;022;Bétête;373;7;380
75;Nouvelle-Aquitaine;23;1;10;023;Blaudeix;105;1;106
75;Nouvelle-Aquitaine;23;1;02;024;Blessac;532;12;544
75;Nouvelle-Aquitaine;23;2;04;025;Bonnat;1342;24;1366
75;Nouvelle-Aquitaine;23;1;06;026;Bord-Saint-Georges;351;10;361
75;Nouvelle-Aquitaine;23;2;05;027;Bosmoreau-les-Mines;235;7;242
75;Nouvelle-Aquitaine;23;1;02;028;Bosroger;107;2;109
75;Nouvelle-Aquitaine;23;2;04;029;Le Bourg-d'Hem;219;2;221
75;Nouvelle-Aquitaine;23;2;05;030;Bourganeuf;2478;213;2691
75;Nouvelle-Aquitaine;23;1;06;031;Boussac;1249;18;1267
75;Nouvelle-Aquitaine;23;1;06;032;Boussac-Bourg;695;11;706
75;Nouvelle-Aquitaine;23;2;14;033;La Brionne;445;8;453
75;Nouvelle-Aquitaine;23;1;03;034;Brousse;28;0;28
75;Nouvelle-Aquitaine;23;1;08;035;Budelière;707;10;717
75;Nouvelle-Aquitaine;23;2;14;036;Bussière-Dunoise;1030;14;1044
75;Nouvelle-Aquitaine;23;1;03;037;Bussière-Nouvelle;79;3;82
75;Nouvelle-Aquitaine;23;1;06;038;Bussière-Saint-Georges;253;3;256
75;Nouvelle-Aquitaine;23;2;07;039;La Celle-Dunoise;541;24;565
75;Nouvelle-Aquitaine;23;1;10;040;La Celle-sous-Gouzon;154;1;155
75;Nouvelle-Aquitaine;23;2;04;041;La Cellette;243;4;247
75;Nouvelle-Aquitaine;23;2;11;042;Ceyroux;125;1;126
75;Nouvelle-Aquitaine;23;2;01;043;Chamberaud;96;0;96
75;Nouvelle-Aquitaine;23;2;04;044;Chambon-Sainte-Croix;80;1;81
75;Nouvelle-Aquitaine;23;1;08;045;Chambon-sur-Voueize;868;12;880
75;Nouvelle-Aquitaine;23;1;08;046;Chambonchard;81;4;85
75;Nouvelle-Aquitaine;23;2;11;047;Chamborand;241;3;244
75;Nouvelle-Aquitaine;23;1;02;048;Champagnat;471;10;481
75;Nouvelle-Aquitaine;23;2;04;049;Champsanglard;249;6;255
75;Nouvelle-Aquitaine;23;2;07;050;La Chapelle-Baloue;128;1;129
75;Nouvelle-Aquitaine;23;2;01;051;La Chapelle-Saint-Martial;78;1;79
75;Nouvelle-Aquitaine;23;2;13;052;La Chapelle-Taillefert;431;10;441
75;Nouvelle-Aquitaine;23;1;03;053;Chard;205;2;207
75;Nouvelle-Aquitaine;23;1;03;054;Charron;230;9;239
75;Nouvelle-Aquitaine;23;1;03;055;Châtelard;30;0;30
75;Nouvelle-Aquitaine;23;2;11;056;Châtelus-le-Marcheix;294;6;300
75;Nouvelle-Aquitaine;23;2;04;057;Châtelus-Malvaleix;551;12;563
75;Nouvelle-Aquitaine;23;1;10;058;Le Chauchet;105;2;107
75;Nouvelle-Aquitaine;23;1;02;059;La Chaussade;101;6;107
75;Nouvelle-Aquitaine;23;2;01;060;Chavanat;143;3;146
75;Nouvelle-Aquitaine;23;1;10;061;Chénérailles;755;12;767
75;Nouvelle-Aquitaine;23;2;04;062;Chéniers;559;9;568
75;Nouvelle-Aquitaine;23;1;03;063;Clairavaux;155;1;156
75;Nouvelle-Aquitaine;23;1;06;064;Clugnat;650;3;653
75;Nouvelle-Aquitaine;23;2;07;065;Colondannes;274;9;283
75;Nouvelle-Aquitaine;23;1;03;066;Le Compas;194;11;205
75;Nouvelle-Aquitaine;23;1;03;067;La Courtine;788;9;797
75;Nouvelle-Aquitaine;23;1;10;068;Cressat;528;7;535
75;Nouvelle-Aquitaine;23;1;03;069;Crocq;412;6;418
75;Nouvelle-Aquitaine;23;2;07;070;Crozant;439;14;453
75;Nouvelle-Aquitaine;23;1;09;071;Croze;191;6;197
75;Nouvelle-Aquitaine;23;1;10;072;Domeyrot;231;3;234
75;Nouvelle-Aquitaine;23;1;03;073;Dontreix;425;5;430
75;Nouvelle-Aquitaine;23;2;01;074;Le Donzeil;186;5;191
75;Nouvelle-Aquitaine;23;2;07;075;Dun-le-Palestel;1094;24;1118
75;Nouvelle-Aquitaine;23;1;08;076;Évaux-les-Bains;1328;32;1360
75;Nouvelle-Aquitaine;23;1;09;077;Faux-la-Montagne;439;11;450
75;Nouvelle-Aquitaine;23;2;05;078;Faux-Mazuras;189;4;193
75;Nouvelle-Aquitaine;23;1;09;079;Felletin;1550;186;1736
75;Nouvelle-Aquitaine;23;1;09;080;Féniers;94;0;94
75;Nouvelle-Aquitaine;23;1;03;081;Flayat;300;4;304
75;Nouvelle-Aquitaine;23;2;11;082;Fleurat;316;6;322
75;Nouvelle-Aquitaine;23;1;08;083;Fontanières;247;1;248
75;Nouvelle-Aquitaine;23;2;04;084;La Forêt-du-Temple;146;1;147
75;Nouvelle-Aquitaine;23;2;01;086;Fransèches;244;3;247
75;Nouvelle-Aquitaine;23;2;07;087;Fresselines;488;11;499
75;Nouvelle-Aquitaine;23;2;14;088;Gartempe;121;0;121
75;Nouvelle-Aquitaine;23;2;04;089;Genouillac;728;11;739
75;Nouvelle-Aquitaine;23;1;09;090;Gentioux-Pigerolles;378;6;384
75;Nouvelle-Aquitaine;23;1;09;091;Gioux;161;3;164
75;Nouvelle-Aquitaine;23;2;14;092;Glénic;680;12;692
75;Nouvelle-Aquitaine;23;1;10;093;Gouzon;1567;22;1589
75;Nouvelle-Aquitaine;23;2;11;095;Le Grand-Bourg;1220;43;1263
75;Nouvelle-Aquitaine;23;2;99;096;Guéret;12734;637;13371
75;Nouvelle-Aquitaine;23;1;10;097;Issoudun-Létrieix;298;3;301
75;Nouvelle-Aquitaine;23;2;06;098;Jalesches;90;3;93
75;Nouvelle-Aquitaine;23;2;01;099;Janaillat;318;5;323
75;Nouvelle-Aquitaine;23;1;10;100;Jarnages;439;10;449
75;Nouvelle-Aquitaine;23;2;14;101;Jouillat;387;13;400
75;Nouvelle-Aquitaine;23;1;10;102;Ladapeyre;346;3;349
75;Nouvelle-Aquitaine;23;2;07;103;Lafat;323;14;337
75;Nouvelle-Aquitaine;23;1;06;104;Lavaufranche;239;1;240
75;Nouvelle-Aquitaine;23;1;10;105;Lavaveix-les-Mines;635;2;637
75;Nouvelle-Aquitaine;23;1;08;106;Lépaud;366;4;370
75;Nouvelle-Aquitaine;23;2;01;107;Lépinas;129;5;134
75;Nouvelle-Aquitaine;23;1;06;108;Leyrat;142;1;143
75;Nouvelle-Aquitaine;23;2;04;109;Linard-Malval;211;5;216
75;Nouvelle-Aquitaine;23;1;03;110;Lioux-les-Monges;60;1;61
75;Nouvelle-Aquitaine;23;2;11;111;Lizières;251;1;252
75;Nouvelle-Aquitaine;23;2;04;112;Lourdoueix-Saint-Pierre;746;11;757
75;Nouvelle-Aquitaine;23;1;02;113;Lupersat;299;6;305
75;Nouvelle-Aquitaine;23;1;08;114;Lussat;410;7;417
75;Nouvelle-Aquitaine;23;1;03;115;Magnat-l'Étrange;247;2;249
75;Nouvelle-Aquitaine;23;1;02;116;Mainsat;543;11;554
75;Nouvelle-Aquitaine;23;2;07;117;Maison-Feyne;302;7;309
75;Nouvelle-Aquitaine;23;2;01;118;Maisonnisses;180;6;186
75;Nouvelle-Aquitaine;23;1;03;119;Malleret;43;0;43
75;Nouvelle-Aquitaine;23;1;06;120;Malleret-Boussac;187;3;190
75;Nouvelle-Aquitaine;23;2;05;122;Mansat-la-Courrière;70;4;74
75;Nouvelle-Aquitaine;23;1;03;123;Les Mars;187;2;189
75;Nouvelle-Aquitaine;23;2;11;124;Marsac;652;17;669
75;Nouvelle-Aquitaine;23;1;03;125;Le Mas-d'Artige;99;1;100
75;Nouvelle-Aquitaine;23;1;02;127;Mautes;198;6;204
75;Nouvelle-Aquitaine;23;2;01;128;Mazeirat;126;6;132
75;Nouvelle-Aquitaine;23;1;03;129;La Mazière-aux-Bons-Hommes;65;1;66
75;Nouvelle-Aquitaine;23;2;04;130;Méasnes;530;6;536
75;Nouvelle-Aquitaine;23;1;03;131;Mérinchal;693;13;706
75;Nouvelle-Aquitaine;23;2;13;132;Montaigut-le-Blanc;411;6;417
75;Nouvelle-Aquitaine;23;2;05;133;Montboucher;345;12;357
75;Nouvelle-Aquitaine;23;2;09;134;Le Monteil-au-Vicomte;200;47;247
75;Nouvelle-Aquitaine;23;2;04;136;Mortroux;277;9;286
75;Nouvelle-Aquitaine;23;2;11;137;Mourioux-Vieilleville;516;12;528
75;Nouvelle-Aquitaine;23;2;01;138;Moutier-d'Ahun;169;1;170
75;Nouvelle-Aquitaine;23;2;04;139;Moutier-Malcard;542;6;548
75;Nouvelle-Aquitaine;23;1;09;140;Moutier-Rozeille;419;9;428
75;Nouvelle-Aquitaine;23;2;07;141;Naillat;630;16;646
75;Nouvelle-Aquitaine;23;1;02;142;Néoux;287;3;290
75;Nouvelle-Aquitaine;23;2;15;143;Noth;491;13;504
75;Nouvelle-Aquitaine;23;1;09;144;La Nouaille;240;3;243
75;Nouvelle-Aquitaine;23;1;08;145;Nouhant;279;7;286
75;Nouvelle-Aquitaine;23;1;06;146;Nouzerines;241;7;248
75;Nouvelle-Aquitaine;23;2;07;147;Nouzerolles;96;2;98
75;Nouvelle-Aquitaine;23;2;04;148;Nouziers;245;2;247
75;Nouvelle-Aquitaine;23;1;10;149;Parsac-Rimondeix;709;14;723
75;Nouvelle-Aquitaine;23;2;01;150;Peyrabout;156;2;158
75;Nouvelle-Aquitaine;23;1;10;151;Peyrat-la-Nonière;431;8;439
75;Nouvelle-Aquitaine;23;1;10;152;Pierrefitte;70;0;70
75;Nouvelle-Aquitaine;23;1;10;154;Pionnat;737;11;748
75;Nouvelle-Aquitaine;23;2;01;155;Pontarion;364;6;370
75;Nouvelle-Aquitaine;23;1;03;156;Pontcharraud;83;1;84
75;Nouvelle-Aquitaine;23;2;01;157;La Pouge;96;0;96
75;Nouvelle-Aquitaine;23;1;09;158;Poussanges;158;0;158
75;Nouvelle-Aquitaine;23;1;10;159;Puy-Malsignat;150;3;153
75;Nouvelle-Aquitaine;23;1;08;160;Reterre;276;1;277
75;Nouvelle-Aquitaine;23;2;04;162;Roches;369;3;372
75;Nouvelle-Aquitaine;23;1;03;164;Rougnat;484;11;495
75;Nouvelle-Aquitaine;23;2;09;165;Royère-de-Vassivière;577;5;582
75;Nouvelle-Aquitaine;23;2;07;166;Sagnat;192;7;199
75;Nouvelle-Aquitaine;23;1;08;167;Sannat;334;8;342
75;Nouvelle-Aquitaine;23;2;01;168;Sardent;769;18;787
75;Nouvelle-Aquitaine;23;2;12;169;La Saunière;632;13;645
75;Nouvelle-Aquitaine;23;2;12;170;Savennes;213;11;224
75;Nouvelle-Aquitaine;23;1;03;171;Sermur;116;1;117
75;Nouvelle-Aquitaine;23;1;02;172;La Serre-Bussière-Vieille;122;1;123
75;Nouvelle-Aquitaine;23;2;05;173;Soubrebost;139;3;142
75;Nouvelle-Aquitaine;23;1;06;174;Soumans;584;7;591
75;Nouvelle-Aquitaine;23;2;01;175;Sous-Parsat;114;1;115
75;Nouvelle-Aquitaine;23;2;15;176;La Souterraine;4982;231;5213
75;Nouvelle-Aquitaine;23;2;15;177;Saint-Agnant-de-Versillat;1088;29;1117
75;Nouvelle-Aquitaine;23;1;03;178;Saint-Agnant-près-Crocq;175;0;175
75;Nouvelle-Aquitaine;23;1;02;179;Saint-Alpinien;279;4;283
75;Nouvelle-Aquitaine;23;1;02;180;Saint-Amand;486;3;489
75;Nouvelle-Aquitaine;23;2;05;181;Saint-Amand-Jartoudeix;158;2;160
75;Nouvelle-Aquitaine;23;1;02;182;Saint-Avit-de-Tardes;173;2;175
75;Nouvelle-Aquitaine;23;2;01;183;Saint-Avit-le-Pauvre;77;2;79
75;Nouvelle-Aquitaine;23;1;03;184;Saint-Bard;99;3;102
75;Nouvelle-Aquitaine;23;1;10;185;Saint-Chabrais;284;3;287
75;Nouvelle-Aquitaine;23;2;13;186;Saint-Christophe;154;6;160
75;Nouvelle-Aquitaine;23;1;10;187;Saint-Dizier-la-Tour;195;2;197
75;Nouvelle-Aquitaine;23;2;04;188;Saint-Dizier-les-Domaines;196;2;198
75;Nouvelle-Aquitaine;23;2;05;189;Saint-Dizier-Masbaraud;1133;25;1158
75;Nouvelle-Aquitaine;23;1;02;190;Saint-Domet;167;1;168
75;Nouvelle-Aquitaine;23;2;13;191;Saint-Éloi;195;7;202
75;Nouvelle-Aquitaine;23;2;11;192;Fursac;1466;21;1487
75;Nouvelle-Aquitaine;23;2;12;193;Sainte-Feyre;2482;59;2541
75;Nouvelle-Aquitaine;23;1;09;194;Sainte-Feyre-la-Montagne;123;3;126
75;Nouvelle-Aquitaine;23;2;14;195;Saint-Fiel;1049;26;1075
75;Nouvelle-Aquitaine;23;1;09;196;Saint-Frion;255;5;260
75;Nouvelle-Aquitaine;23;2;01;197;Saint-Georges-la-Pouge;369;2;371
75;Nouvelle-Aquitaine;23;1;03;198;Saint-Georges-Nigremont;143;1;144
75;Nouvelle-Aquitaine;23;2;07;199;Saint-Germain-Beaupré;386;8;394
75;Nouvelle-Aquitaine;23;2;11;200;Saint-Goussaud;165;8;173
75;Nouvelle-Aquitaine;23;2;01;201;Saint-Hilaire-la-Plaine;212;5;217
75;Nouvelle-Aquitaine;23;2;01;202;Saint-Hilaire-le-Château;229;7;236
75;Nouvelle-Aquitaine;23;1;08;203;Saint-Julien-la-Genête;219;7;226
75;Nouvelle-Aquitaine;23;1;10;204;Saint-Julien-le-Châtel;142;3;145
75;Nouvelle-Aquitaine;23;2;05;205;Saint-Junien-la-Bregère;143;1;144
75;Nouvelle-Aquitaine;23;2;12;206;Saint-Laurent;689;13;702
75;Nouvelle-Aquitaine;23;2;15;207;Saint-Léger-Bridereix;195;3;198
75;Nouvelle-Aquitaine;23;2;14;208;Saint-Léger-le-Guérétois;415;9;424
75;Nouvelle-Aquitaine;23;1;10;209;Saint-Loup;184;1;185
75;Nouvelle-Aquitaine;23;1;02;210;Saint-Maixant;253;2;255
75;Nouvelle-Aquitaine;23;1;02;211;Saint-Marc-à-Frongier;426;9;435
75;Nouvelle-Aquitaine;23;1;09;212;Saint-Marc-à-Loubaud;129;1;130
75;Nouvelle-Aquitaine;23;1;06;213;Saint-Marien;181;2;183
75;Nouvelle-Aquitaine;23;2;01;214;Saint-Martial-le-Mont;272;5;277
75;Nouvelle-Aquitaine;23;1;03;215;Saint-Martial-le-Vieux;139;4;143
75;Nouvelle-Aquitaine;23;2;09;216;Saint-Martin-Château;146;5;151
75;Nouvelle-Aquitaine;23;2;05;217;Saint-Martin-Sainte-Catherine;343;5;348
75;Nouvelle-Aquitaine;23;1;03;218;Saint-Maurice-près-Crocq;98;1;99
75;Nouvelle-Aquitaine;23;2;15;219;Saint-Maurice-la-Souterraine;1222;28;1250
75;Nouvelle-Aquitaine;23;1;10;220;Saint-Médard-la-Rochette;566;12;578
75;Nouvelle-Aquitaine;23;1;03;221;Saint-Merd-la-Breuille;193;5;198
75;Nouvelle-Aquitaine;23;2;01;222;Saint-Michel-de-Veisse;161;3;164
75;Nouvelle-Aquitaine;23;2;05;223;Saint-Moreil;215;0;215
75;Nouvelle-Aquitaine;23;1;03;224;Saint-Oradoux-de-Chirouze;72;0;72
75;Nouvelle-Aquitaine;23;1;03;225;Saint-Oradoux-près-Crocq;104;1;105
75;Nouvelle-Aquitaine;23;1;03;226;Saint-Pardoux-d'Arnet;169;6;175
75;Nouvelle-Aquitaine;23;2;05;227;Saint-Pardoux-Morterolles;201;8;209
75;Nouvelle-Aquitaine;23;1;02;228;Saint-Pardoux-le-Neuf;197;5;202
75;Nouvelle-Aquitaine;23;1;10;229;Saint-Pardoux-les-Cards;284;2;286
75;Nouvelle-Aquitaine;23;2;05;230;Saint-Pierre-Chérignat;166;5;171
75;Nouvelle-Aquitaine;23;2;05;232;Saint-Pierre-Bellevue;209;1;210
75;Nouvelle-Aquitaine;23;1;06;233;Saint-Pierre-le-Bost;126;7;133
75;Nouvelle-Aquitaine;23;1;08;234;Saint-Priest;155;1;156
75;Nouvelle-Aquitaine;23;2;15;235;Saint-Priest-la-Feuille;777;13;790
75;Nouvelle-Aquitaine;23;2;11;236;Saint-Priest-la-Plaine;257;8;265
75;Nouvelle-Aquitaine;23;2;05;237;Saint-Priest-Palus;55;0;55
75;Nouvelle-Aquitaine;23;1;09;238;Saint-Quentin-la-Chabanne;385;7;392
75;Nouvelle-Aquitaine;23;2;07;239;Saint-Sébastien;632;11;643
75;Nouvelle-Aquitaine;23;1;06;240;Saint-Silvain-Bas-le-Roc;405;5;410
75;Nouvelle-Aquitaine;23;1;02;241;Saint-Silvain-Bellegarde;215;3;218
75;Nouvelle-Aquitaine;23;2;13;242;Saint-Silvain-Montaigut;226;3;229
75;Nouvelle-Aquitaine;23;1;10;243;Saint-Silvain-sous-Toulx;154;2;156
75;Nouvelle-Aquitaine;23;2;07;244;Saint-Sulpice-le-Dunois;587;14;601
75;Nouvelle-Aquitaine;23;2;14;245;Saint-Sulpice-le-Guérétois;1935;57;1992
75;Nouvelle-Aquitaine;23;1;02;246;Saint-Sulpice-les-Champs;350;9;359
75;Nouvelle-Aquitaine;23;2;14;247;Saint-Vaury;1738;114;1852
75;Nouvelle-Aquitaine;23;2;13;248;Saint-Victor-en-Marche;359;8;367
75;Nouvelle-Aquitaine;23;1;09;249;Saint-Yrieix-la-Montagne;221;7;228
75;Nouvelle-Aquitaine;23;2;01;250;Saint-Yrieix-les-Bois;289;3;292
75;Nouvelle-Aquitaine;23;1;08;251;Tardes;126;2;128
75;Nouvelle-Aquitaine;23;2;06;252;Tercillat;156;3;159
75;Nouvelle-Aquitaine;23;2;01;253;Thauron;175;6;181
75;Nouvelle-Aquitaine;23;1;06;254;Toulx-Sainte-Croix;254;2;256
75;Nouvelle-Aquitaine;23;1;10;255;Trois-Fonds;122;0;122
75;Nouvelle-Aquitaine;23;1;09;257;Vallière;715;18;733
75;Nouvelle-Aquitaine;23;2;15;258;Vareilles;306;9;315
75;Nouvelle-Aquitaine;23;1;08;259;Verneiges;120;1;121
75;Nouvelle-Aquitaine;23;2;01;260;Vidaillat;180;0;180
75;Nouvelle-Aquitaine;23;1;08;261;Viersat;288;5;293
75;Nouvelle-Aquitaine;23;1;10;262;Vigeville;164;2;166
75;Nouvelle-Aquitaine;23;2;07;263;Villard;374;5;379
75;Nouvelle-Aquitaine;23;1;09;264;La Villedieu;47;1;48
75;Nouvelle-Aquitaine;23;1;03;265;La Villeneuve;54;0;54
75;Nouvelle-Aquitaine;23;1;03;266;La Villetelle;171;1;172
75;Nouvelle-Aquitaine;24;2;13;001;Abjat-sur-Bandiat;622;7;629
75;Nouvelle-Aquitaine;24;3;22;002;Agonac;1772;23;1795
75;Nouvelle-Aquitaine;24;4;05;004;Ajat;296;3;299
75;Nouvelle-Aquitaine;24;1;08;005;Alles-sur-Dordogne;385;9;394
75;Nouvelle-Aquitaine;24;4;23;006;Allas-les-Mines;196;10;206
75;Nouvelle-Aquitaine;24;3;16;007;Allemans;500;13;513
75;Nouvelle-Aquitaine;24;2;06;008;Angoisse;588;10;598
75;Nouvelle-Aquitaine;24;2;06;009;Anlhiac;268;8;276
75;Nouvelle-Aquitaine;24;3;17;010;Annesse-et-Beaulieu;1419;49;1468
75;Nouvelle-Aquitaine;24;3;22;011;Antonne-et-Trigonant;1297;19;1316
75;Nouvelle-Aquitaine;24;4;20;012;Archignac;380;9;389
75;Nouvelle-Aquitaine;24;4;25;014;Aubas;622;20;642
75;Nouvelle-Aquitaine;24;4;23;015;Audrix;268;4;272
75;Nouvelle-Aquitaine;24;2;13;016;Augignac;821;20;841
75;Nouvelle-Aquitaine;24;4;05;018;Auriac-du-Périgord;399;10;409
75;Nouvelle-Aquitaine;24;4;05;019;Azerat;436;7;443
75;Nouvelle-Aquitaine;24;4;05;020;La Bachellerie;894;20;914
75;Nouvelle-Aquitaine;24;4;05;021;Badefols-d'Ans;391;8;399
75;Nouvelle-Aquitaine;24;1;08;022;Badefols-sur-Dordogne;210;5;215
75;Nouvelle-Aquitaine;24;1;08;023;Baneuil;328;11;339
75;Nouvelle-Aquitaine;24;1;19;024;Bardou;48;0;48
75;Nouvelle-Aquitaine;24;4;05;025;Bars;239;7;246
75;Nouvelle-Aquitaine;24;3;89;026;Bassillac et Auberoche;4410;82;4492
75;Nouvelle-Aquitaine;24;1;08;027;Bayac;360;1;361
75;Nouvelle-Aquitaine;24;1;08;028;Beaumontois en Périgord;1842;42;1884
75;Nouvelle-Aquitaine;24;3;24;029;Beaupouyet;525;7;532
75;Nouvelle-Aquitaine;24;4;05;030;Beauregard-de-Terrasson;684;16;700
75;Nouvelle-Aquitaine;24;3;12;031;Beauregard-et-Bassac;255;5;260
75;Nouvelle-Aquitaine;24;3;24;032;Beauronne;371;10;381
75;Nouvelle-Aquitaine;24;3;12;034;Beleymas;273;7;280
75;Nouvelle-Aquitaine;24;4;23;035;Pays de Belvès;1350;36;1386
75;Nouvelle-Aquitaine;24;4;23;036;Berbiguières;177;3;180
75;Nouvelle-Aquitaine;24;1;98;037;Bergerac;26693;715;27408
75;Nouvelle-Aquitaine;24;3;16;038;Bertric-Burée;432;12;444
75;Nouvelle-Aquitaine;24;4;23;039;Besse;161;4;165
75;Nouvelle-Aquitaine;24;4;18;040;Beynac-et-Cazenac;544;9;553
75;Nouvelle-Aquitaine;24;2;03;042;Biras;670;7;677
75;Nouvelle-Aquitaine;24;1;08;043;Biron;144;10;154
75;Nouvelle-Aquitaine;24;1;19;045;Boisse;246;4;250
75;Nouvelle-Aquitaine;24;4;05;046;Boisseuilh;120;1;121
75;Nouvelle-Aquitaine;24;1;11;048;Bonneville-et-Saint-Avit-de-Fumadières;322;7;329
75;Nouvelle-Aquitaine;24;4;20;050;Borrèze;341;12;353
75;Nouvelle-Aquitaine;24;1;10;051;Bosset;213;6;219
75;Nouvelle-Aquitaine;24;1;08;052;Bouillac;127;0;127
75;Nouvelle-Aquitaine;24;3;07;053;Boulazac Isle Manoire;10737;341;11078
75;Nouvelle-Aquitaine;24;1;19;054;Bouniagues;609;20;629
75;Nouvelle-Aquitaine;24;2;03;055;Bourdeilles;765;16;781
75;Nouvelle-Aquitaine;24;2;13;056;Le Bourdeix;227;4;231
75;Nouvelle-Aquitaine;24;3;16;057;Bourg-des-Maisons;67;0;67
75;Nouvelle-Aquitaine;24;3;16;058;Bourg-du-Bost;218;3;221
75;Nouvelle-Aquitaine;24;3;24;059;Bourgnac;349;6;355
75;Nouvelle-Aquitaine;24;1;08;060;Bourniquel;71;1;72
75;Nouvelle-Aquitaine;24;3;12;061;Bourrou;124;6;130
75;Nouvelle-Aquitaine;24;3;16;062;Bouteilles-Saint-Sébastien;175;3;178
75;Nouvelle-Aquitaine;24;4;23;063;Bouzic;150;3;153
75;Nouvelle-Aquitaine;24;2;03;064;Brantôme en Périgord;3670;56;3726
75;Nouvelle-Aquitaine;24;2;06;066;Brouchaud;213;5;218
75;Nouvelle-Aquitaine;24;4;25;067;Le Bugue;2588;42;2630
75;Nouvelle-Aquitaine;24;1;08;068;Le Buisson-de-Cadouin;1927;60;1987
75;Nouvelle-Aquitaine;24;2;03;069;Bussac;395;2;397
75;Nouvelle-Aquitaine;24;2;13;070;Busserolles;506;9;515
75;Nouvelle-Aquitaine;24;2;13;071;Bussière-Badil;374;2;376
75;Nouvelle-Aquitaine;24;1;08;073;Calès;378;12;390
75;Nouvelle-Aquitaine;24;4;20;074;Calviac-en-Périgord;510;21;531
75;Nouvelle-Aquitaine;24;4;23;075;Campagnac-lès-Quercy;319;8;327
75;Nouvelle-Aquitaine;24;4;25;076;Campagne;403;14;417
75;Nouvelle-Aquitaine;24;3;12;077;Campsegret;394;8;402
75;Nouvelle-Aquitaine;24;1;08;080;Capdrot;476;12;488
75;Nouvelle-Aquitaine;24;4;20;081;Carlux;634;10;644
75;Nouvelle-Aquitaine;24;4;20;082;Carsac-Aillac;1529;28;1557
75;Nouvelle-Aquitaine;24;1;11;083;Carsac-de-Gurson;185;4;189
75;Nouvelle-Aquitaine;24;4;23;084;Carves;104;4;108
75;Nouvelle-Aquitaine;24;4;20;085;La Cassagne;154;1;155
75;Nouvelle-Aquitaine;24;4;23;086;Castelnaud-la-Chapelle;448;7;455
75;Nouvelle-Aquitaine;24;4;23;087;Castels et Bézenac;815;19;834
75;Nouvelle-Aquitaine;24;1;08;088;Cause-de-Clérans;347;7;354
75;Nouvelle-Aquitaine;24;4;20;089;Cazoulès;450;13;463
75;Nouvelle-Aquitaine;24;3;16;090;Celles;589;11;600
75;Nouvelle-Aquitaine;24;4;23;091;Cénac-et-Saint-Julien;1204;32;1236
75;Nouvelle-Aquitaine;24;3;12;094;Chalagnac;439;9;448
75;Nouvelle-Aquitaine;24;2;21;095;Chalais;405;9;414
75;Nouvelle-Aquitaine;24;2;03;096;Champagnac-de-Belair;789;14;803
75;Nouvelle-Aquitaine;24;3;16;097;Champagne-et-Fontaine;354;10;364
75;Nouvelle-Aquitaine;24;3;22;098;Champcevinel;2965;90;3055
75;Nouvelle-Aquitaine;24;2;13;100;Champniers-et-Reilhac;453;3;456
75;Nouvelle-Aquitaine;24;2;13;101;Champs-Romain;282;8;290
75;Nouvelle-Aquitaine;24;3;04;102;Chancelade;4378;82;4460
75;Nouvelle-Aquitaine;24;3;24;104;Chantérac;617;7;624
75;Nouvelle-Aquitaine;24;3;03;105;Chapdeuil;135;1;136
75;Nouvelle-Aquitaine;24;4;25;106;La Chapelle-Aubareil;533;23;556
75;Nouvelle-Aquitaine;24;2;03;107;La Chapelle-Faucher;395;6;401
75;Nouvelle-Aquitaine;24;3;17;108;La Chapelle-Gonaguet;1074;16;1090
75;Nouvelle-Aquitaine;24;3;16;109;La Chapelle-Grésignac;104;2;106
75;Nouvelle-Aquitaine;24;3;16;110;La Chapelle-Montabourlet;61;4;65
75;Nouvelle-Aquitaine;24;2;03;111;La Chapelle-Montmoreau;72;1;73
75;Nouvelle-Aquitaine;24;4;05;113;La Chapelle-Saint-Jean;91;1;92
75;Nouvelle-Aquitaine;24;3;16;114;Chassaignes;68;2;70
75;Nouvelle-Aquitaine;24;3;22;115;Château-l'Évêque;2148;31;2179
75;Nouvelle-Aquitaine;24;4;05;116;Châtres;187;1;188
75;Nouvelle-Aquitaine;24;4;20;117;Les Coteaux Périgourdins;572;18;590
75;Nouvelle-Aquitaine;24;3;16;119;Cherval;250;4;254
75;Nouvelle-Aquitaine;24;2;06;120;Cherveix-Cubas;554;12;566
75;Nouvelle-Aquitaine;24;4;05;121;Chourgnac;59;2;61
75;Nouvelle-Aquitaine;24;4;23;122;Cladech;110;1;111
75;Nouvelle-Aquitaine;24;3;12;123;Clermont-de-Beauregard;119;1;120
75;Nouvelle-Aquitaine;24;2;06;124;Clermont-d'Excideuil;235;5;240
75;Nouvelle-Aquitaine;24;1;19;126;Colombier;266;12;278
75;Nouvelle-Aquitaine;24;3;16;128;Comberanche-et-Épeluche;166;3;169
75;Nouvelle-Aquitaine;24;2;03;129;Condat-sur-Trincou;478;8;486
75;Nouvelle-Aquitaine;24;4;20;130;Condat-sur-Vézère;880;16;896
75;Nouvelle-Aquitaine;24;2;13;131;Connezac;71;0;71
75;Nouvelle-Aquitaine;24;1;19;132;Conne-de-Labarde;258;4;262
75;Nouvelle-Aquitaine;24;2;21;133;La Coquille;1276;18;1294
75;Nouvelle-Aquitaine;24;2;21;134;Corgnac-sur-l'Isle;838;13;851
75;Nouvelle-Aquitaine;24;3;22;135;Cornille;683;12;695
75;Nouvelle-Aquitaine;24;4;05;136;Coubjours;118;6;124
75;Nouvelle-Aquitaine;24;2;06;137;Coulaures;726;77;803
75;Nouvelle-Aquitaine;24;3;04;138;Coulounieix-Chamiers;7387;296;7683
75;Nouvelle-Aquitaine;24;3;17;139;Coursac;2211;48;2259
75;Nouvelle-Aquitaine;24;1;02;140;Cours-de-Pile;1563;34;1597
75;Nouvelle-Aquitaine;24;3;16;141;Coutures;182;1;183
75;Nouvelle-Aquitaine;24;4;23;142;Coux et Bigaroque-Mouzens;1219;42;1261
75;Nouvelle-Aquitaine;24;1;08;143;Couze-et-Saint-Front;725;8;733
75;Nouvelle-Aquitaine;24;3;03;144;Creyssac;95;0;95
75;Nouvelle-Aquitaine;24;1;02;145;Creysse;1749;30;1779
75;Nouvelle-Aquitaine;24;3;12;146;Creyssensac-et-Pissot;255;9;264
75;Nouvelle-Aquitaine;24;2;06;147;Cubjac-Auvézère-Val d'Ans;1090;10;1100
75;Nouvelle-Aquitaine;24;1;19;148;Cunèges;285;5;290
75;Nouvelle-Aquitaine;24;4;23;150;Daglan;529;19;548
75;Nouvelle-Aquitaine;24;4;23;151;Doissat;103;2;105
75;Nouvelle-Aquitaine;24;4;23;152;Domme;909;22;931
75;Nouvelle-Aquitaine;24;4;20;153;La Dornac;398;11;409
75;Nouvelle-Aquitaine;24;3;03;154;Douchapt;354;10;364
75;Nouvelle-Aquitaine;24;3;12;155;Douville;465;11;476
75;Nouvelle-Aquitaine;24;3;07;156;La Douze;1165;16;1181
75;Nouvelle-Aquitaine;24;3;24;157;Douzillac;792;11;803
75;Nouvelle-Aquitaine;24;2;06;158;Dussac;399;4;403
75;Nouvelle-Aquitaine;24;3;09;159;Échourgnac;392;7;399
75;Nouvelle-Aquitaine;24;3;12;160;Église-Neuve-de-Vergt;563;2;565
75;Nouvelle-Aquitaine;24;3;12;161;Église-Neuve-d'Issac;129;1;130
75;Nouvelle-Aquitaine;24;3;22;162;Escoire;408;9;417
75;Nouvelle-Aquitaine;24;2;13;163;Étouars;159;1;160
75;Nouvelle-Aquitaine;24;2;06;164;Excideuil;1171;40;1211
75;Nouvelle-Aquitaine;24;3;09;165;Eygurande-et-Gardedeuil;415;7;422
75;Nouvelle-Aquitaine;24;1;19;167;Eymet;2564;40;2604
75;Nouvelle-Aquitaine;24;1;19;168;Plaisance;431;13;444
75;Nouvelle-Aquitaine;24;2;21;171;Eyzerac;557;8;565
75;Nouvelle-Aquitaine;24;4;25;172;Les Eyzies;1097;16;1113
75;Nouvelle-Aquitaine;24;4;25;174;Fanlac;138;1;139
75;Nouvelle-Aquitaine;24;4;25;175;Les Farges;316;17;333
75;Nouvelle-Aquitaine;24;1;19;176;Faurilles;36;0;36
75;Nouvelle-Aquitaine;24;1;19;177;Faux;644;10;654
75;Nouvelle-Aquitaine;24;4;20;179;La Feuillade;770;28;798
75;Nouvelle-Aquitaine;24;2;21;180;Firbeix;317;9;326
75;Nouvelle-Aquitaine;24;1;10;182;Le Fleix;1488;53;1541
75;Nouvelle-Aquitaine;24;4;25;183;Fleurac;281;3;284
75;Nouvelle-Aquitaine;24;4;23;184;Florimont-Gaumier;147;2;149
75;Nouvelle-Aquitaine;24;1;19;186;Fonroque;332;2;334
75;Nouvelle-Aquitaine;24;4;05;188;Fossemagne;537;13;550
75;Nouvelle-Aquitaine;24;1;11;189;Fougueyrolles;447;16;463
75;Nouvelle-Aquitaine;24;3;12;190;Fouleix;263;8;271
75;Nouvelle-Aquitaine;24;1;10;191;Fraisse;173;1;174
75;Nouvelle-Aquitaine;24;4;05;192;Gabillou;91;3;94
75;Nouvelle-Aquitaine;24;1;19;193;Gageac-et-Rouillac;477;9;486
75;Nouvelle-Aquitaine;24;1;10;194;Gardonne;1600;25;1625
75;Nouvelle-Aquitaine;24;1;08;195;Gaugeac;109;1;110
75;Nouvelle-Aquitaine;24;2;06;196;Génis;490;4;494
75;Nouvelle-Aquitaine;24;1;10;197;Ginestet;721;14;735
75;Nouvelle-Aquitaine;24;3;16;199;Gout-Rossignol;370;7;377
75;Nouvelle-Aquitaine;24;3;03;200;Grand-Brassac;543;11;554
75;Nouvelle-Aquitaine;24;4;05;202;Granges-d'Ans;146;4;150
75;Nouvelle-Aquitaine;24;3;17;205;Grignols;670;5;675
75;Nouvelle-Aquitaine;24;4;23;206;Grives;109;4;113
75;Nouvelle-Aquitaine;24;4;23;207;Groléjac;652;16;668
75;Nouvelle-Aquitaine;24;3;12;208;Grun-Bordas;242;4;246
75;Nouvelle-Aquitaine;24;2;13;209;Hautefaye;139;1;140
75;Nouvelle-Aquitaine;24;4;05;210;Hautefort;859;20;879
75;Nouvelle-Aquitaine;24;3;12;211;Issac;435;3;438
75;Nouvelle-Aquitaine;24;1;19;212;Issigeac;740;10;750
75;Nouvelle-Aquitaine;24;3;17;213;Jaure;171;2;173
75;Nouvelle-Aquitaine;24;2;13;214;Javerlhac-et-la-Chapelle-Saint-Robert;835;10;845
75;Nouvelle-Aquitaine;24;4;20;215;Jayac;178;3;181
75;Nouvelle-Aquitaine;24;3;16;216;La Jemaye-Ponteyraud;153;3;156
75;Nouvelle-Aquitaine;24;4;25;217;Journiac;451;8;459
75;Nouvelle-Aquitaine;24;2;21;218;Jumilhac-le-Grand;1175;44;1219
75;Nouvelle-Aquitaine;24;3;12;220;Lacropte;674;8;682
75;Nouvelle-Aquitaine;24;2;03;221;Rudeau-Ladosse;158;3;161
75;Nouvelle-Aquitaine;24;1;10;222;La Force;2653;96;2749
75;Nouvelle-Aquitaine;24;1;08;223;Lalinde;2770;37;2807
75;Nouvelle-Aquitaine;24;1;02;224;Lamonzie-Montastruc;694;12;706
75;Nouvelle-Aquitaine;24;1;10;225;Lamonzie-Saint-Martin;2609;35;2644
75;Nouvelle-Aquitaine;24;1;11;226;Lamothe-Montravel;1377;21;1398
75;Nouvelle-Aquitaine;24;2;06;227;Lanouaille;981;24;1005
75;Nouvelle-Aquitaine;24;1;08;228;Lanquais;496;13;509
75;Nouvelle-Aquitaine;24;4;05;229;Le Lardin-Saint-Lazare;1688;38;1726
75;Nouvelle-Aquitaine;24;4;23;230;Larzac;148;1;149
75;Nouvelle-Aquitaine;24;1;08;231;Lavalade;94;1;95
75;Nouvelle-Aquitaine;24;4;23;232;Lavaur;70;2;72
75;Nouvelle-Aquitaine;24;3;24;234;Les Lèches;370;2;372
75;Nouvelle-Aquitaine;24;3;17;236;Léguillac-de-l'Auche;994;15;1009
75;Nouvelle-Aquitaine;24;1;02;237;Lembras;1208;24;1232
75;Nouvelle-Aquitaine;24;2;21;238;Lempzours;137;5;142
75;Nouvelle-Aquitaine;24;4;12;240;Limeuil;334;7;341
75;Nouvelle-Aquitaine;24;4;05;241;Limeyrat;443;10;453
75;Nouvelle-Aquitaine;24;1;08;242;Liorac-sur-Louyre;256;1;257
75;Nouvelle-Aquitaine;24;3;03;243;Lisle;836;11;847
75;Nouvelle-Aquitaine;24;1;08;244;Lolme;193;2;195
75;Nouvelle-Aquitaine;24;4;23;245;Loubejac;261;3;264
75;Nouvelle-Aquitaine;24;1;10;246;Lunas;411;5;416
75;Nouvelle-Aquitaine;24;3;16;247;Lusignac;167;3;170
75;Nouvelle-Aquitaine;24;2;13;248;Lussas-et-Nontronneau;283;7;290
75;Nouvelle-Aquitaine;24;3;17;251;Manzac-sur-Vern;568;9;577
75;Nouvelle-Aquitaine;24;4;18;252;Marcillac-Saint-Quentin;815;20;835
75;Nouvelle-Aquitaine;24;2;03;253;Mareuil en Périgord;2280;47;2327
75;Nouvelle-Aquitaine;24;4;23;254;Marnac;186;1;187
75;Nouvelle-Aquitaine;24;4;18;255;Marquay;584;9;593
75;Nouvelle-Aquitaine;24;3;04;256;Marsac-sur-l'Isle;3142;75;3217
75;Nouvelle-Aquitaine;24;1;08;257;Marsalès;233;5;238
75;Nouvelle-Aquitaine;24;3;12;259;Eyraud-Crempse-Maurens;1572;31;1603
75;Nouvelle-Aquitaine;24;1;08;260;Mauzac-et-Grand-Castang;868;9;877
75;Nouvelle-Aquitaine;24;4;25;261;Mauzens-et-Miremont;289;10;299
75;Nouvelle-Aquitaine;24;2;06;262;Mayac;346;7;353
75;Nouvelle-Aquitaine;24;4;23;263;Mazeyrolles;303;13;316
75;Nouvelle-Aquitaine;24;3;09;264;Ménesplet;1850;15;1865
75;Nouvelle-Aquitaine;24;3;17;266;Mensignac;1524;27;1551
75;Nouvelle-Aquitaine;24;1;19;267;Mescoules;178;1;179
75;Nouvelle-Aquitaine;24;4;23;268;Meyrals;660;13;673
75;Nouvelle-Aquitaine;24;2;21;269;Mialet;628;7;635
75;Nouvelle-Aquitaine;24;2;13;271;Milhac-de-Nontron;492;13;505
75;Nouvelle-Aquitaine;24;1;11;272;Minzac;468;5;473
75;Nouvelle-Aquitaine;24;1;08;273;Molières;335;10;345
75;Nouvelle-Aquitaine;24;1;19;274;Monbazillac;804;88;892
75;Nouvelle-Aquitaine;24;1;19;276;Monestier;404;4;408
75;Nouvelle-Aquitaine;24;1;10;277;Monfaucon;290;4;294
75;Nouvelle-Aquitaine;24;1;19;278;Monmadalès;83;1;84
75;Nouvelle-Aquitaine;24;1;19;279;Monmarvès;63;1;64
75;Nouvelle-Aquitaine;24;1;08;280;Monpazier;459;8;467
75;Nouvelle-Aquitaine;24;1;08;281;Monsac;193;7;200
75;Nouvelle-Aquitaine;24;1;19;282;Monsaguel;145;7;152
75;Nouvelle-Aquitaine;24;4;05;284;Montagnac-d'Auberoche;137;5;142
75;Nouvelle-Aquitaine;24;3;12;285;Montagnac-la-Crempse;410;13;423
75;Nouvelle-Aquitaine;24;3;03;286;Montagrier;496;10;506
75;Nouvelle-Aquitaine;24;1;19;287;Montaut;125;2;127
75;Nouvelle-Aquitaine;24;1;11;288;Montazeau;285;4;289
75;Nouvelle-Aquitaine;24;1;11;289;Montcaret;1476;21;1497
75;Nouvelle-Aquitaine;24;1;08;290;Montferrand-du-Périgord;156;5;161
75;Nouvelle-Aquitaine;24;4;25;291;Montignac-Lascaux;2753;55;2808
75;Nouvelle-Aquitaine;24;1;11;292;Montpeyroux;458;7;465
75;Nouvelle-Aquitaine;24;4;23;293;Monplaisant;300;4;304
75;Nouvelle-Aquitaine;24;3;09;294;Montpon-Ménestérol;5704;69;5773
75;Nouvelle-Aquitaine;24;3;17;295;Montrem;1214;20;1234
75;Nouvelle-Aquitaine;24;1;02;296;Mouleydier;1139;15;1154
75;Nouvelle-Aquitaine;24;3;09;297;Moulin-Neuf;942;13;955
75;Nouvelle-Aquitaine;24;3;24;299;Mussidan;2762;50;2812
75;Nouvelle-Aquitaine;24;4;23;300;Nabirat;369;10;379
75;Nouvelle-Aquitaine;24;4;20;301;Nadaillac;384;4;388
75;Nouvelle-Aquitaine;24;4;05;302;Nailhac;308;2;310
75;Nouvelle-Aquitaine;24;3;16;303;Nanteuil-Auriac-de-Bourzac;231;3;234
75;Nouvelle-Aquitaine;24;2;21;304;Nantheuil;974;23;997
75;Nouvelle-Aquitaine;24;2;21;305;Nanthiat;237;2;239
75;Nouvelle-Aquitaine;24;1;11;306;Nastringues;126;4;130
75;Nouvelle-Aquitaine;24;1;08;307;Naussannes;265;5;270
75;Nouvelle-Aquitaine;24;2;21;308;Négrondes;797;10;807
75;Nouvelle-Aquitaine;24;3;24;309;Neuvic;3611;67;3678
75;Nouvelle-Aquitaine;24;2;13;311;Nontron;3055;111;3166
75;Nouvelle-Aquitaine;24;3;88;312;Sanilhac;4604;101;4705
75;Nouvelle-Aquitaine;24;4;23;313;Orliac;53;0;53
75;Nouvelle-Aquitaine;24;4;20;314;Orliaguet;109;9;118
75;Nouvelle-Aquitaine;24;3;09;316;Parcoul-Chenaud;789;16;805
75;Nouvelle-Aquitaine;24;4;20;317;Paulin;254;8;262
75;Nouvelle-Aquitaine;24;3;12;318;Paunat;312;8;320
75;Nouvelle-Aquitaine;24;3;03;319;Paussac-et-Saint-Vivien;474;7;481
75;Nouvelle-Aquitaine;24;2;06;320;Payzac;974;17;991
75;Nouvelle-Aquitaine;24;4;20;321;Pazayac;893;13;906
75;Nouvelle-Aquitaine;24;3;99;322;Périgueux;29896;1580;31476
75;Nouvelle-Aquitaine;24;3;16;323;Petit-Bersac;183;5;188
75;Nouvelle-Aquitaine;24;4;05;324;Peyrignac;570;9;579
75;Nouvelle-Aquitaine;24;4;20;325;Peyrillac-et-Millac;206;4;210
75;Nouvelle-Aquitaine;24;4;25;326;Peyzac-le-Moustier;187;2;189
75;Nouvelle-Aquitaine;24;1;08;327;Pezuls;127;3;130
75;Nouvelle-Aquitaine;24;2;13;328;Piégut-Pluviers;1179;20;1199
75;Nouvelle-Aquitaine;24;3;09;329;Le Pizou;1325;19;1344
75;Nouvelle-Aquitaine;24;4;25;330;Plazac;688;27;715
75;Nouvelle-Aquitaine;24;1;19;331;Pomport;721;23;744
75;Nouvelle-Aquitaine;24;1;08;334;Pontours;188;5;193
75;Nouvelle-Aquitaine;24;1;11;335;Port-Sainte-Foy-et-Ponchapt;2478;46;2524
75;Nouvelle-Aquitaine;24;4;20;336;Prats-de-Carlux;529;19;548
75;Nouvelle-Aquitaine;24;4;23;337;Prats-du-Périgord;147;2;149
75;Nouvelle-Aquitaine;24;1;08;338;Pressignac-Vicq;426;11;437
75;Nouvelle-Aquitaine;24;2;06;339;Preyssac-d'Excideuil;148;0;148
75;Nouvelle-Aquitaine;24;1;10;340;Prigonrieux;4143;80;4223
75;Nouvelle-Aquitaine;24;4;18;341;Proissans;1043;20;1063
75;Nouvelle-Aquitaine;24;1;02;345;Queyssac;467;15;482
75;Nouvelle-Aquitaine;24;2;03;346;Quinsac;377;9;386
75;Nouvelle-Aquitaine;24;1;08;347;Rampieux;145;0;145
75;Nouvelle-Aquitaine;24;1;19;348;Razac-d'Eymet;305;1;306
75;Nouvelle-Aquitaine;24;1;19;349;Razac-de-Saussignac;339;10;349
75;Nouvelle-Aquitaine;24;3;04;350;Razac-sur-l'Isle;2392;41;2433
75;Nouvelle-Aquitaine;24;1;19;351;Ribagnac;310;6;316
75;Nouvelle-Aquitaine;24;3;16;352;Ribérac;3844;148;3992
75;Nouvelle-Aquitaine;24;2;03;353;La Rochebeaucourt-et-Argentine;331;9;340
75;Nouvelle-Aquitaine;24;3;09;354;La Roche-Chalais;3022;52;3074
75;Nouvelle-Aquitaine;24;4;18;355;La Roque-Gageac;427;4;431
75;Nouvelle-Aquitaine;24;4;25;356;Rouffignac-Saint-Cernin-de-Reilhac;1628;35;1663
75;Nouvelle-Aquitaine;24;1;19;357;Rouffignac-de-Sigoulès;301;6;307
75;Nouvelle-Aquitaine;24;1;19;359;Sadillac;122;0;122
75;Nouvelle-Aquitaine;24;4;23;360;Sagelat;319;5;324
75;Nouvelle-Aquitaine;24;1;08;361;Saint-Agne;445;8;453
75;Nouvelle-Aquitaine;24;3;12;362;Val de Louyre et Caudeau;1588;26;1614
75;Nouvelle-Aquitaine;24;4;25;364;Coly-Saint-Amand;567;20;587
75;Nouvelle-Aquitaine;24;3;12;365;Saint-Amand-de-Vergt;240;8;248
75;Nouvelle-Aquitaine;24;4;18;366;Saint-André-d'Allas;856;20;876
75;Nouvelle-Aquitaine;24;3;16;367;Saint-André-de-Double;179;2;181
75;Nouvelle-Aquitaine;24;1;11;370;Saint-Antoine-de-Breuilh;1860;39;1899
75;Nouvelle-Aquitaine;24;3;24;371;Saint-Aquilin;468;3;471
75;Nouvelle-Aquitaine;24;3;17;372;Saint-Astier;5352;94;5446
75;Nouvelle-Aquitaine;24;1;19;373;Saint-Aubin-de-Cadelech;341;8;349
75;Nouvelle-Aquitaine;24;1;19;374;Saint-Aubin-de-Lanquais;353;4;357
75;Nouvelle-Aquitaine;24;4;23;375;Saint-Aubin-de-Nabirat;148;3;151
75;Nouvelle-Aquitaine;24;3;09;376;Saint Aulaye-Puymangou;1426;19;1445
75;Nouvelle-Aquitaine;24;4;25;377;Saint-Avit-de-Vialard;158;7;165
75;Nouvelle-Aquitaine;24;1;08;378;Saint-Avit-Rivière;81;1;82
75;Nouvelle-Aquitaine;24;1;08;379;Saint-Avit-Sénieur;418;4;422
75;Nouvelle-Aquitaine;24;3;09;380;Saint-Barthélemy-de-Bellegarde;484;2;486
75;Nouvelle-Aquitaine;24;2;13;381;Saint-Barthélemy-de-Bussière;213;8;221
75;Nouvelle-Aquitaine;24;1;08;382;Saint-Capraise-de-Lalinde;526;9;535
75;Nouvelle-Aquitaine;24;1;19;383;Saint-Capraise-d'Eymet;164;2;166
75;Nouvelle-Aquitaine;24;1;08;384;Saint-Cassien;37;1;38
75;Nouvelle-Aquitaine;24;1;19;385;Saint-Cernin-de-Labarde;225;2;227
75;Nouvelle-Aquitaine;24;4;23;386;Saint-Cernin-de-l'Herm;215;10;225
75;Nouvelle-Aquitaine;24;4;25;388;Saint-Chamassy;493;15;508
75;Nouvelle-Aquitaine;24;3;07;390;Saint-Crépin-d'Auberoche;342;9;351
75;Nouvelle-Aquitaine;24;4;20;392;Saint-Crépin-et-Carlucet;519;10;529
75;Nouvelle-Aquitaine;24;1;08;393;Sainte-Croix;88;0;88
75;Nouvelle-Aquitaine;24;2;03;394;Sainte-Croix-de-Mareuil;155;7;162
75;Nouvelle-Aquitaine;24;4;23;395;Saint-Cybranet;368;6;374
75;Nouvelle-Aquitaine;24;4;23;396;Saint-Cyprien;1548;34;1582
75;Nouvelle-Aquitaine;24;2;06;397;Saint-Cyr-les-Champagnes;236;7;243
75;Nouvelle-Aquitaine;24;2;13;398;Saint-Estèphe;599;7;606
75;Nouvelle-Aquitaine;24;3;24;399;Saint-Étienne-de-Puycorbier;105;4;109
75;Nouvelle-Aquitaine;24;4;05;401;Sainte-Eulalie-d'Ans;294;4;298
75;Nouvelle-Aquitaine;24;2;03;403;Saint-Félix-de-Bourdeilles;65;0;65
75;Nouvelle-Aquitaine;24;4;25;404;Saint-Félix-de-Reillac-et-Mortemart;176;5;181
75;Nouvelle-Aquitaine;24;1;08;405;Saint-Félix-de-Villadeix;327;9;336
75;Nouvelle-Aquitaine;24;4;23;406;Sainte-Foy-de-Belvès;140;2;142
75;Nouvelle-Aquitaine;24;1;08;407;Sainte-Foy-de-Longas;240;7;247
75;Nouvelle-Aquitaine;24;2;21;408;Saint-Front-d'Alemps;258;4;262
75;Nouvelle-Aquitaine;24;3;24;409;Saint-Front-de-Pradoux;1188;16;1204
75;Nouvelle-Aquitaine;24;2;13;410;Saint-Front-la-Rivière;497;8;505
75;Nouvelle-Aquitaine;24;2;13;411;Saint-Front-sur-Nizonne;162;2;164
75;Nouvelle-Aquitaine;24;4;20;412;Saint-Geniès;914;26;940
75;Nouvelle-Aquitaine;24;1;10;413;Saint-Georges-Blancaneix;269;0;269
75;Nouvelle-Aquitaine;24;3;12;414;Saint-Georges-de-Montclard;287;5;292
75;Nouvelle-Aquitaine;24;1;11;415;Saint-Géraud-de-Corps;251;2;253
75;Nouvelle-Aquitaine;24;4;23;416;Saint-Germain-de-Belvès;172;9;181
75;Nouvelle-Aquitaine;24;2;06;417;Saint-Germain-des-Prés;471;8;479
75;Nouvelle-Aquitaine;24;3;24;418;Saint-Germain-du-Salembre;946;7;953
75;Nouvelle-Aquitaine;24;1;02;419;Saint-Germain-et-Mons;864;19;883
75;Nouvelle-Aquitaine;24;1;10;420;Saint-Géry;243;2;245
75;Nouvelle-Aquitaine;24;3;07;421;Saint-Geyrac;197;6;203
75;Nouvelle-Aquitaine;24;3;12;422;Saint-Hilaire-d'Estissac;116;2;118
75;Nouvelle-Aquitaine;24;1;19;423;Saint-Julien-Innocence-Eulalie;310;3;313
75;Nouvelle-Aquitaine;24;3;24;424;Saint-Jean-d'Ataux;133;3;136
75;Nouvelle-Aquitaine;24;2;21;425;Saint-Jean-de-Côle;364;6;370
75;Nouvelle-Aquitaine;24;3;12;426;Saint-Jean-d'Estissac;166;6;172
75;Nouvelle-Aquitaine;24;2;21;428;Saint-Jory-de-Chalais;601;38;639
75;Nouvelle-Aquitaine;24;2;06;429;Saint-Jory-las-Bloux;236;8;244
75;Nouvelle-Aquitaine;24;4;20;432;Saint-Julien-de-Lampon;637;17;654
75;Nouvelle-Aquitaine;24;3;03;434;Saint-Just;144;2;146
75;Nouvelle-Aquitaine;24;3;24;436;Saint-Laurent-des-Hommes;1024;18;1042
75;Nouvelle-Aquitaine;24;1;10;437;Saint-Laurent-des-Vignes;918;14;932
75;Nouvelle-Aquitaine;24;4;23;438;Saint-Laurent-la-Vallée;236;9;245
75;Nouvelle-Aquitaine;24;1;19;441;Saint-Léon-d'Issigeac;136;3;139
75;Nouvelle-Aquitaine;24;3;17;442;Saint-Léon-sur-l'Isle;2031;23;2054
75;Nouvelle-Aquitaine;24;4;25;443;Saint-Léon-sur-Vézère;416;11;427
75;Nouvelle-Aquitaine;24;3;24;444;Saint-Louis-en-l'Isle;304;7;311
75;Nouvelle-Aquitaine;24;1;08;445;Saint-Marcel-du-Périgord;146;5;151
75;Nouvelle-Aquitaine;24;1;08;446;Saint-Marcory;50;3;53
75;Nouvelle-Aquitaine;24;2;06;448;Saint-Martial-d'Albarède;474;9;483
75;Nouvelle-Aquitaine;24;3;09;449;Saint-Martial-d'Artenset;941;7;948
75;Nouvelle-Aquitaine;24;4;23;450;Saint-Martial-de-Nabirat;575;4;579
75;Nouvelle-Aquitaine;24;2;13;451;Saint-Martial-de-Valette;796;18;814
75;Nouvelle-Aquitaine;24;3;16;452;Saint-Martial-Viveyrol;189;2;191
75;Nouvelle-Aquitaine;24;2;21;453;Saint-Martin-de-Fressengeas;362;6;368
75;Nouvelle-Aquitaine;24;1;11;454;Saint-Martin-de-Gurson;655;7;662
75;Nouvelle-Aquitaine;24;3;16;455;Saint-Martin-de-Ribérac;734;10;744
75;Nouvelle-Aquitaine;24;3;12;456;Saint-Martin-des-Combes;193;8;201
75;Nouvelle-Aquitaine;24;3;24;457;Saint-Martin-l'Astier;138;1;139
75;Nouvelle-Aquitaine;24;2;13;458;Saint-Martin-le-Pin;267;7;274
75;Nouvelle-Aquitaine;24;3;12;459;Saint-Mayme-de-Péreyrol;284;9;293
75;Nouvelle-Aquitaine;24;3;16;460;Saint-Méard-de-Drône;497;6;503
75;Nouvelle-Aquitaine;24;1;11;461;Saint-Méard-de-Gurçon;822;17;839
75;Nouvelle-Aquitaine;24;3;24;462;Saint-Médard-de-Mussidan;1706;24;1730
75;Nouvelle-Aquitaine;24;2;06;463;Saint-Médard-d'Excideuil;547;15;562
75;Nouvelle-Aquitaine;24;2;06;464;Saint-Mesmin;325;6;331
75;Nouvelle-Aquitaine;24;3;24;465;Saint-Michel-de-Double;236;6;242
75;Nouvelle-Aquitaine;24;1;11;466;Saint-Michel-de-Montaigne;326;5;331
75;Nouvelle-Aquitaine;24;3;12;468;Saint-Michel-de-Villadeix;305;6;311
75;Nouvelle-Aquitaine;24;4;20;470;Sainte-Mondane;258;5;263
75;Nouvelle-Aquitaine;24;4;18;471;Sainte-Nathalène;625;12;637
75;Nouvelle-Aquitaine;24;1;02;472;Saint-Nexans;986;18;1004
75;Nouvelle-Aquitaine;24;4;05;473;Sainte-Orse;353;6;359
75;Nouvelle-Aquitaine;24;2;03;474;Saint-Pancrace;168;1;169
75;Nouvelle-Aquitaine;24;2;06;476;Saint-Pantaly-d'Excideuil;159;3;162
75;Nouvelle-Aquitaine;24;3;16;477;Saint-Pardoux-de-Drône;193;5;198
75;Nouvelle-Aquitaine;24;4;23;478;Saint-Pardoux-et-Vielvic;191;0;191
75;Nouvelle-Aquitaine;24;2;13;479;Saint-Pardoux-la-Rivière;1168;13;1181
75;Nouvelle-Aquitaine;24;3;12;480;Saint-Paul-de-Serre;304;8;312
75;Nouvelle-Aquitaine;24;2;21;481;Saint-Paul-la-Roche;519;0;519
75;Nouvelle-Aquitaine;24;3;16;482;Saint-Paul-Lizonne;277;3;280
75;Nouvelle-Aquitaine;24;1;19;483;Saint-Perdoux;140;7;147
75;Nouvelle-Aquitaine;24;3;07;484;Saint-Pierre-de-Chignac;885;17;902
75;Nouvelle-Aquitaine;24;2;21;485;Saint-Pierre-de-Côle;420;2;422
75;Nouvelle-Aquitaine;24;2;21;486;Saint-Pierre-de-Frugie;404;3;407
75;Nouvelle-Aquitaine;24;1;10;487;Saint-Pierre-d'Eyraud;1811;15;1826
75;Nouvelle-Aquitaine;24;4;23;488;Saint-Pompont;352;5;357
75;Nouvelle-Aquitaine;24;2;21;489;Saint-Priest-les-Fougères;380;5;385
75;Nouvelle-Aquitaine;24;3;09;490;Saint Privat en Périgord;1115;14;1129
75;Nouvelle-Aquitaine;24;4;05;491;Saint-Rabier;579;9;588
75;Nouvelle-Aquitaine;24;1;19;492;Sainte-Radegonde;61;1;62
75;Nouvelle-Aquitaine;24;2;06;493;Saint-Raphaël;93;2;95
75;Nouvelle-Aquitaine;24;1;11;494;Saint-Rémy;508;4;512
75;Nouvelle-Aquitaine;24;1;08;495;Saint-Romain-de-Monpazier;113;3;116
75;Nouvelle-Aquitaine;24;2;21;496;Saint-Romain-et-Saint-Clément;328;4;332
75;Nouvelle-Aquitaine;24;2;13;498;Saint-Saud-Lacoussière;827;22;849
75;Nouvelle-Aquitaine;24;1;02;499;Saint-Sauveur;859;21;880
75;Nouvelle-Aquitaine;24;3;09;500;Saint-Sauveur-Lalande;149;7;156
75;Nouvelle-Aquitaine;24;1;11;501;Saint-Seurin-de-Prats;494;8;502
75;Nouvelle-Aquitaine;24;3;24;502;Saint-Séverin-d'Estissac;90;0;90
75;Nouvelle-Aquitaine;24;3;16;504;Saint-Sulpice-de-Roumagnac;283;1;284
75;Nouvelle-Aquitaine;24;2;06;505;Saint-Sulpice-d'Excideuil;352;3;355
75;Nouvelle-Aquitaine;24;4;05;507;Sainte-Trie;110;2;112
75;Nouvelle-Aquitaine;24;3;03;508;Saint-Victor;210;5;215
75;Nouvelle-Aquitaine;24;3;16;509;Saint-Vincent-de-Connezac;673;12;685
75;Nouvelle-Aquitaine;24;4;18;510;Saint-Vincent-de-Cosse;361;12;373
75;Nouvelle-Aquitaine;24;3;09;511;Saint-Vincent-Jalmoutiers;253;3;256
75;Nouvelle-Aquitaine;24;4;18;512;Saint-Vincent-le-Paluel;287;10;297
75;Nouvelle-Aquitaine;24;2;06;513;Saint-Vincent-sur-l'Isle;310;3;313
75;Nouvelle-Aquitaine;24;1;11;514;Saint-Vivien;245;2;247
75;Nouvelle-Aquitaine;24;2;06;515;Salagnac;729;4;733
75;Nouvelle-Aquitaine;24;4;20;516;Salignac-Eyvigues;1177;54;1231
75;Nouvelle-Aquitaine;24;4;23;517;Salles-de-Belvès;72;2;74
75;Nouvelle-Aquitaine;24;3;12;518;Salon;280;4;284
75;Nouvelle-Aquitaine;24;2;06;519;Sarlande;435;0;435
75;Nouvelle-Aquitaine;24;4;18;520;Sarlat-la-Canéda;8816;409;9225
75;Nouvelle-Aquitaine;24;3;22;521;Sarliac-sur-l'Isle;1027;19;1046
75;Nouvelle-Aquitaine;24;2;06;522;Sarrazac;368;11;379
75;Nouvelle-Aquitaine;24;1;19;523;Saussignac;426;13;439
75;Nouvelle-Aquitaine;24;4;25;524;Savignac-de-Miremont;179;5;184
75;Nouvelle-Aquitaine;24;2;13;525;Savignac-de-Nontron;194;2;196
75;Nouvelle-Aquitaine;24;2;06;526;Savignac-Lédrier;713;9;722
75;Nouvelle-Aquitaine;24;3;06;527;Savignac-les-Églises;934;16;950
75;Nouvelle-Aquitaine;24;2;13;528;Sceau-Saint-Angel;127;2;129
75;Nouvelle-Aquitaine;24;3;03;529;Segonzac;201;2;203
75;Nouvelle-Aquitaine;24;4;25;531;Sergeac;212;3;215
75;Nouvelle-Aquitaine;24;1;19;532;Serres-et-Montguyard;248;3;251
75;Nouvelle-Aquitaine;24;3;09;533;Servanches;80;4;84
75;Nouvelle-Aquitaine;24;1;19;534;Sigoulès-et-Flaugeac;1202;240;1442
75;Nouvelle-Aquitaine;24;4;20;535;Simeyrols;254;3;257
75;Nouvelle-Aquitaine;24;1;19;536;Singleyrac;297;5;302
75;Nouvelle-Aquitaine;24;3;16;537;Siorac-de-Ribérac;249;4;253
75;Nouvelle-Aquitaine;24;4;23;538;Siorac-en-Périgord;1059;11;1070
75;Nouvelle-Aquitaine;24;3;21;540;Sorges et Ligueux en Périgord;1590;28;1618
75;Nouvelle-Aquitaine;24;2;13;541;Soudat;88;0;88
75;Nouvelle-Aquitaine;24;1;08;542;Soulaures;80;3;83
75;Nouvelle-Aquitaine;24;3;24;543;Sourzac;1107;14;1121
75;Nouvelle-Aquitaine;24;4;18;544;Tamniès;386;10;396
75;Nouvelle-Aquitaine;24;4;05;545;Teillots;99;1;100
75;Nouvelle-Aquitaine;24;4;05;546;Temple-Laguyon;38;0;38
75;Nouvelle-Aquitaine;24;4;20;547;Terrasson-Lavilledieu;6266;106;6372
75;Nouvelle-Aquitaine;24;2;13;548;Teyjat;274;5;279
75;Nouvelle-Aquitaine;24;1;19;549;Thénac;499;10;509
75;Nouvelle-Aquitaine;24;4;05;550;Thenon;1257;16;1273
75;Nouvelle-Aquitaine;24;2;21;551;Thiviers;2871;185;3056
75;Nouvelle-Aquitaine;24;4;25;552;Thonac;250;4;254
75;Nouvelle-Aquitaine;24;3;03;553;Tocane-Saint-Apre;1742;37;1779
75;Nouvelle-Aquitaine;24;3;16;554;La Tour-Blanche-Cercles;574;13;587
75;Nouvelle-Aquitaine;24;4;05;555;Tourtoirac;641;10;651
75;Nouvelle-Aquitaine;24;3;22;557;Trélissac;7006;201;7207
75;Nouvelle-Aquitaine;24;1;12;558;Trémolat;637;5;642
75;Nouvelle-Aquitaine;24;4;25;559;Tursac;332;10;342
75;Nouvelle-Aquitaine;24;1;08;560;Urval;116;7;123
75;Nouvelle-Aquitaine;24;3;24;562;Vallereuil;270;11;281
75;Nouvelle-Aquitaine;24;4;25;563;Valojoulx;277;7;284
75;Nouvelle-Aquitaine;24;3;16;564;Vanxains;690;106;796
75;Nouvelle-Aquitaine;24;2;13;565;Varaignes;372;8;380
75;Nouvelle-Aquitaine;24;1;08;566;Varennes;472;4;476
75;Nouvelle-Aquitaine;24;2;21;567;Vaunac;252;3;255
75;Nouvelle-Aquitaine;24;1;11;568;Vélines;1059;11;1070
75;Nouvelle-Aquitaine;24;3;16;569;Vendoire;127;2;129
75;Nouvelle-Aquitaine;24;1;08;570;Verdon;42;1;43
75;Nouvelle-Aquitaine;24;3;12;571;Vergt;1693;14;1707
75;Nouvelle-Aquitaine;24;1;08;572;Vergt-de-Biron;191;5;196
75;Nouvelle-Aquitaine;24;3;16;573;Verteillac;590;14;604
75;Nouvelle-Aquitaine;24;4;20;574;Veyrignac;343;8;351
75;Nouvelle-Aquitaine;24;4;23;575;Veyrines-de-Domme;231;22;253
75;Nouvelle-Aquitaine;24;3;12;576;Veyrines-de-Vergt;242;10;252
75;Nouvelle-Aquitaine;24;4;18;577;Vézac;524;10;534
75;Nouvelle-Aquitaine;24;4;05;580;Villac;265;2;267
75;Nouvelle-Aquitaine;24;3;12;581;Villamblard;906;19;925
75;Nouvelle-Aquitaine;24;2;03;582;Villars;454;9;463
75;Nouvelle-Aquitaine;24;1;11;584;Villefranche-de-Lonchat;972;18;990
75;Nouvelle-Aquitaine;24;4;23;585;Villefranche-du-Périgord;676;12;688
75;Nouvelle-Aquitaine;24;3;16;586;Villetoureix;921;22;943
75;Nouvelle-Aquitaine;24;4;18;587;Vitrac;817;21;838
27;Bourgogne-Franche-Comté;25;1;17;001;Abbans-Dessous;252;6;258
27;Bourgogne-Franche-Comté;25;1;17;002;Abbans-Dessus;305;5;310
27;Bourgogne-Franche-Comté;25;1;02;003;Abbenans;323;6;329
27;Bourgogne-Franche-Comté;25;2;12;004;Abbévillers;1059;20;1079
27;Bourgogne-Franche-Comté;25;2;03;005;Accolans;90;1;91
27;Bourgogne-Franche-Comté;25;1;02;006;Adam-lès-Passavant;88;2;90
27;Bourgogne-Franche-Comté;25;3;18;007;Adam-lès-Vercel;105;3;108
27;Bourgogne-Franche-Comté;25;2;03;008;Aibre;467;4;471
27;Bourgogne-Franche-Comté;25;1;02;009;Aïssey;163;3;166
27;Bourgogne-Franche-Comté;25;2;10;011;Allenjoie;740;16;756
27;Bourgogne-Franche-Comté;25;3;15;012;Les Alliés;166;5;171
27;Bourgogne-Franche-Comté;25;2;03;013;Allondans;260;3;263
27;Bourgogne-Franche-Comté;25;1;08;014;Amagney;929;11;940
27;Bourgogne-Franche-Comté;25;1;15;015;Amancey;704;21;725
27;Bourgogne-Franche-Comté;25;1;15;016;Amathay-Vésigneux;164;4;168
27;Bourgogne-Franche-Comté;25;1;15;017;Amondans;92;3;95
27;Bourgogne-Franche-Comté;25;2;03;018;Anteuil;624;23;647
27;Bourgogne-Franche-Comté;25;2;03;019;Appenans;381;11;392
27;Bourgogne-Franche-Comté;25;2;01;020;Arbouans;910;9;919
27;Bourgogne-Franche-Comté;25;1;17;021;Arc-et-Senans;1619;30;1649
27;Bourgogne-Franche-Comté;25;2;03;022;Arcey;1468;39;1507
27;Bourgogne-Franche-Comté;25;3;15;024;Arçon;900;30;930
27;Bourgogne-Franche-Comté;25;3;15;025;Arc-sous-Cicon;707;14;721
27;Bourgogne-Franche-Comté;25;3;11;026;Arc-sous-Montenot;214;5;219
27;Bourgogne-Franche-Comté;25;3;15;029;Aubonne;244;3;247
27;Bourgogne-Franche-Comté;25;1;05;030;Audeux;430;11;441
27;Bourgogne-Franche-Comté;25;2;01;031;Audincourt;13341;208;13549
27;Bourgogne-Franche-Comté;25;1;02;032;Autechaux;425;10;435
27;Bourgogne-Franche-Comté;25;2;12;033;Autechaux-Roide;518;10;528
27;Bourgogne-Franche-Comté;25;1;06;035;Les Auxons;2515;46;2561
27;Bourgogne-Franche-Comté;25;1;04;036;Avanne-Aveney;2227;31;2258
27;Bourgogne-Franche-Comté;25;1;02;038;Avilley;161;4;165
27;Bourgogne-Franche-Comté;25;3;18;039;Avoudrey;914;16;930
27;Bourgogne-Franche-Comté;25;2;01;040;Badevel;810;14;824
27;Bourgogne-Franche-Comté;25;3;11;041;Bannans;366;10;376
27;Bourgogne-Franche-Comté;25;3;14;042;Le Barboux;228;8;236
27;Bourgogne-Franche-Comté;25;2;13;043;Bart;1951;53;2004
27;Bourgogne-Franche-Comté;25;1;17;044;Bartherans;59;0;59
27;Bourgogne-Franche-Comté;25;1;02;045;Battenans-les-Mines;48;1;49
27;Bourgogne-Franche-Comté;25;2;18;046;Battenans-Varin;74;2;76
27;Bourgogne-Franche-Comté;25;1;02;047;Baume-les-Dames;4989;162;5151
27;Bourgogne-Franche-Comté;25;2;03;048;Bavans;3616;75;3691
27;Bourgogne-Franche-Comté;25;2;12;049;Belfays;137;5;142
27;Bourgogne-Franche-Comté;25;3;14;050;Le Bélieu;500;5;505
27;Bourgogne-Franche-Comté;25;2;18;051;Belleherbe;623;14;637
27;Bourgogne-Franche-Comté;25;3;18;052;Belmont;67;0;67
27;Bourgogne-Franche-Comté;25;2;03;053;Belvoir;96;6;102
27;Bourgogne-Franche-Comté;25;2;03;054;Berche;524;13;537
27;Bourgogne-Franche-Comté;25;1;17;055;Berthelange;350;8;358
27;Bourgogne-Franche-Comté;25;1;99;056;Besançon;117912;3232;121144
27;Bourgogne-Franche-Comté;25;2;10;057;Bethoncourt;5441;72;5513
27;Bourgogne-Franche-Comté;25;1;09;058;Beure;1345;11;1356
27;Bourgogne-Franche-Comté;25;2;03;059;Beutal;270;5;275
27;Bourgogne-Franche-Comté;25;3;15;060;Bians-les-Usiers;698;24;722
27;Bourgogne-Franche-Comté;25;2;12;061;Bief;116;1;117
27;Bourgogne-Franche-Comté;25;3;14;062;Le Bizot;301;11;312
27;Bourgogne-Franche-Comté;25;2;12;063;Blamont;1210;26;1236
27;Bourgogne-Franche-Comté;25;1;02;065;Blarians;55;4;59
27;Bourgogne-Franche-Comté;25;2;03;066;Blussangeaux;84;1;85
27;Bourgogne-Franche-Comté;25;2;03;067;Blussans;191;3;194
27;Bourgogne-Franche-Comté;25;1;15;070;Bolandoz;373;15;388
27;Bourgogne-Franche-Comté;25;2;12;071;Bondeval;475;11;486
27;Bourgogne-Franche-Comté;25;1;02;072;Bonnal;21;1;22
27;Bourgogne-Franche-Comté;25;1;02;073;Bonnay;830;6;836
27;Bourgogne-Franche-Comté;25;3;14;074;Bonnétage;978;21;999
27;Bourgogne-Franche-Comté;25;3;11;075;Bonnevaux;398;11;409
27;Bourgogne-Franche-Comté;25;3;14;077;La Bosse;72;0;72
27;Bourgogne-Franche-Comté;25;1;02;078;Bouclans;1064;24;1088
27;Bourgogne-Franche-Comté;25;3;11;079;Boujailles;438;11;449
27;Bourgogne-Franche-Comté;25;2;19;082;Bourguignon;894;23;917
27;Bourgogne-Franche-Comté;25;2;03;083;Bournois;191;1;192
27;Bourgogne-Franche-Comté;25;1;09;084;Boussières;1166;17;1183
27;Bourgogne-Franche-Comté;25;3;11;085;Bouverans;388;8;396
27;Bourgogne-Franche-Comté;25;1;07;086;Braillans;210;2;212
27;Bourgogne-Franche-Comté;25;2;03;087;Branne;179;3;182
27;Bourgogne-Franche-Comté;25;1;02;088;Breconchaux;88;5;93
27;Bourgogne-Franche-Comté;25;3;18;089;Bremondans;94;2;96
27;Bourgogne-Franche-Comté;25;1;17;090;Brères;67;0;67
27;Bourgogne-Franche-Comté;25;2;12;091;Les Bréseux;471;8;479
27;Bourgogne-Franche-Comté;25;1;02;092;La Bretenière;70;2;72
27;Bourgogne-Franche-Comté;25;2;03;093;Bretigney;76;0;76
27;Bourgogne-Franche-Comté;25;1;02;094;Bretigney-Notre-Dame;116;0;116
27;Bourgogne-Franche-Comté;25;3;18;095;Bretonvillers;278;3;281
27;Bourgogne-Franche-Comté;25;3;11;096;Brey-et-Maison-du-Bois;143;2;145
27;Bourgogne-Franche-Comté;25;2;10;097;Brognard;478;12;490
27;Bourgogne-Franche-Comté;25;1;17;098;Buffard;181;4;185
27;Bourgogne-Franche-Comté;25;3;15;099;Bugny;225;6;231
27;Bourgogne-Franche-Comté;25;3;11;100;Bulle;472;7;479
27;Bourgogne-Franche-Comté;25;1;17;101;Burgille;571;12;583
27;Bourgogne-Franche-Comté;25;2;12;102;Burnevillers;48;2;50
27;Bourgogne-Franche-Comté;25;1;09;103;Busy;636;14;650
27;Bourgogne-Franche-Comté;25;1;17;104;By;85;1;86
27;Bourgogne-Franche-Comté;25;1;17;105;Byans-sur-Doubs;588;6;594
27;Bourgogne-Franche-Comté;25;1;15;106;Cademène;69;0;69
27;Bourgogne-Franche-Comté;25;1;02;107;Cendrey;192;0;192
27;Bourgogne-Franche-Comté;25;2;12;108;Cernay-l'Église;309;9;318
27;Bourgogne-Franche-Comté;25;1;17;109;Cessey;326;10;336
27;Bourgogne-Franche-Comté;25;3;16;110;Chaffois;1020;19;1039
27;Bourgogne-Franche-Comté;25;1;07;111;Chalèze;362;12;374
27;Bourgogne-Franche-Comté;25;1;07;112;Chalezeule;1312;26;1338
27;Bourgogne-Franche-Comté;25;3;18;113;Chamesey;142;3;145
27;Bourgogne-Franche-Comté;25;2;12;114;Chamesol;386;6;392
27;Bourgogne-Franche-Comté;25;1;05;115;Champagney;279;3;282
27;Bourgogne-Franche-Comté;25;1;02;116;Champlive;246;6;252
27;Bourgogne-Franche-Comté;25;1;07;117;Champoux;91;0;91
27;Bourgogne-Franche-Comté;25;1;05;119;Champvans-les-Moulins;325;10;335
27;Bourgogne-Franche-Comté;25;1;15;120;Chantrans;398;10;408
27;Bourgogne-Franche-Comté;25;3;11;121;Chapelle-des-Bois;255;16;271
27;Bourgogne-Franche-Comté;25;3;11;122;Chapelle-d'Huin;525;7;532
27;Bourgogne-Franche-Comté;25;2;12;124;Charmauvillers;269;7;276
27;Bourgogne-Franche-Comté;25;2;18;125;Charmoille;324;5;329
27;Bourgogne-Franche-Comté;25;1;17;126;Charnay;476;8;484
27;Bourgogne-Franche-Comté;25;2;12;127;Charquemont;2741;50;2791
27;Bourgogne-Franche-Comté;25;1;15;129;Chassagne-Saint-Denis;111;3;114
27;Bourgogne-Franche-Comté;25;1;15;130;Châteauvieux-les-Fossés;11;0;11
27;Bourgogne-Franche-Comté;25;3;11;131;Châtelblanc;110;5;115
27;Bourgogne-Franche-Comté;25;1;02;132;Châtillon-Guyotte;138;4;142
27;Bourgogne-Franche-Comté;25;1;06;133;Châtillon-le-Duc;2023;56;2079
27;Bourgogne-Franche-Comté;25;1;17;134;Châtillon-sur-Lison;8;0;8
27;Bourgogne-Franche-Comté;25;1;05;136;Chaucenne;502;13;515
27;Bourgogne-Franche-Comté;25;2;12;138;Les Terres-de-Chaux;125;5;130
27;Bourgogne-Franche-Comté;25;3;15;139;La Chaux;602;10;612
27;Bourgogne-Franche-Comté;25;3;18;141;Chaux-lès-Passavant;122;6;128
27;Bourgogne-Franche-Comté;25;3;11;142;Chaux-Neuve;327;3;330
27;Bourgogne-Franche-Comté;25;1;17;143;Chay;207;11;218
27;Bourgogne-Franche-Comté;25;2;03;145;Chazot;120;1;121
27;Bourgogne-Franche-Comté;25;1;04;147;Chemaudin et Vaux;2021;39;2060
27;Bourgogne-Franche-Comté;25;3;14;148;La Chenalotte;502;5;507
27;Bourgogne-Franche-Comté;25;1;17;149;Chenecey-Buillon;506;11;517
27;Bourgogne-Franche-Comté;25;1;17;150;Chevigney-sur-l'Ognon;291;3;294
27;Bourgogne-Franche-Comté;25;3;18;151;Chevigney-lès-Vercel;133;5;138
27;Bourgogne-Franche-Comté;25;1;08;152;La Chevillotte;158;0;158
27;Bourgogne-Franche-Comté;25;1;02;153;Chevroz;132;1;133
27;Bourgogne-Franche-Comté;25;1;17;154;Chouzelot;266;8;274
27;Bourgogne-Franche-Comté;25;1;15;155;Cléron;299;13;312
27;Bourgogne-Franche-Comté;25;2;03;156;Pays-de-Clerval;1169;22;1191
27;Bourgogne-Franche-Comté;25;3;16;157;La Cluse-et-Mijoux;1299;28;1327
27;Bourgogne-Franche-Comté;25;2;03;159;Colombier-Fontaine;1220;24;1244
27;Bourgogne-Franche-Comté;25;3;14;160;Les Combes;750;27;777
27;Bourgogne-Franche-Comté;25;3;18;161;Consolation-Maisonnettes;30;5;35
27;Bourgogne-Franche-Comté;25;1;17;162;Corcelles-Ferrières;208;6;214
27;Bourgogne-Franche-Comté;25;1;02;163;Corcelle-Mieslot;107;1;108
27;Bourgogne-Franche-Comté;25;1;17;164;Corcondray;144;2;146
27;Bourgogne-Franche-Comté;25;1;02;166;Côtebrune;84;6;90
27;Bourgogne-Franche-Comté;25;2;13;170;Courcelles-lès-Montbéliard;1356;41;1397
27;Bourgogne-Franche-Comté;25;1;17;171;Courcelles;105;2;107
27;Bourgogne-Franche-Comté;25;1;17;172;Courchapon;232;3;235
27;Bourgogne-Franche-Comté;25;2;18;173;Cour-Saint-Maurice;148;1;149
27;Bourgogne-Franche-Comté;25;2;12;174;Courtefontaine;244;3;247
27;Bourgogne-Franche-Comté;25;3;18;175;Courtetain-et-Salans;89;1;90
27;Bourgogne-Franche-Comté;25;3;11;176;Courvières;315;5;320
27;Bourgogne-Franche-Comté;25;2;03;177;Crosey-le-Grand;150;5;155
27;Bourgogne-Franche-Comté;25;2;03;178;Crosey-le-Petit;124;3;127
27;Bourgogne-Franche-Comté;25;3;11;179;Le Crouzet;60;2;62
27;Bourgogne-Franche-Comté;25;1;15;180;Crouzet-Migette;115;6;121
27;Bourgogne-Franche-Comté;25;1;02;181;Cubrial;146;6;152
27;Bourgogne-Franche-Comté;25;1;02;182;Cubry;92;0;92
27;Bourgogne-Franche-Comté;25;1;02;183;Cusance;74;2;76
27;Bourgogne-Franche-Comté;25;1;02;184;Cuse-et-Adrisans;281;12;293
27;Bourgogne-Franche-Comté;25;1;17;185;Cussey-sur-Lison;62;3;65
27;Bourgogne-Franche-Comté;25;1;02;186;Cussey-sur-l'Ognon;1044;24;1068
27;Bourgogne-Franche-Comté;25;2;19;187;Dambelin;502;6;508
27;Bourgogne-Franche-Comté;25;2;10;188;Dambenois;750;26;776
27;Bourgogne-Franche-Comté;25;1;02;189;Dammartin-les-Templiers;189;6;195
27;Bourgogne-Franche-Comté;25;2;01;190;Dampierre-les-Bois;1598;27;1625
27;Bourgogne-Franche-Comté;25;2;03;191;Dampierre-sur-le-Doubs;452;10;462
27;Bourgogne-Franche-Comté;25;2;12;192;Dampjoux;170;4;174
27;Bourgogne-Franche-Comté;25;2;12;193;Damprichard;1856;46;1902
27;Bourgogne-Franche-Comté;25;2;12;194;Dannemarie;112;0;112
27;Bourgogne-Franche-Comté;25;1;04;195;Dannemarie-sur-Crète;1522;290;1812
27;Bourgogne-Franche-Comté;25;2;01;196;Dasle;1392;26;1418
27;Bourgogne-Franche-Comté;25;1;08;197;Deluz;616;5;621
27;Bourgogne-Franche-Comté;25;2;03;198;Désandans;726;21;747
27;Bourgogne-Franche-Comté;25;1;15;199;Déservillers;344;12;356
27;Bourgogne-Franche-Comté;25;1;02;200;Devecey;1379;36;1415
27;Bourgogne-Franche-Comté;25;3;16;201;Dommartin;737;15;752
27;Bourgogne-Franche-Comté;25;3;11;202;Dompierre-les-Tilleuls;314;5;319
27;Bourgogne-Franche-Comté;25;3;18;203;Domprel;189;4;193
27;Bourgogne-Franche-Comté;25;3;16;204;Doubs;3198;95;3293
27;Bourgogne-Franche-Comté;25;2;03;207;Dung;624;17;641
27;Bourgogne-Franche-Comté;25;1;15;208;Durnes;178;4;182
27;Bourgogne-Franche-Comté;25;1;17;209;Échay;131;4;135
27;Bourgogne-Franche-Comté;25;2;03;210;Échenans;159;4;163
27;Bourgogne-Franche-Comté;25;1;15;211;Échevannes;88;1;89
27;Bourgogne-Franche-Comté;25;1;05;212;École-Valentin;2633;49;2682
27;Bourgogne-Franche-Comté;25;2;12;213;Les Écorces;736;22;758
27;Bourgogne-Franche-Comté;25;2;19;214;Écot;491;10;501
27;Bourgogne-Franche-Comté;25;1;02;215;L'Écouvotte;89;0;89
27;Bourgogne-Franche-Comté;25;2;12;216;Écurcey;265;10;275
27;Bourgogne-Franche-Comté;25;1;17;217;Émagny;597;10;607
27;Bourgogne-Franche-Comté;25;3;18;218;Épenouse;160;7;167
27;Bourgogne-Franche-Comté;25;3;18;219;Épenoy;635;14;649
27;Bourgogne-Franche-Comté;25;1;17;220;Épeugney;594;15;609
27;Bourgogne-Franche-Comté;25;1;02;221;Esnans;65;0;65
27;Bourgogne-Franche-Comté;25;3;18;222;Étalans;1595;36;1631
27;Bourgogne-Franche-Comté;25;1;15;223;Éternoz;327;8;335
27;Bourgogne-Franche-Comté;25;2;03;224;Étouvans;835;13;848
27;Bourgogne-Franche-Comté;25;1;17;225;Étrabonne;188;1;189
27;Bourgogne-Franche-Comté;25;2;03;226;Étrappe;218;4;222
27;Bourgogne-Franche-Comté;25;3;18;227;Étray;281;0;281
27;Bourgogne-Franche-Comté;25;2;10;228;Étupes;3724;64;3788
27;Bourgogne-Franche-Comté;25;3;15;229;Évillers;389;4;393
27;Bourgogne-Franche-Comté;25;2;10;230;Exincourt;3237;54;3291
27;Bourgogne-Franche-Comté;25;3;18;231;Eysson;119;2;121
27;Bourgogne-Franche-Comté;25;2;03;232;Faimbe;100;2;102
27;Bourgogne-Franche-Comté;25;3;18;233;Fallerans;289;8;297
27;Bourgogne-Franche-Comté;25;2;12;234;Ferrières-le-Lac;175;7;182
27;Bourgogne-Franche-Comté;25;1;17;235;Ferrières-les-Bois;317;3;320
27;Bourgogne-Franche-Comté;25;1;15;236;Fertans;288;3;291
27;Bourgogne-Franche-Comté;25;2;10;237;Fesches-le-Châtel;2172;34;2206
27;Bourgogne-Franche-Comté;25;2;12;238;Fessevillers;157;2;159
27;Bourgogne-Franche-Comté;25;2;19;239;Feule;177;1;178
27;Bourgogne-Franche-Comté;25;3;14;240;Les Fins;3202;151;3353
27;Bourgogne-Franche-Comté;25;1;15;241;Flagey;147;6;153
27;Bourgogne-Franche-Comté;25;1;02;242;Flagey-Rigney;119;0;119
27;Bourgogne-Franche-Comté;25;3;18;243;Flangebouche;788;19;807
27;Bourgogne-Franche-Comté;25;2;12;244;Fleurey;84;3;87
27;Bourgogne-Franche-Comté;25;1;08;245;Fontain;1251;22;1273
27;Bourgogne-Franche-Comté;25;2;03;246;Fontaine-lès-Clerval;280;10;290
27;Bourgogne-Franche-Comté;25;1;02;247;Fontenelle-Montby;87;3;90
27;Bourgogne-Franche-Comté;25;3;14;248;Les Fontenelles;549;112;661
27;Bourgogne-Franche-Comté;25;1;02;249;Fontenotte;61;2;63
27;Bourgogne-Franche-Comté;25;1;02;251;Fourbanne;174;8;182
27;Bourgogne-Franche-Comté;25;3;11;252;Fourcatier-et-Maison-Neuve;115;0;115
27;Bourgogne-Franche-Comté;25;1;17;253;Fourg;393;4;397
27;Bourgogne-Franche-Comté;25;3;11;254;Les Fourgs;1405;31;1436
27;Bourgogne-Franche-Comté;25;2;12;255;Fournet-Blancheroche;349;13;362
27;Bourgogne-Franche-Comté;25;2;12;256;Frambouhans;906;14;920
27;Bourgogne-Franche-Comté;25;1;17;257;Franey;268;4;272
27;Bourgogne-Franche-Comté;25;1;04;258;Franois;2295;39;2334
27;Bourgogne-Franche-Comté;25;3;11;259;Frasne;1926;37;1963
27;Bourgogne-Franche-Comté;25;2;12;261;Froidevaux;80;1;81
27;Bourgogne-Franche-Comté;25;3;18;262;Fuans;466;24;490
27;Bourgogne-Franche-Comté;25;3;11;263;Gellin;250;2;252
27;Bourgogne-Franche-Comté;25;2;03;264;Gémonval;84;2;86
27;Bourgogne-Franche-Comté;25;1;02;265;Geneuille;1317;20;1337
27;Bourgogne-Franche-Comté;25;2;03;266;Geney;116;3;119
27;Bourgogne-Franche-Comté;25;1;08;267;Gennes;682;20;702
27;Bourgogne-Franche-Comté;25;3;18;268;Germéfontaine;115;2;117
27;Bourgogne-Franche-Comté;25;1;02;269;Germondans;61;1;62
27;Bourgogne-Franche-Comté;25;1;15;270;Gevresin;121;6;127
27;Bourgogne-Franche-Comté;25;3;15;271;Gilley;1691;38;1729
27;Bourgogne-Franche-Comté;25;1;02;273;Glamondans;207;4;211
27;Bourgogne-Franche-Comté;25;2;12;274;Glay;339;2;341
27;Bourgogne-Franche-Comté;25;2;12;275;Glère;201;4;205
27;Bourgogne-Franche-Comté;25;1;02;276;Gondenans-Montby;171;2;173
27;Bourgogne-Franche-Comté;25;1;02;277;Gondenans-les-Moulins;73;0;73
27;Bourgogne-Franche-Comté;25;1;02;278;Gonsans;558;13;571
27;Bourgogne-Franche-Comté;25;1;02;279;Gouhelans;119;1;120
27;Bourgogne-Franche-Comté;25;2;12;280;Goumois;157;4;161
27;Bourgogne-Franche-Comté;25;2;19;281;Goux-lès-Dambelin;282;0;282
27;Bourgogne-Franche-Comté;25;3;15;282;Goux-les-Usiers;763;13;776
27;Bourgogne-Franche-Comté;25;1;17;283;Goux-sous-Landet;64;1;65
27;Bourgogne-Franche-Comté;25;2;10;284;Grand-Charmont;5786;73;5859
27;Bourgogne-Franche-Comté;25;3;14;285;Grand'Combe-Châteleu;1484;26;1510
27;Bourgogne-Franche-Comté;25;3;14;286;Grand'Combe-des-Bois;125;5;130
27;Bourgogne-Franche-Comté;25;1;04;287;Grandfontaine;1771;42;1813
27;Bourgogne-Franche-Comté;25;3;18;288;Fournets-Luisans;719;19;738
27;Bourgogne-Franche-Comté;25;3;18;289;Grandfontaine-sur-Creuse;73;3;76
27;Bourgogne-Franche-Comté;25;2;18;290;La Grange;95;3;98
27;Bourgogne-Franche-Comté;25;3;16;293;Granges-Narboz;1267;51;1318
27;Bourgogne-Franche-Comté;25;3;11;295;Les Grangettes;298;5;303
27;Bourgogne-Franche-Comté;25;3;14;296;Les Gras;788;28;816
27;Bourgogne-Franche-Comté;25;1;08;297;Le Gratteris;169;3;172
27;Bourgogne-Franche-Comté;25;1;02;298;Grosbois;242;8;250
27;Bourgogne-Franche-Comté;25;1;02;299;Guillon-les-Bains;110;1;111
27;Bourgogne-Franche-Comté;25;1;18;300;Guyans-Durnes;297;5;302
27;Bourgogne-Franche-Comté;25;3;18;301;Guyans-Vennes;860;26;886
27;Bourgogne-Franche-Comté;25;3;15;303;Hauterive-la-Fresse;226;6;232
27;Bourgogne-Franche-Comté;25;2;01;304;Hérimoncourt;3662;62;3724
27;Bourgogne-Franche-Comté;25;1;15;305;L'Hôpital-du-Grosbois;593;17;610
27;Bourgogne-Franche-Comté;25;2;03;306;L'Hôpital-Saint-Lieffroy;124;5;129
27;Bourgogne-Franche-Comté;25;3;11;307;Les Hôpitaux-Neufs;913;11;924
27;Bourgogne-Franche-Comté;25;3;11;308;Les Hôpitaux-Vieux;463;6;469
27;Bourgogne-Franche-Comté;25;3;16;309;Houtaud;1128;36;1164
27;Bourgogne-Franche-Comté;25;1;02;310;Huanne-Montmartin;98;1;99
27;Bourgogne-Franche-Comté;25;2;03;311;Hyémondans;207;4;211
27;Bourgogne-Franche-Comté;25;1;02;312;Hyèvre-Magny;67;1;68
27;Bourgogne-Franche-Comté;25;1;02;313;Hyèvre-Paroisse;195;3;198
27;Bourgogne-Franche-Comté;25;2;12;314;Indevillers;268;2;270
27;Bourgogne-Franche-Comté;25;2;03;315;L'Isle-sur-le-Doubs;2865;70;2935
27;Bourgogne-Franche-Comté;25;2;03;316;Issans;235;12;247
27;Bourgogne-Franche-Comté;25;1;17;317;Jallerange;265;5;270
27;Bourgogne-Franche-Comté;25;3;11;318;Jougne;1801;33;1834
27;Bourgogne-Franche-Comté;25;3;11;320;Labergement-Sainte-Marie;1221;34;1255
27;Bourgogne-Franche-Comté;25;3;14;321;Villers-le-Lac;5188;116;5304
27;Bourgogne-Franche-Comté;25;2;03;322;Laire;406;10;416
27;Bourgogne-Franche-Comté;25;1;02;323;Laissey;445;6;451
27;Bourgogne-Franche-Comté;25;1;03;324;Lanans;162;8;170
27;Bourgogne-Franche-Comté;25;3;18;325;Landresse;232;8;240
27;Bourgogne-Franche-Comté;25;1;17;326;Lantenne-Vertière;529;13;542
27;Bourgogne-Franche-Comté;25;2;03;327;Lanthenans;70;0;70
27;Bourgogne-Franche-Comté;25;1;09;328;Larnod;786;11;797
27;Bourgogne-Franche-Comté;25;3;14;329;Laval-le-Prieuré;36;1;37
27;Bourgogne-Franche-Comté;25;1;17;330;Lavans-Quingey;181;3;184
27;Bourgogne-Franche-Comté;25;1;15;331;Lavans-Vuillafans;242;5;247
27;Bourgogne-Franche-Comté;25;1;17;332;Lavernay;575;10;585
27;Bourgogne-Franche-Comté;25;3;18;333;Laviron;343;15;358
27;Bourgogne-Franche-Comté;25;3;11;334;Levier;2236;243;2479
27;Bourgogne-Franche-Comté;25;2;12;335;Liebvillers;152;5;157
27;Bourgogne-Franche-Comté;25;1;17;336;Liesle;543;5;548
27;Bourgogne-Franche-Comté;25;1;15;338;Lizine;97;1;98
27;Bourgogne-Franche-Comté;25;1;15;339;Lods;223;2;225
27;Bourgogne-Franche-Comté;25;1;17;340;Lombard;188;4;192
27;Bourgogne-Franche-Comté;25;1;02;341;Lomont-sur-Crête;178;6;184
27;Bourgogne-Franche-Comté;25;3;18;342;Longechaux;79;3;82
27;Bourgogne-Franche-Comté;25;3;18;343;Longemaison;165;3;168
27;Bourgogne-Franche-Comté;25;3;18;344;Longevelle-lès-Russey;45;0;45
27;Bourgogne-Franche-Comté;25;2;03;345;Longevelle-sur-Doubs;670;14;684
27;Bourgogne-Franche-Comté;25;1;15;346;Longeville;180;3;183
27;Bourgogne-Franche-Comté;25;3;15;347;La Longeville;823;21;844
27;Bourgogne-Franche-Comté;25;3;11;348;Longevilles-Mont-d'Or;609;16;625
27;Bourgogne-Franche-Comté;25;3;18;349;Loray;564;15;579
27;Bourgogne-Franche-Comté;25;2;03;350;Lougres;736;22;758
27;Bourgogne-Franche-Comté;25;3;14;351;Le Luhier;234;1;235
27;Bourgogne-Franche-Comté;25;1;02;354;Luxiol;159;0;159
27;Bourgogne-Franche-Comté;25;3;18;355;Magny-Châtelard;62;0;62
27;Bourgogne-Franche-Comté;25;2;12;356;Maîche;4266;103;4369
27;Bourgogne-Franche-Comté;25;3;15;357;Maisons-du-Bois-Lièvremont;852;8;860
27;Bourgogne-Franche-Comté;25;1;15;359;Malans;160;5;165
27;Bourgogne-Franche-Comté;25;1;15;360;Malbrans;171;4;175
27;Bourgogne-Franche-Comté;25;3;11;361;Malbuisson;844;25;869
27;Bourgogne-Franche-Comté;25;3;11;362;Malpas;284;12;296
27;Bourgogne-Franche-Comté;25;1;08;364;Mamirolle;1795;18;1813
27;Bourgogne-Franche-Comté;25;2;03;365;Mancenans;305;5;310
27;Bourgogne-Franche-Comté;25;2;12;366;Mancenans-Lizerne;193;6;199
27;Bourgogne-Franche-Comté;25;2;19;367;Mandeure;4795;150;4945
27;Bourgogne-Franche-Comté;25;1;07;368;Marchaux-Chaudefontaine;1479;21;1500
27;Bourgogne-Franche-Comté;25;2;03;369;Marvelise;162;3;165
27;Bourgogne-Franche-Comté;25;2;19;370;Mathay;2152;37;2189
27;Bourgogne-Franche-Comté;25;1;05;371;Mazerolles-le-Salin;211;7;218
27;Bourgogne-Franche-Comté;25;2;03;372;Médière;275;12;287
27;Bourgogne-Franche-Comté;25;3;14;373;Le Mémont;46;2;48
27;Bourgogne-Franche-Comté;25;1;17;374;Mercey-le-Grand;555;16;571
27;Bourgogne-Franche-Comté;25;1;15;375;Mérey-sous-Montrond;442;10;452
27;Bourgogne-Franche-Comté;25;1;02;376;Mérey-Vieilley;154;5;159
27;Bourgogne-Franche-Comté;25;1;02;377;Mésandans;231;6;237
27;Bourgogne-Franche-Comté;25;2;12;378;Meslières;346;8;354
27;Bourgogne-Franche-Comté;25;1;17;379;Mesmay;71;4;75
27;Bourgogne-Franche-Comté;25;3;11;380;Métabief;1339;36;1375
27;Bourgogne-Franche-Comté;25;1;06;381;Miserey-Salines;2555;37;2592
27;Bourgogne-Franche-Comté;25;1;02;382;Moncey;609;6;615
27;Bourgogne-Franche-Comté;25;1;17;383;Moncley;276;6;282
27;Bourgogne-Franche-Comté;25;1;02;384;Mondon;97;1;98
27;Bourgogne-Franche-Comté;25;1;02;385;Montagney-Servigney;128;3;131
27;Bourgogne-Franche-Comté;25;2;12;386;Montancy;126;3;129
27;Bourgogne-Franche-Comté;25;2;12;387;Montandon;385;9;394
27;Bourgogne-Franche-Comté;25;2;13;388;Montbéliard;25806;559;26365
27;Bourgogne-Franche-Comté;25;3;14;389;Montbéliardot;113;4;117
27;Bourgogne-Franche-Comté;25;3;15;390;Montbenoît;399;12;411
27;Bourgogne-Franche-Comté;25;3;14;391;Mont-de-Laval;179;6;185
27;Bourgogne-Franche-Comté;25;2;12;392;Mont-de-Vougney;192;5;197
27;Bourgogne-Franche-Comté;25;2;12;393;Montécheroux;549;7;556
27;Bourgogne-Franche-Comté;25;2;03;394;Montenois;1472;43;1515
27;Bourgogne-Franche-Comté;25;1;08;395;Montfaucon;1570;49;1619
27;Bourgogne-Franche-Comté;25;1;09;397;Montferrand-le-Château;2180;42;2222
27;Bourgogne-Franche-Comté;25;3;15;398;Montflovin;115;4;119
27;Bourgogne-Franche-Comté;25;1;15;400;Montgesoye;472;9;481
27;Bourgogne-Franche-Comté;25;1;02;401;Montivernage;26;0;26
27;Bourgogne-Franche-Comté;25;2;12;402;Montjoie-le-Château;24;1;25
27;Bourgogne-Franche-Comté;25;3;14;403;Montlebon;2129;71;2200
27;Bourgogne-Franche-Comté;25;1;15;404;Montmahoux;91;2;93
27;Bourgogne-Franche-Comté;25;3;11;405;Montperreux;899;41;940
27;Bourgogne-Franche-Comté;25;1;17;406;Montrond-le-Château;566;14;580
27;Bourgogne-Franche-Comté;25;1;02;408;Montussaint;56;1;57
27;Bourgogne-Franche-Comté;25;1;08;410;Morre;1342;62;1404
27;Bourgogne-Franche-Comté;25;3;14;411;Morteau;6853;336;7189
27;Bourgogne-Franche-Comté;25;3;11;413;Mouthe;1047;36;1083
27;Bourgogne-Franche-Comté;25;1;17;414;Le Moutherot;123;2;125
27;Bourgogne-Franche-Comté;25;1;15;415;Mouthier-Haute-Pierre;341;5;346
27;Bourgogne-Franche-Comté;25;1;17;416;Myon;183;4;187
27;Bourgogne-Franche-Comté;25;1;02;417;Naisey-les-Granges;804;20;824
27;Bourgogne-Franche-Comté;25;1;08;418;Nancray;1259;29;1288
27;Bourgogne-Franche-Comté;25;1;02;419;Nans;94;4;98
27;Bourgogne-Franche-Comté;25;1;15;420;Nans-sous-Sainte-Anne;166;4;170
27;Bourgogne-Franche-Comté;25;3;14;421;Narbief;72;4;76
27;Bourgogne-Franche-Comté;25;2;19;422;Neuchâtel-Urtière;178;4;182
27;Bourgogne-Franche-Comté;25;3;18;424;Les Premiers Sapins;1544;32;1576
27;Bourgogne-Franche-Comté;25;3;14;425;Noël-Cerneux;455;16;471
27;Bourgogne-Franche-Comté;25;2;19;426;Noirefontaine;335;6;341
27;Bourgogne-Franche-Comté;25;1;05;427;Noironte;394;5;399
27;Bourgogne-Franche-Comté;25;2;10;428;Nommay;1619;38;1657
27;Bourgogne-Franche-Comté;25;1;08;429;Novillars;1497;41;1538
27;Bourgogne-Franche-Comté;25;1;02;430;Ollans;39;0;39
27;Bourgogne-Franche-Comté;25;2;03;431;Onans;339;13;352
27;Bourgogne-Franche-Comté;25;3;18;432;Orchamps-Vennes;2149;58;2207
27;Bourgogne-Franche-Comté;25;2;12;433;Orgeans-Blanchefontaine;41;1;42
27;Bourgogne-Franche-Comté;25;1;15;434;Ornans;4423;104;4527
27;Bourgogne-Franche-Comté;25;3;18;435;Orsans;163;4;167
27;Bourgogne-Franche-Comté;25;2;03;436;Orve;57;2;59
27;Bourgogne-Franche-Comté;25;1;02;437;Osse;345;3;348
27;Bourgogne-Franche-Comté;25;1;09;438;Osselle-Routelle;956;15;971
27;Bourgogne-Franche-Comté;25;1;02;439;Ougney-Douvot;254;2;256
27;Bourgogne-Franche-Comté;25;3;15;440;Ouhans;376;8;384
27;Bourgogne-Franche-Comté;25;3;18;441;Ouvans;65;1;66
27;Bourgogne-Franche-Comté;25;3;11;442;Oye-et-Pallet;728;12;740
27;Bourgogne-Franche-Comté;25;1;17;443;Palantine;78;1;79
27;Bourgogne-Franche-Comté;25;1;02;444;Palise;141;4;145
27;Bourgogne-Franche-Comté;25;1;17;445;Paroy;124;2;126
27;Bourgogne-Franche-Comté;25;1;02;446;Passavant;191;10;201
27;Bourgogne-Franche-Comté;25;3;18;447;Passonfontaine;344;5;349
27;Bourgogne-Franche-Comté;25;1;05;448;Pelousey;1526;29;1555
27;Bourgogne-Franche-Comté;25;2;18;449;Péseux;138;1;139
27;Bourgogne-Franche-Comté;25;1;17;450;Pessans;86;3;89
27;Bourgogne-Franche-Comté;25;3;11;451;Petite-Chaux;142;3;145
27;Bourgogne-Franche-Comté;25;2;12;452;Pierrefontaine-lès-Blamont;470;12;482
27;Bourgogne-Franche-Comté;25;3;18;453;Pierrefontaine-les-Varans;1396;39;1435
27;Bourgogne-Franche-Comté;25;1;05;454;Pirey;2127;42;2169
27;Bourgogne-Franche-Comté;25;1;17;455;Placey;198;4;202
27;Bourgogne-Franche-Comté;25;3;14;456;Plaimbois-du-Miroir;268;9;277
27;Bourgogne-Franche-Comté;25;3;18;457;Plaimbois-Vennes;109;0;109
27;Bourgogne-Franche-Comté;25;2;12;458;Les Plains-et-Grands-Essarts;214;5;219
27;Bourgogne-Franche-Comté;25;3;11;459;La Planée;314;10;324
27;Bourgogne-Franche-Comté;25;1;17;460;Le Val;242;24;266
27;Bourgogne-Franche-Comté;25;2;03;461;Pompierre-sur-Doubs;304;2;306
27;Bourgogne-Franche-Comté;25;3;16;462;Pontarlier;17542;898;18440
27;Bourgogne-Franche-Comté;25;2;19;463;Pont-de-Roide-Vermondans;4124;74;4198
27;Bourgogne-Franche-Comté;25;3;11;464;Les Pontets;132;4;136
27;Bourgogne-Franche-Comté;25;1;02;465;Pont-les-Moulins;203;3;206
27;Bourgogne-Franche-Comté;25;1;17;466;Pouilley-Français;828;18;846
27;Bourgogne-Franche-Comté;25;1;05;467;Pouilley-les-Vignes;1982;42;2024
27;Bourgogne-Franche-Comté;25;1;02;468;Pouligney-Lusans;846;19;865
27;Bourgogne-Franche-Comté;25;2;03;469;Présentevillers;458;12;470
27;Bourgogne-Franche-Comté;25;2;03;470;La Prétière;157;5;162
27;Bourgogne-Franche-Comté;25;2;18;471;Provenchère;138;3;141
27;Bourgogne-Franche-Comté;25;1;02;472;Puessans;31;3;34
27;Bourgogne-Franche-Comté;25;1;09;473;Pugey;731;21;752
27;Bourgogne-Franche-Comté;25;1;02;474;Le Puy;113;3;116
27;Bourgogne-Franche-Comté;25;1;17;475;Quingey;1441;14;1455
27;Bourgogne-Franche-Comté;25;2;03;476;Rahon;125;0;125
27;Bourgogne-Franche-Comté;25;1;04;477;Rancenay;396;6;402
27;Bourgogne-Franche-Comté;25;2;03;478;Randevillers;122;2;124
27;Bourgogne-Franche-Comté;25;2;03;479;Rang;401;4;405
27;Bourgogne-Franche-Comté;25;2;03;481;Raynans;334;5;339
27;Bourgogne-Franche-Comté;25;1;17;482;Recologne;667;3;670
27;Bourgogne-Franche-Comté;25;3;11;483;Reculfoz;39;3;42
27;Bourgogne-Franche-Comté;25;2;19;485;Rémondans-Vaivre;233;4;237
27;Bourgogne-Franche-Comté;25;3;11;486;Remoray-Boujeons;425;11;436
27;Bourgogne-Franche-Comté;25;3;15;487;Renédale;46;3;49
27;Bourgogne-Franche-Comté;25;1;17;488;Rennes-sur-Loue;109;6;115
27;Bourgogne-Franche-Comté;25;1;15;489;Reugney;284;27;311
27;Bourgogne-Franche-Comté;25;1;02;490;Rigney;375;19;394
27;Bourgogne-Franche-Comté;25;1;02;491;Rignosot;116;3;119
27;Bourgogne-Franche-Comté;25;1;02;492;Rillans;94;3;97
27;Bourgogne-Franche-Comté;25;3;11;493;La Rivière-Drugeon;920;26;946
27;Bourgogne-Franche-Comté;25;3;11;494;Rochejean;711;24;735
27;Bourgogne-Franche-Comté;25;1;08;495;Roche-lez-Beaupré;2157;26;2183
27;Bourgogne-Franche-Comté;25;2;03;496;Roche-lès-Clerval;101;0;101
27;Bourgogne-Franche-Comté;25;2;12;497;Roches-lès-Blamont;617;14;631
27;Bourgogne-Franche-Comté;25;1;02;498;Rognon;48;0;48
27;Bourgogne-Franche-Comté;25;1;02;499;Romain;124;2;126
27;Bourgogne-Franche-Comté;25;1;17;500;Ronchaux;87;1;88
27;Bourgogne-Franche-Comté;25;3;11;501;Rondefontaine;37;1;38
27;Bourgogne-Franche-Comté;25;1;17;502;Roset-Fluans;546;4;550
27;Bourgogne-Franche-Comté;25;2;18;503;Rosières-sur-Barbèche;116;4;120
27;Bourgogne-Franche-Comté;25;3;18;504;Rosureux;80;2;82
27;Bourgogne-Franche-Comté;25;1;02;505;Rougemont;1035;27;1062
27;Bourgogne-Franche-Comté;25;1;02;506;Rougemontot;92;0;92
27;Bourgogne-Franche-Comté;25;1;17;507;Rouhe;75;2;77
27;Bourgogne-Franche-Comté;25;1;02;508;Roulans;1130;23;1153
27;Bourgogne-Franche-Comté;25;1;17;510;Ruffey-le-Château;361;9;370
27;Bourgogne-Franche-Comté;25;1;17;511;Rurey;348;6;354
27;Bourgogne-Franche-Comté;25;3;14;512;Le Russey;2408;52;2460
27;Bourgogne-Franche-Comté;25;1;15;513;Sainte-Anne;47;0;47
27;Bourgogne-Franche-Comté;25;3;11;514;Saint-Antoine;341;17;358
27;Bourgogne-Franche-Comté;25;3;16;515;Sainte-Colombe;428;8;436
27;Bourgogne-Franche-Comté;25;2;03;516;Saint-Georges-Armont;124;6;130
27;Bourgogne-Franche-Comté;25;3;15;517;Saint-Gorgon-Main;284;4;288
27;Bourgogne-Franche-Comté;25;1;02;518;Saint-Hilaire;157;9;166
27;Bourgogne-Franche-Comté;25;2;12;519;Saint-Hippolyte;887;13;900
27;Bourgogne-Franche-Comté;25;1;02;520;Saint-Juan;176;3;179
27;Bourgogne-Franche-Comté;25;2;03;521;Saint-Julien-lès-Montbéliard;163;5;168
27;Bourgogne-Franche-Comté;25;3;14;522;Saint-Julien-lès-Russey;187;3;190
27;Bourgogne-Franche-Comté;25;2;03;523;Sainte-Marie;680;15;695
27;Bourgogne-Franche-Comté;25;2;03;524;Saint-Maurice-Colombier;903;26;929
27;Bourgogne-Franche-Comté;25;3;11;525;Saint-Point-Lac;292;12;304
27;Bourgogne-Franche-Comté;25;2;13;526;Sainte-Suzanne;1455;41;1496
27;Bourgogne-Franche-Comté;25;1;17;527;Saint-Vit;4922;73;4995
27;Bourgogne-Franche-Comté;25;1;17;528;Samson;74;0;74
27;Bourgogne-Franche-Comté;25;2;03;529;Sancey;1308;27;1335
27;Bourgogne-Franche-Comté;25;1;08;532;Saône;3231;69;3300
27;Bourgogne-Franche-Comté;25;1;15;533;Saraz;15;0;15
27;Bourgogne-Franche-Comté;25;3;11;534;Sarrageois;193;4;197
27;Bourgogne-Franche-Comté;25;1;15;535;Saules;229;6;235
27;Bourgogne-Franche-Comté;25;1;17;536;Sauvagney;187;2;189
27;Bourgogne-Franche-Comté;25;1;15;537;Scey-Maisières;284;9;293
27;Bourgogne-Franche-Comté;25;1;02;538;Séchin;116;4;120
27;Bourgogne-Franche-Comté;25;2;01;539;Seloncourt;5726;143;5869
27;Bourgogne-Franche-Comté;25;2;03;540;Semondans;307;6;313
27;Bourgogne-Franche-Comté;25;3;15;541;Septfontaines;371;8;379
27;Bourgogne-Franche-Comté;25;1;05;542;Serre-les-Sapins;1764;30;1794
27;Bourgogne-Franche-Comté;25;1;03;544;Servin;208;9;217
27;Bourgogne-Franche-Comté;25;1;15;545;Silley-Amancey;144;2;146
27;Bourgogne-Franche-Comté;25;1;02;546;Silley-Bléfond;60;1;61
27;Bourgogne-Franche-Comté;25;2;10;547;Sochaux;3829;41;3870
27;Bourgogne-Franche-Comté;25;2;19;548;Solemont;139;7;146
27;Bourgogne-Franche-Comté;25;3;15;549;Sombacour;632;7;639
27;Bourgogne-Franche-Comté;25;3;18;550;La Sommette;242;7;249
27;Bourgogne-Franche-Comté;25;2;12;551;Soulce-Cernay;131;1;132
27;Bourgogne-Franche-Comté;25;2;03;552;Sourans;117;2;119
27;Bourgogne-Franche-Comté;25;2;03;553;Soye;399;9;408
27;Bourgogne-Franche-Comté;25;2;03;554;Surmont;116;3;119
27;Bourgogne-Franche-Comté;25;2;01;555;Taillecourt;1098;25;1123
27;Bourgogne-Franche-Comté;25;1;02;556;Tallans;47;3;50
27;Bourgogne-Franche-Comté;25;1;06;557;Tallenay;425;8;433
27;Bourgogne-Franche-Comté;25;1;15;558;Tarcenay-Foucherans;1528;24;1552
27;Bourgogne-Franche-Comté;25;2;12;559;Thiébouhans;257;6;263
27;Bourgogne-Franche-Comté;25;1;07;560;Thise;3020;42;3062
27;Bourgogne-Franche-Comté;25;1;09;561;Thoraise;348;9;357
27;Bourgogne-Franche-Comté;25;2;12;562;Thulay;213;6;219
27;Bourgogne-Franche-Comté;25;1;02;563;Thurey-le-Mont;122;2;124
27;Bourgogne-Franche-Comté;25;1;09;564;Torpes;1019;16;1035
27;Bourgogne-Franche-Comté;25;3;11;565;Touillon-et-Loutelet;275;13;288
27;Bourgogne-Franche-Comté;25;1;02;566;La Tour-de-Sçay;300;4;304
27;Bourgogne-Franche-Comté;25;1;02;567;Tournans;117;3;120
27;Bourgogne-Franche-Comté;25;1;15;569;Trépot;540;11;551
27;Bourgogne-Franche-Comté;25;1;02;570;Tressandans;26;1;27
27;Bourgogne-Franche-Comté;25;2;12;571;Trévillers;498;11;509
27;Bourgogne-Franche-Comté;25;1;02;572;Trouvans;105;5;110
27;Bourgogne-Franche-Comté;25;2;12;573;Urtière;13;0;13
27;Bourgogne-Franche-Comté;25;1;02;574;Uzelle;175;1;176
27;Bourgogne-Franche-Comté;25;1;08;575;Vaire;807;10;817
27;Bourgogne-Franche-Comté;25;3;18;578;Valdahon;5748;101;5849
27;Bourgogne-Franche-Comté;25;1;02;579;Val-de-Roulans;206;3;209
27;Bourgogne-Franche-Comté;25;2;19;580;Valentigney;11272;169;11441
27;Bourgogne-Franche-Comté;25;1;02;582;Valleroy;142;2;144
27;Bourgogne-Franche-Comté;25;2;03;583;Valonne;251;5;256
27;Bourgogne-Franche-Comté;25;2;12;584;Valoreille;125;4;129
27;Bourgogne-Franche-Comté;25;2;01;586;Vandoncourt;815;31;846
27;Bourgogne-Franche-Comté;25;2;18;588;Vaucluse;120;30;150
27;Bourgogne-Franche-Comté;25;2;18;589;Vauclusotte;84;1;85
27;Bourgogne-Franche-Comté;25;1;03;590;Vaudrivillers;84;2;86
27;Bourgogne-Franche-Comté;25;2;12;591;Vaufrey;157;0;157
27;Bourgogne-Franche-Comté;25;3;11;592;Vaux-et-Chantegrue;624;14;638
27;Bourgogne-Franche-Comté;25;1;17;594;Velesmes-Essarts;352;4;356
27;Bourgogne-Franche-Comté;25;2;03;595;Vellerot-lès-Belvoir;93;0;93
27;Bourgogne-Franche-Comté;25;3;18;596;Vellerot-lès-Vercel;71;1;72
27;Bourgogne-Franche-Comté;25;2;03;597;Vellevans;236;3;239
27;Bourgogne-Franche-Comté;25;1;02;598;Venise;522;7;529
27;Bourgogne-Franche-Comté;25;1;02;599;Vennans;256;8;264
27;Bourgogne-Franche-Comté;25;3;18;600;Vennes;205;4;209
27;Bourgogne-Franche-Comté;25;3;18;601;Vercel-Villedieu-le-Camp;1664;83;1747
27;Bourgogne-Franche-Comté;25;1;02;602;Vergranne;115;5;120
27;Bourgogne-Franche-Comté;25;1;02;604;Verne;126;4;130
27;Bourgogne-Franche-Comté;25;3;18;605;Vernierfontaine;471;11;482
27;Bourgogne-Franche-Comté;25;2;03;607;Vernois-lès-Belvoir;60;1;61
27;Bourgogne-Franche-Comté;25;2;03;608;Le Vernoy;175;2;177
27;Bourgogne-Franche-Comté;25;3;16;609;Verrières-de-Joux;476;11;487
27;Bourgogne-Franche-Comté;25;1;08;611;La Vèze;478;7;485
27;Bourgogne-Franche-Comté;25;1;02;612;Vieilley;692;20;712
27;Bourgogne-Franche-Comté;25;1;02;613;Viéthorey;94;2;96
27;Bourgogne-Franche-Comté;25;2;10;614;Vieux-Charmont;2793;54;2847
27;Bourgogne-Franche-Comté;25;2;12;615;Villars-lès-Blamont;441;6;447
27;Bourgogne-Franche-Comté;25;1;17;616;Villars-Saint-Georges;280;3;283
27;Bourgogne-Franche-Comté;25;2;19;617;Villars-sous-Dampjoux;353;6;359
27;Bourgogne-Franche-Comté;25;2;03;618;Villars-sous-Écot;347;8;355
27;Bourgogne-Franche-Comté;25;3;11;619;Les Villedieu;202;3;205
27;Bourgogne-Franche-Comté;25;3;15;620;Ville-du-Pont;336;7;343
27;Bourgogne-Franche-Comté;25;3;11;621;Villeneuve-d'Amont;227;36;263
27;Bourgogne-Franche-Comté;25;1;17;622;Villers-Buzon;259;1;260
27;Bourgogne-Franche-Comté;25;3;18;623;Villers-Chief;126;1;127
27;Bourgogne-Franche-Comté;25;1;02;624;Villers-Grélot;148;3;151
27;Bourgogne-Franche-Comté;25;3;18;625;Villers-la-Combe;52;1;53
27;Bourgogne-Franche-Comté;25;1;02;626;Villers-Saint-Martin;221;8;229
27;Bourgogne-Franche-Comté;25;3;11;627;Villers-sous-Chalamont;304;5;309
27;Bourgogne-Franche-Comté;25;1;15;628;Villers-sous-Montrond;210;3;213
27;Bourgogne-Franche-Comté;25;1;02;629;Voillans;204;6;210
27;Bourgogne-Franche-Comté;25;1;18;630;Voires;80;0;80
27;Bourgogne-Franche-Comté;25;1;09;631;Vorges-les-Pins;601;11;612
27;Bourgogne-Franche-Comté;25;2;19;632;Voujeaucourt;3148;85;3233
27;Bourgogne-Franche-Comté;25;1;15;633;Vuillafans;735;13;748
27;Bourgogne-Franche-Comté;25;3;16;634;Vuillecin;637;23;660
27;Bourgogne-Franche-Comté;25;2;03;635;Vyt-lès-Belvoir;188;3;191
84;Auvergne-Rhône-Alpes;26;1;04;001;Solaure en Diois;428;8;436
84;Auvergne-Rhône-Alpes;26;3;12;002;Albon;1985;37;2022
84;Auvergne-Rhône-Alpes;26;2;03;003;Aleyrac;50;0;50
84;Auvergne-Rhône-Alpes;26;3;01;004;Alixan;2546;77;2623
84;Auvergne-Rhône-Alpes;26;2;09;005;Allan;1791;50;1841
84;Auvergne-Rhône-Alpes;26;1;07;006;Allex;2495;77;2572
84;Auvergne-Rhône-Alpes;26;1;07;007;Ambonil;104;7;111
84;Auvergne-Rhône-Alpes;26;2;08;008;Ancône;1370;28;1398
84;Auvergne-Rhône-Alpes;26;3;12;009;Andancette;1337;35;1372
84;Auvergne-Rhône-Alpes;26;3;12;010;Anneyron;4063;97;4160
84;Auvergne-Rhône-Alpes;26;1;02;011;Aouste-sur-Sye;2580;42;2622
84;Auvergne-Rhône-Alpes;26;1;04;012;Arnayon;21;3;24
84;Auvergne-Rhône-Alpes;26;2;10;013;Arpavon;77;3;80
84;Auvergne-Rhône-Alpes;26;3;05;014;Arthémonay;594;8;602
84;Auvergne-Rhône-Alpes;26;1;04;015;Aubenasson;77;4;81
84;Auvergne-Rhône-Alpes;26;2;10;016;Aubres;418;16;434
84;Auvergne-Rhône-Alpes;26;1;04;017;Aucelon;16;0;16
84;Auvergne-Rhône-Alpes;26;2;10;018;Aulan;12;1;13
84;Auvergne-Rhône-Alpes;26;1;04;019;Aurel;244;3;247
84;Auvergne-Rhône-Alpes;26;1;02;020;La Répara-Auriples;242;6;248
84;Auvergne-Rhône-Alpes;26;1;02;021;Autichamp;124;4;128
84;Auvergne-Rhône-Alpes;26;2;10;022;Ballons;88;3;91
84;Auvergne-Rhône-Alpes;26;3;19;023;Barbières;1105;19;1124
84;Auvergne-Rhône-Alpes;26;3;02;024;Barcelonne;354;10;364
84;Auvergne-Rhône-Alpes;26;1;04;025;Barnave;201;10;211
84;Auvergne-Rhône-Alpes;26;2;10;026;Barret-de-Lioure;66;0;66
84;Auvergne-Rhône-Alpes;26;1;04;027;Barsac;139;2;141
84;Auvergne-Rhône-Alpes;26;3;05;028;Bathernay;235;13;248
84;Auvergne-Rhône-Alpes;26;1;04;030;La Bâtie-des-Fonds;2;0;2
84;Auvergne-Rhône-Alpes;26;2;03;031;La Bâtie-Rolland;1029;27;1056
84;Auvergne-Rhône-Alpes;26;3;02;032;La Baume-Cornillane;452;9;461
84;Auvergne-Rhône-Alpes;26;2;06;033;La Baume-de-Transit;926;17;943
84;Auvergne-Rhône-Alpes;26;3;19;034;La Baume-d'Hostun;576;9;585
84;Auvergne-Rhône-Alpes;26;1;02;035;Beaufort-sur-Gervanne;477;8;485
84;Auvergne-Rhône-Alpes;26;1;04;036;Beaumont-en-Diois;105;4;109
84;Auvergne-Rhône-Alpes;26;3;17;037;Beaumont-lès-Valence;3984;85;4069
84;Auvergne-Rhône-Alpes;26;3;13;038;Beaumont-Monteux;1324;33;1357
84;Auvergne-Rhône-Alpes;26;3;19;039;Beauregard-Baret;874;13;887
84;Auvergne-Rhône-Alpes;26;1;04;040;Beaurières;69;2;71
84;Auvergne-Rhône-Alpes;26;3;12;041;Beausemblant;1427;26;1453
84;Auvergne-Rhône-Alpes;26;3;17;042;Beauvallon;1599;26;1625
84;Auvergne-Rhône-Alpes;26;2;10;043;Beauvoisin;144;5;149
84;Auvergne-Rhône-Alpes;26;2;03;045;La Bégude-de-Mazenc;1654;47;1701
84;Auvergne-Rhône-Alpes;26;2;10;046;Bellecombe-Tarendol;68;3;71
84;Auvergne-Rhône-Alpes;26;1;04;047;Bellegarde-en-Diois;92;0;92
84;Auvergne-Rhône-Alpes;26;2;10;048;Bénivay-Ollon;72;1;73
84;Auvergne-Rhône-Alpes;26;3;19;049;Bésayes;1250;37;1287
84;Auvergne-Rhône-Alpes;26;2;10;050;Bésignan;86;2;88
84;Auvergne-Rhône-Alpes;26;2;03;051;Bézaudun-sur-Bîne;67;2;69
84;Auvergne-Rhône-Alpes;26;2;03;052;Bonlieu-sur-Roubion;481;12;493
84;Auvergne-Rhône-Alpes;26;2;06;054;Bouchet;1544;22;1566
84;Auvergne-Rhône-Alpes;26;1;04;055;Boulc;153;2;155
84;Auvergne-Rhône-Alpes;26;2;03;056;Bourdeaux;679;15;694
84;Auvergne-Rhône-Alpes;26;3;01;057;Bourg-de-Péage;9957;145;10102
84;Auvergne-Rhône-Alpes;26;3;15;058;Bourg-lès-Valence;19792;566;20358
84;Auvergne-Rhône-Alpes;26;1;19;059;Bouvante;212;3;215
84;Auvergne-Rhône-Alpes;26;2;03;060;Bouvières;147;6;153
84;Auvergne-Rhône-Alpes;26;3;05;061;Bren;595;10;605
84;Auvergne-Rhône-Alpes;26;1;04;062;Brette;36;3;39
84;Auvergne-Rhône-Alpes;26;2;10;063;Buis-les-Baronnies;2325;95;2420
84;Auvergne-Rhône-Alpes;26;3;16;064;Chabeuil;6814;179;6993
84;Auvergne-Rhône-Alpes;26;1;02;065;Chabrillan;751;8;759
84;Auvergne-Rhône-Alpes;26;1;19;066;Le Chaffal;41;0;41
84;Auvergne-Rhône-Alpes;26;1;04;067;Chalancon;58;1;59
84;Auvergne-Rhône-Alpes;26;3;05;068;Le Chalon;211;6;217
84;Auvergne-Rhône-Alpes;26;1;04;069;Chamaloc;129;3;132
84;Auvergne-Rhône-Alpes;26;2;06;070;Chamaret;527;11;538
84;Auvergne-Rhône-Alpes;26;3;13;071;Chanos-Curson;1084;33;1117
84;Auvergne-Rhône-Alpes;26;3;13;072;Chantemerle-les-Blés;1292;20;1312
84;Auvergne-Rhône-Alpes;26;2;06;073;Chantemerle-lès-Grignan;242;3;245
84;Auvergne-Rhône-Alpes;26;1;19;074;La Chapelle-en-Vercors;720;132;852
84;Auvergne-Rhône-Alpes;26;2;10;075;La Charce;28;1;29
84;Auvergne-Rhône-Alpes;26;1;04;076;Charens;27;0;27
84;Auvergne-Rhône-Alpes;26;3;05;077;Charmes-sur-l'Herbasse;887;22;909
84;Auvergne-Rhône-Alpes;26;2;03;078;Charols;935;14;949
84;Auvergne-Rhône-Alpes;26;3;19;079;Charpey;1500;38;1538
84;Auvergne-Rhône-Alpes;26;1;04;080;Chastel-Arnaud;43;0;43
84;Auvergne-Rhône-Alpes;26;3;02;081;Châteaudouble;576;24;600
84;Auvergne-Rhône-Alpes;26;2;10;082;Châteauneuf-de-Bordette;102;1;103
84;Auvergne-Rhône-Alpes;26;3;05;083;Châteauneuf-de-Galaure;1831;580;2411
84;Auvergne-Rhône-Alpes;26;3;13;084;Châteauneuf-sur-Isère;3945;147;4092
84;Auvergne-Rhône-Alpes;26;2;09;085;Châteauneuf-du-Rhône;2724;52;2776
84;Auvergne-Rhône-Alpes;26;1;04;086;Châtillon-en-Diois;666;12;678
84;Auvergne-Rhône-Alpes;26;3;11;087;Châtillon-Saint-Jean;1316;45;1361
84;Auvergne-Rhône-Alpes;26;3;19;088;Chatuzange-le-Goubet;5934;136;6070
84;Auvergne-Rhône-Alpes;26;2;10;089;Chaudebonne;61;1;62
84;Auvergne-Rhône-Alpes;26;1;04;090;La Chaudière;33;0;33
84;Auvergne-Rhône-Alpes;26;2;10;091;Chauvac-Laux-Montaux;42;0;42
84;Auvergne-Rhône-Alpes;26;3;05;092;Chavannes;735;11;746
84;Auvergne-Rhône-Alpes;26;2;14;093;Clansayes;531;13;544
84;Auvergne-Rhône-Alpes;26;3;12;094;Claveyson;862;24;886
84;Auvergne-Rhône-Alpes;26;2;03;095;Cléon-d'Andran;922;32;954
84;Auvergne-Rhône-Alpes;26;3;11;096;Clérieux;2061;37;2098
84;Auvergne-Rhône-Alpes;26;1;07;097;Cliousclat;616;16;632
84;Auvergne-Rhône-Alpes;26;1;02;098;Cobonne;167;5;172
84;Auvergne-Rhône-Alpes;26;2;06;099;Colonzelle;556;12;568
84;Auvergne-Rhône-Alpes;26;3;02;100;Combovin;449;15;464
84;Auvergne-Rhône-Alpes;26;2;03;101;Comps;143;10;153
84;Auvergne-Rhône-Alpes;26;2;03;102;Condillac;136;7;143
84;Auvergne-Rhône-Alpes;26;2;10;103;Condorcet;499;4;503
84;Auvergne-Rhône-Alpes;26;2;10;104;Cornillac;89;0;89
84;Auvergne-Rhône-Alpes;26;2;10;105;Cornillon-sur-l'Oule;72;1;73
84;Auvergne-Rhône-Alpes;26;2;08;106;La Coucourde;1157;22;1179
84;Auvergne-Rhône-Alpes;26;3;05;107;Crépol;542;15;557
84;Auvergne-Rhône-Alpes;26;1;02;108;Crest;8680;274;8954
84;Auvergne-Rhône-Alpes;26;3;13;110;Crozes-Hermitage;659;10;669
84;Auvergne-Rhône-Alpes;26;2;03;111;Crupies;100;1;101
84;Auvergne-Rhône-Alpes;26;2;10;112;Curnier;197;8;205
84;Auvergne-Rhône-Alpes;26;1;04;113;Die;4718;240;4958
84;Auvergne-Rhône-Alpes;26;2;03;114;Dieulefit;3239;136;3375
84;Auvergne-Rhône-Alpes;26;1;02;115;Divajeu;663;70;733
84;Auvergne-Rhône-Alpes;26;2;06;116;Donzère;5921;102;6023
84;Auvergne-Rhône-Alpes;26;1;19;117;Échevis;56;4;60
84;Auvergne-Rhône-Alpes;26;3;05;118;Épinouze;1510;22;1532
84;Auvergne-Rhône-Alpes;26;3;13;119;Érôme;806;7;813
84;Auvergne-Rhône-Alpes;26;2;09;121;Espeluche;1103;41;1144
84;Auvergne-Rhône-Alpes;26;1;04;122;Espenel;179;2;181
84;Auvergne-Rhône-Alpes;26;1;04;123;Establet;25;0;25
84;Auvergne-Rhône-Alpes;26;3;07;124;Étoile-sur-Rhône;5520;127;5647
84;Auvergne-Rhône-Alpes;26;1;02;125;Eurre;1387;33;1420
84;Auvergne-Rhône-Alpes;26;2;10;126;Eygalayes;91;0;91
84;Auvergne-Rhône-Alpes;26;2;10;127;Eygaliers;115;2;117
84;Auvergne-Rhône-Alpes;26;1;04;128;Eygluy-Escoulin;74;0;74
84;Auvergne-Rhône-Alpes;26;3;19;129;Eymeux;1026;22;1048
84;Auvergne-Rhône-Alpes;26;2;10;130;Eyroles;24;0;24
84;Auvergne-Rhône-Alpes;26;2;03;131;Eyzahut;150;1;151
84;Auvergne-Rhône-Alpes;26;3;12;133;Fay-le-Clos;163;4;167
84;Auvergne-Rhône-Alpes;26;1;03;134;Félines-sur-Rimandoule;83;1;84
84;Auvergne-Rhône-Alpes;26;2;10;135;Ferrassières;124;2;126
84;Auvergne-Rhône-Alpes;26;1;04;136;Val-Maravel;51;0;51
84;Auvergne-Rhône-Alpes;26;1;03;137;Francillon-sur-Roubion;191;2;193
84;Auvergne-Rhône-Alpes;26;2;14;138;La Garde-Adhémar;1115;34;1149
84;Auvergne-Rhône-Alpes;26;3;11;139;Génissieux;2392;57;2449
84;Auvergne-Rhône-Alpes;26;3;05;140;Geyssans;717;28;745
84;Auvergne-Rhône-Alpes;26;1;02;141;Gigors-et-Lozeron;210;5;215
84;Auvergne-Rhône-Alpes;26;1;04;142;Glandage;118;1;119
84;Auvergne-Rhône-Alpes;26;3;05;143;Le Grand-Serre;906;51;957
84;Auvergne-Rhône-Alpes;26;1;02;144;Grane;1961;51;2012
84;Auvergne-Rhône-Alpes;26;2;06;145;Les Granges-Gontardes;664;20;684
84;Auvergne-Rhône-Alpes;26;2;06;146;Grignan;1577;44;1621
84;Auvergne-Rhône-Alpes;26;1;04;147;Gumiane;19;1;20
84;Auvergne-Rhône-Alpes;26;3;05;148;Hauterives;1894;57;1951
84;Auvergne-Rhône-Alpes;26;3;19;149;Hostun;991;8;999
84;Auvergne-Rhône-Alpes;26;2;10;150;Izon-la-Bruisse;11;0;11
84;Auvergne-Rhône-Alpes;26;1;04;152;Jonchères;27;0;27
84;Auvergne-Rhône-Alpes;26;2;10;153;Laborel;98;1;99
84;Auvergne-Rhône-Alpes;26;2;10;154;Lachau;240;4;244
84;Auvergne-Rhône-Alpes;26;3;05;155;Lapeyrouse-Mornay;1221;18;1239
84;Auvergne-Rhône-Alpes;26;3;13;156;Larnage;1057;43;1100
84;Auvergne-Rhône-Alpes;26;2;03;157;La Laupie;748;17;765
84;Auvergne-Rhône-Alpes;26;1;04;159;Laval-d'Aix;116;2;118
84;Auvergne-Rhône-Alpes;26;3;12;160;Laveyron;1232;17;1249
84;Auvergne-Rhône-Alpes;26;2;10;161;Lemps;49;0;49
84;Auvergne-Rhône-Alpes;26;3;05;162;Lens-Lestang;891;29;920
84;Auvergne-Rhône-Alpes;26;1;19;163;Léoncel;51;0;51
84;Auvergne-Rhône-Alpes;26;1;04;164;Lesches-en-Diois;56;1;57
84;Auvergne-Rhône-Alpes;26;1;07;165;Livron-sur-Drôme;9202;152;9354
84;Auvergne-Rhône-Alpes;26;1;07;166;Loriol-sur-Drôme;6616;94;6710
84;Auvergne-Rhône-Alpes;26;1;04;167;Luc-en-Diois;538;1;539
84;Auvergne-Rhône-Alpes;26;1;04;168;Lus-la-Croix-Haute;535;14;549
84;Auvergne-Rhône-Alpes;26;2;06;169;Malataverne;2182;42;2224
84;Auvergne-Rhône-Alpes;26;3;16;170;Malissard;3207;97;3304
84;Auvergne-Rhône-Alpes;26;2;03;171;Manas;191;9;200
84;Auvergne-Rhône-Alpes;26;3;05;172;Manthes;664;10;674
84;Auvergne-Rhône-Alpes;26;3;19;173;Marches;876;20;896
84;Auvergne-Rhône-Alpes;26;3;05;174;Margès;1116;32;1148
84;Auvergne-Rhône-Alpes;26;1;04;175;Marignac-en-Diois;224;9;233
84;Auvergne-Rhône-Alpes;26;2;03;176;Marsanne;1301;42;1343
84;Auvergne-Rhône-Alpes;26;3;05;177;Marsaz;700;22;722
84;Auvergne-Rhône-Alpes;26;1;04;178;Menglon;534;7;541
84;Auvergne-Rhône-Alpes;26;3;13;179;Mercurol-Veaunes;2732;56;2788
84;Auvergne-Rhône-Alpes;26;2;10;180;Mérindol-les-Oliviers;220;6;226
84;Auvergne-Rhône-Alpes;26;2;10;181;Mévouillon;235;7;242
84;Auvergne-Rhône-Alpes;26;2;10;182;Mirabel-aux-Baronnies;1550;35;1585
84;Auvergne-Rhône-Alpes;26;1;02;183;Mirabel-et-Blacons;1170;30;1200
84;Auvergne-Rhône-Alpes;26;1;07;185;Mirmande;587;14;601
84;Auvergne-Rhône-Alpes;26;1;04;186;Miscon;53;1;54
84;Auvergne-Rhône-Alpes;26;2;10;188;Mollans-sur-Ouvèze;1064;24;1088
84;Auvergne-Rhône-Alpes;26;2;10;189;Montauban-sur-l'Ouvèze;119;2;121
84;Auvergne-Rhône-Alpes;26;2;10;190;Montaulieu;85;2;87
84;Auvergne-Rhône-Alpes;26;2;09;191;Montboucher-sur-Jabron;2400;60;2460
84;Auvergne-Rhône-Alpes;26;2;06;192;Montbrison-sur-Lez;275;11;286
84;Auvergne-Rhône-Alpes;26;2;10;193;Montbrun-les-Bains;442;9;451
84;Auvergne-Rhône-Alpes;26;3;05;194;Montchenu;581;16;597
84;Auvergne-Rhône-Alpes;26;1;02;195;Montclar-sur-Gervanne;191;3;194
84;Auvergne-Rhône-Alpes;26;3;17;196;Montéléger;1796;140;1936
84;Auvergne-Rhône-Alpes;26;3;16;197;Montélier;4271;118;4389
84;Auvergne-Rhône-Alpes;26;2;97;198;Montélimar;39818;1234;41052
84;Auvergne-Rhône-Alpes;26;2;10;199;Montferrand-la-Fare;28;0;28
84;Auvergne-Rhône-Alpes;26;2;10;200;Montfroc;75;1;76
84;Auvergne-Rhône-Alpes;26;2;10;201;Montguers;48;6;54
84;Auvergne-Rhône-Alpes;26;2;03;202;Montjoux;332;11;343
84;Auvergne-Rhône-Alpes;26;2;06;203;Montjoyer;281;6;287
84;Auvergne-Rhône-Alpes;26;1;04;204;Montlaur-en-Diois;143;5;148
84;Auvergne-Rhône-Alpes;26;1;04;205;Montmaur-en-Diois;85;0;85
84;Auvergne-Rhône-Alpes;26;3;02;206;Montmeyran;2942;101;3043
84;Auvergne-Rhône-Alpes;26;3;05;207;Montmiral;696;18;714
84;Auvergne-Rhône-Alpes;26;1;07;208;Montoison;1937;36;1973
84;Auvergne-Rhône-Alpes;26;2;10;209;Montréal-les-Sources;24;0;24
84;Auvergne-Rhône-Alpes;26;3;05;210;Valherbasse;1025;24;1049
84;Auvergne-Rhône-Alpes;26;2;06;211;Montségur-sur-Lauzon;1348;27;1375
84;Auvergne-Rhône-Alpes;26;3;02;212;Montvendre;1200;30;1230
84;Auvergne-Rhône-Alpes;26;3;05;213;Moras-en-Valloire;681;15;696
84;Auvergne-Rhône-Alpes;26;1;03;214;Mornans;75;0;75
84;Auvergne-Rhône-Alpes;26;1;04;215;La Motte-Chalancon;416;22;438
84;Auvergne-Rhône-Alpes;26;3;12;216;La Motte-de-Galaure;795;15;810
84;Auvergne-Rhône-Alpes;26;1;19;217;La Motte-Fanjas;193;3;196
84;Auvergne-Rhône-Alpes;26;3;11;218;Mours-Saint-Eusèbe;3229;56;3285
84;Auvergne-Rhône-Alpes;26;3;12;219;Mureils;473;8;481
84;Auvergne-Rhône-Alpes;26;2;10;220;Nyons;6772;186;6958
84;Auvergne-Rhône-Alpes;26;1;02;221;Omblèze;71;2;73
84;Auvergne-Rhône-Alpes;26;2;03;222;Orcinas;39;0;39
84;Auvergne-Rhône-Alpes;26;1;19;223;Oriol-en-Royans;523;6;529
84;Auvergne-Rhône-Alpes;26;3;02;224;Ourches;267;8;275
84;Auvergne-Rhône-Alpes;26;3;05;225;Parnans;699;21;720
84;Auvergne-Rhône-Alpes;26;2;06;226;Le Pègue;368;6;374
84;Auvergne-Rhône-Alpes;26;2;10;227;Pelonne;27;0;27
84;Auvergne-Rhône-Alpes;26;1;04;228;Pennes-le-Sec;40;0;40
84;Auvergne-Rhône-Alpes;26;2;10;229;La Penne-sur-l'Ouvèze;95;1;96
84;Auvergne-Rhône-Alpes;26;3;11;231;Peyrins;2629;69;2698
84;Auvergne-Rhône-Alpes;26;3;02;232;Peyrus;592;8;600
84;Auvergne-Rhône-Alpes;26;2;10;233;Piégon;242;9;251
84;Auvergne-Rhône-Alpes;26;1;02;234;Piégros-la-Clastre;873;17;890
84;Auvergne-Rhône-Alpes;26;2;14;235;Pierrelatte;13510;259;13769
84;Auvergne-Rhône-Alpes;26;2;10;236;Pierrelongue;214;4;218
84;Auvergne-Rhône-Alpes;26;2;10;238;Les Pilles;240;2;242
84;Auvergne-Rhône-Alpes;26;2;10;239;Plaisians;206;4;210
84;Auvergne-Rhône-Alpes;26;1;02;240;Plan-de-Baix;147;3;150
84;Auvergne-Rhône-Alpes;26;1;03;241;Le Poët-Célard;132;2;134
84;Auvergne-Rhône-Alpes;26;2;10;242;Le Poët-en-Percip;17;0;17
84;Auvergne-Rhône-Alpes;26;2;03;243;Le Poët-Laval;968;39;1007
84;Auvergne-Rhône-Alpes;26;2;10;244;Le Poët-Sigillat;134;1;135
84;Auvergne-Rhône-Alpes;26;2;10;245;Pommerol;6;0;6
84;Auvergne-Rhône-Alpes;26;1;04;246;Ponet-et-Saint-Auban;126;4;130
84;Auvergne-Rhône-Alpes;26;3;12;247;Ponsas;531;8;539
84;Auvergne-Rhône-Alpes;26;1;04;248;Pontaix;175;5;180
84;Auvergne-Rhône-Alpes;26;2;03;249;Pont-de-Barret;672;17;689
84;Auvergne-Rhône-Alpes;26;3;13;250;Pont-de-l'Isère;3573;49;3622
84;Auvergne-Rhône-Alpes;26;2;03;251;Portes-en-Valdaine;412;12;424
84;Auvergne-Rhône-Alpes;26;3;17;252;Portes-lès-Valence;10680;151;10831
84;Auvergne-Rhône-Alpes;26;1;04;253;Poyols;72;1;73
84;Auvergne-Rhône-Alpes;26;1;04;254;Pradelle;18;0;18
84;Auvergne-Rhône-Alpes;26;1;04;255;Les Prés;23;0;23
84;Auvergne-Rhône-Alpes;26;2;10;256;Propiac;141;2;143
84;Auvergne-Rhône-Alpes;26;2;03;257;Puygiron;453;21;474
84;Auvergne-Rhône-Alpes;26;1;03;258;Puy-Saint-Martin;887;29;916
84;Auvergne-Rhône-Alpes;26;3;05;259;Ratières;266;12;278
84;Auvergne-Rhône-Alpes;26;2;06;261;Réauville;396;11;407
84;Auvergne-Rhône-Alpes;26;1;04;262;Recoubeau-Jansac;260;7;267
84;Auvergne-Rhône-Alpes;26;2;10;263;Reilhanette;146;2;148
84;Auvergne-Rhône-Alpes;26;2;10;264;Rémuzat;329;7;336
84;Auvergne-Rhône-Alpes;26;1;04;266;Rimon-et-Savel;24;0;24
84;Auvergne-Rhône-Alpes;26;2;10;267;Rioms;25;1;26
84;Auvergne-Rhône-Alpes;26;2;03;268;Rochebaudin;122;0;122
84;Auvergne-Rhône-Alpes;26;2;10;269;Rochebrune;56;0;56
84;Auvergne-Rhône-Alpes;26;1;19;270;Rochechinard;125;2;127
84;Auvergne-Rhône-Alpes;26;3;13;271;La Roche-de-Glun;3395;64;3459
84;Auvergne-Rhône-Alpes;26;2;03;272;Rochefort-en-Valdaine;361;9;370
84;Auvergne-Rhône-Alpes;26;3;19;273;Rochefort-Samson;1023;20;1043
84;Auvergne-Rhône-Alpes;26;1;04;274;Rochefourchat;1;0;1
84;Auvergne-Rhône-Alpes;26;2;14;275;Rochegude;1640;46;1686
84;Auvergne-Rhône-Alpes;26;2;03;276;Roche-Saint-Secret-Béconne;464;14;478
84;Auvergne-Rhône-Alpes;26;1;02;277;La Roche-sur-Grane;164;4;168
84;Auvergne-Rhône-Alpes;26;2;10;278;La Roche-sur-le-Buis;283;10;293
84;Auvergne-Rhône-Alpes;26;2;10;279;La Rochette-du-Buis;60;2;62
84;Auvergne-Rhône-Alpes;26;3;98;281;Romans-sur-Isère;33098;680;33778
84;Auvergne-Rhône-Alpes;26;1;04;282;Romeyer;187;8;195
84;Auvergne-Rhône-Alpes;26;1;04;283;Rottier;23;0;23
84;Auvergne-Rhône-Alpes;26;2;06;284;Roussas;382;8;390
84;Auvergne-Rhône-Alpes;26;2;06;285;Rousset-les-Vignes;280;9;289
84;Auvergne-Rhône-Alpes;26;2;10;286;Roussieux;24;1;25
84;Auvergne-Rhône-Alpes;26;2;03;287;Roynac;485;15;500
84;Auvergne-Rhône-Alpes;26;2;10;288;Sahune;308;6;314
84;Auvergne-Rhône-Alpes;26;1;04;289;Saillans;1364;21;1385
84;Auvergne-Rhône-Alpes;26;1;19;290;Saint-Agnan-en-Vercors;362;10;372
84;Auvergne-Rhône-Alpes;26;1;04;291;Saint-Andéol;84;2;86
84;Auvergne-Rhône-Alpes;26;2;10;292;Saint-Auban-sur-l'Ouvèze;212;4;216
84;Auvergne-Rhône-Alpes;26;3;05;293;Saint-Avit;324;8;332
84;Auvergne-Rhône-Alpes;26;3;11;294;Saint-Bardoux;603;18;621
84;Auvergne-Rhône-Alpes;26;3;12;295;Saint-Barthélemy-de-Vals;1858;30;1888
84;Auvergne-Rhône-Alpes;26;1;04;296;Saint-Benoit-en-Diois;31;1;32
84;Auvergne-Rhône-Alpes;26;3;05;298;Saint-Christophe-et-le-Laris;419;5;424
84;Auvergne-Rhône-Alpes;26;1;04;299;Sainte-Croix;105;4;109
84;Auvergne-Rhône-Alpes;26;1;04;300;Saint-Dizier-en-Diois;48;1;49
84;Auvergne-Rhône-Alpes;26;3;05;301;Saint-Donat-sur-l'Herbasse;4248;90;4338
84;Auvergne-Rhône-Alpes;26;1;19;302;Sainte-Eulalie-en-Royans;547;11;558
84;Auvergne-Rhône-Alpes;26;2;10;303;Sainte-Euphémie-sur-Ouvèze;73;4;77
84;Auvergne-Rhône-Alpes;26;2;10;304;Saint-Ferréol-Trente-Pas;275;3;278
84;Auvergne-Rhône-Alpes;26;2;03;305;Saint-Gervais-sur-Roubion;1083;22;1105
84;Auvergne-Rhône-Alpes;26;2;10;306;Sainte-Jalle;316;5;321
84;Auvergne-Rhône-Alpes;26;1;19;307;Saint-Jean-en-Royans;2809;66;2875
84;Auvergne-Rhône-Alpes;26;1;04;308;Saint-Julien-en-Quint;150;0;150
84;Auvergne-Rhône-Alpes;26;1;19;309;Saint-Julien-en-Vercors;231;5;236
84;Auvergne-Rhône-Alpes;26;3;05;310;Saint-Laurent-d'Onay;157;4;161
84;Auvergne-Rhône-Alpes;26;1;19;311;Saint-Laurent-en-Royans;1419;50;1469
84;Auvergne-Rhône-Alpes;26;2;03;312;Saint-Marcel-lès-Sauzet;1289;46;1335
84;Auvergne-Rhône-Alpes;26;3;15;313;Saint-Marcel-lès-Valence;6289;128;6417
84;Auvergne-Rhône-Alpes;26;3;05;314;Saint-Martin-d'Août;382;16;398
84;Auvergne-Rhône-Alpes;26;1;19;315;Saint-Martin-en-Vercors;352;13;365
84;Auvergne-Rhône-Alpes;26;1;19;316;Saint-Martin-le-Colonel;204;7;211
84;Auvergne-Rhône-Alpes;26;2;10;317;Saint-Maurice-sur-Eygues;792;13;805
84;Auvergne-Rhône-Alpes;26;2;10;318;Saint-May;35;1;36
84;Auvergne-Rhône-Alpes;26;3;05;319;Saint-Michel-sur-Savasse;566;11;577
84;Auvergne-Rhône-Alpes;26;1;19;320;Saint-Nazaire-en-Royans;814;10;824
84;Auvergne-Rhône-Alpes;26;1;04;321;Saint-Nazaire-le-Désert;209;9;218
84;Auvergne-Rhône-Alpes;26;2;06;322;Saint-Pantaléon-les-Vignes;420;22;442
84;Auvergne-Rhône-Alpes;26;3;11;323;Saint-Paul-lès-Romans;1829;48;1877
84;Auvergne-Rhône-Alpes;26;2;14;324;Saint-Paul-Trois-Châteaux;8736;436;9172
84;Auvergne-Rhône-Alpes;26;3;12;325;Saint-Rambert-d'Albon;6758;66;6824
84;Auvergne-Rhône-Alpes;26;2;14;326;Saint-Restitut;1443;47;1490
84;Auvergne-Rhône-Alpes;26;1;04;327;Saint-Roman;215;3;218
84;Auvergne-Rhône-Alpes;26;1;04;328;Saint-Sauveur-en-Diois;54;1;55
84;Auvergne-Rhône-Alpes;26;2;10;329;Saint-Sauveur-Gouvernet;180;6;186
84;Auvergne-Rhône-Alpes;26;3;05;330;Saint-Sorlin-en-Valloire;2254;44;2298
84;Auvergne-Rhône-Alpes;26;1;19;331;Saint-Thomas-en-Royans;608;14;622
84;Auvergne-Rhône-Alpes;26;3;12;332;Saint-Uze;2062;20;2082
84;Auvergne-Rhône-Alpes;26;3;12;333;Saint-Vallier;3960;152;4112
84;Auvergne-Rhône-Alpes;26;2;03;334;Salettes;139;2;141
84;Auvergne-Rhône-Alpes;26;2;06;335;Salles-sous-Bois;195;3;198
84;Auvergne-Rhône-Alpes;26;1;03;336;Saou;567;23;590
84;Auvergne-Rhône-Alpes;26;2;08;337;Saulce-sur-Rhône;1844;30;1874
84;Auvergne-Rhône-Alpes;26;2;03;338;Sauzet;1823;58;1881
84;Auvergne-Rhône-Alpes;26;2;08;339;Savasse;1487;42;1529
84;Auvergne-Rhône-Alpes;26;2;10;340;Séderon;258;4;262
84;Auvergne-Rhône-Alpes;26;3;13;341;Serves-sur-Rhône;726;12;738
84;Auvergne-Rhône-Alpes;26;2;14;342;Solérieux;318;7;325
84;Auvergne-Rhône-Alpes;26;2;03;343;Souspierre;103;2;105
84;Auvergne-Rhône-Alpes;26;1;03;344;Soyans;392;7;399
84;Auvergne-Rhône-Alpes;26;2;14;345;Suze-la-Rousse;2155;55;2210
84;Auvergne-Rhône-Alpes;26;1;02;346;Suze;231;5;236
84;Auvergne-Rhône-Alpes;26;3;13;347;Tain-l'Hermitage;6106;206;6312
84;Auvergne-Rhône-Alpes;26;2;06;348;Taulignan;1650;28;1678
84;Auvergne-Rhône-Alpes;26;3;05;349;Tersanne;368;5;373
84;Auvergne-Rhône-Alpes;26;2;03;350;Teyssières;75;1;76
84;Auvergne-Rhône-Alpes;26;2;03;351;Les Tonils;30;0;30
84;Auvergne-Rhône-Alpes;26;2;03;352;La Touche;258;7;265
84;Auvergne-Rhône-Alpes;26;2;08;353;Les Tourrettes;1032;18;1050
84;Auvergne-Rhône-Alpes;26;3;11;355;Triors;602;8;610
84;Auvergne-Rhône-Alpes;26;2;03;356;Truinas;119;4;123
84;Auvergne-Rhône-Alpes;26;2;06;357;Tulette;2012;40;2052
84;Auvergne-Rhône-Alpes;26;3;02;358;Upie;1519;43;1562
84;Auvergne-Rhône-Alpes;26;1;04;359;Vachères-en-Quint;36;0;36
84;Auvergne-Rhône-Alpes;26;2;06;360;Valaurie;660;26;686
84;Auvergne-Rhône-Alpes;26;1;04;361;Valdrôme;140;3;143
84;Auvergne-Rhône-Alpes;26;3;99;362;Valence;64749;1400;66149
84;Auvergne-Rhône-Alpes;26;2;10;363;Valouse;38;0;38
84;Auvergne-Rhône-Alpes;26;1;19;364;Vassieux-en-Vercors;326;8;334
84;Auvergne-Rhône-Alpes;26;1;02;365;Vaunaveys-la-Rochette;585;11;596
84;Auvergne-Rhône-Alpes;26;2;10;367;Venterol;692;20;712
84;Auvergne-Rhône-Alpes;26;1;04;368;Vercheny;464;6;470
84;Auvergne-Rhône-Alpes;26;2;10;369;Verclause;58;1;59
84;Auvergne-Rhône-Alpes;26;2;10;370;Vercoiran;138;5;143
84;Auvergne-Rhône-Alpes;26;1;04;371;Véronne;47;2;49
84;Auvergne-Rhône-Alpes;26;2;10;372;Vers-sur-Méouge;39;1;40
84;Auvergne-Rhône-Alpes;26;2;03;373;Vesc;245;8;253
84;Auvergne-Rhône-Alpes;26;2;10;374;Villebois-les-Pins;15;0;15
84;Auvergne-Rhône-Alpes;26;2;10;375;Villefranche-le-Château;17;1;18
84;Auvergne-Rhône-Alpes;26;2;10;376;Villeperdrix;107;1;108
84;Auvergne-Rhône-Alpes;26;2;10;377;Vinsobres;1031;24;1055
84;Auvergne-Rhône-Alpes;26;1;04;378;Volvent;33;0;33
84;Auvergne-Rhône-Alpes;26;3;13;379;Granges-les-Beaumont;908;10;918
84;Auvergne-Rhône-Alpes;26;3;13;380;Gervans;550;10;560
84;Auvergne-Rhône-Alpes;26;3;19;381;Jaillans;904;12;916
84;Auvergne-Rhône-Alpes;26;3;19;382;Saint-Vincent-la-Commanderie;568;7;575
28;Normandie;27;2;07;001;Aclou;327;9;336
28;Normandie;27;3;22;002;Acon;464;8;472
28;Normandie;27;1;18;003;Acquigny;1619;33;1652
28;Normandie;27;1;16;004;Aigleville;425;8;433
28;Normandie;27;1;12;005;Ailly;1171;18;1189
28;Normandie;27;2;04;006;Aizier;148;3;151
28;Normandie;27;1;18;008;Alizay;1592;16;1608
28;Normandie;27;2;06;009;Ambenay;566;11;577
28;Normandie;27;1;13;010;Amécourt;170;7;177
28;Normandie;27;2;05;011;Amfreville-Saint-Amand;1196;14;1210
28;Normandie;27;1;19;012;Amfreville-les-Champs;447;16;463
28;Normandie;27;1;21;013;Amfreville-sous-les-Monts;486;11;497
28;Normandie;27;1;18;014;Amfreville-sur-Iton;848;23;871
28;Normandie;27;1;14;015;Andé;1303;31;1334
28;Normandie;27;1;01;016;Les Andelys;8070;140;8210
28;Normandie;27;3;11;017;Angerville-la-Campagne;1363;37;1400
28;Normandie;27;2;17;018;Appeville-Annebault;992;11;1003
28;Normandie;27;2;22;019;Armentières-sur-Avre;163;7;170
28;Normandie;27;3;09;020;Arnières-sur-Iton;1676;43;1719
28;Normandie;27;2;03;021;Asnières;340;9;349
28;Normandie;27;1;12;022;Le Val d'Hazey;5350;109;5459
28;Normandie;27;3;08;023;Aulnay-sur-Iton;708;20;728
28;Normandie;27;1;12;025;Autheuil-Authouillet;956;19;975
28;Normandie;27;1;13;026;Authevernes;432;9;441
28;Normandie;27;3;20;027;Les Authieux;286;7;293
28;Normandie;27;2;17;028;Authou;336;4;340
28;Normandie;27;3;10;031;Aviron;1101;39;1140
28;Normandie;27;2;22;032;Chambois;1390;31;1421
28;Normandie;27;2;15;033;Bacquepuis;306;7;313
28;Normandie;27;1;19;034;Bacqueville;632;9;641
28;Normandie;27;2;03;035;Bailleul-la-Vallée;102;1;103
28;Normandie;27;2;22;036;Bâlines;550;21;571
28;Normandie;27;2;07;037;Barc;1178;22;1200
28;Normandie;27;2;22;038;Les Barils;279;6;285
28;Normandie;27;2;04;039;Barneville-sur-Seine;517;36;553
28;Normandie;27;2;07;040;Barquet;448;5;453
28;Normandie;27;2;03;042;Barville;78;0;78
28;Normandie;27;2;06;043;Les Baux-de-Breteuil;676;21;697
28;Normandie;27;3;11;044;Les Baux-Sainte-Croix;820;37;857
28;Normandie;27;1;13;045;Bazincourt-sur-Epte;772;12;784
28;Normandie;27;2;03;046;Bazoques;149;1;150
28;Normandie;27;3;08;047;Beaubray;330;8;338
28;Normandie;27;1;19;048;Beauficel-en-Lyons;187;3;190
28;Normandie;27;2;02;049;Mesnil-en-Ouche;4554;118;4672
28;Normandie;27;2;07;050;Beaumontel;641;15;656
28;Normandie;27;2;07;051;Beaumont-le-Roger;2794;38;2832
28;Normandie;27;2;07;052;Le Bec-Hellouin;396;3;399
28;Normandie;27;2;05;053;Le Bec-Thomas;219;5;224
28;Normandie;27;2;06;054;Bémécourt;582;8;590
28;Normandie;27;2;15;055;Bérengeville-la-Campagne;331;6;337
28;Normandie;27;2;02;056;Bernay;9848;311;10159
28;Normandie;27;2;15;057;Bernienville;285;6;291
28;Normandie;27;1;12;058;Les Trois Lacs;1769;43;1812
28;Normandie;27;1;13;059;Bernouville;306;3;309
28;Normandie;27;2;07;061;Berthouville;327;5;332
28;Normandie;27;2;05;062;Les Monts du Roumois;1567;47;1614
28;Normandie;27;2;07;063;Berville-la-Campagne;255;1;256
28;Normandie;27;2;03;064;Berville-sur-Mer;676;9;685
28;Normandie;27;2;03;065;Beuzeville;4666;58;4724
28;Normandie;27;1;19;066;Bézu-la-Forêt;328;6;334
28;Normandie;27;1;13;067;Bézu-Saint-Éloi;1549;28;1577
28;Normandie;27;2;06;068;Bois-Anzeray;174;2;176
28;Normandie;27;2;06;069;Bois-Arnault;695;16;711
28;Normandie;27;1;01;070;Frenelles-en-Vexin;1726;35;1761
28;Normandie;27;2;03;071;Le Bois-Hellain;215;2;217
28;Normandie;27;1;01;072;Bois-Jérôme-Saint-Ouen;748;22;770
28;Normandie;27;3;20;073;Bois-le-Roi;1214;18;1232
28;Normandie;27;2;07;074;Boisney;277;8;285
28;Normandie;27;2;06;075;Bois-Normand-près-Lyre;340;4;344
28;Normandie;27;1;16;076;Boisset-les-Prévanches;493;9;502
28;Normandie;27;2;05;077;Boissey-le-Châtel;856;10;866
28;Normandie;27;1;16;078;La Boissière;266;11;277
28;Normandie;27;2;03;079;Boissy-Lamberville;362;5;367
28;Normandie;27;3;11;081;Boncourt;183;7;190
28;Normandie;27;3;08;082;La Bonneville-sur-Iton;2075;49;2124
28;Normandie;27;2;17;083;Bonneville-Aptot;261;4;265
28;Normandie;27;2;05;085;Flancourt-Crescy-en-Roumois;1517;22;1539
28;Normandie;27;2;05;089;Thénouville;1009;17;1026
28;Normandie;27;2;05;090;Bosroumois;3649;65;3714
28;Normandie;27;2;04;091;Bosgouet;737;5;742
28;Normandie;27;1;19;094;Bosquentin;126;1;127
28;Normandie;27;2;07;095;Bosrobert;665;11;676
28;Normandie;27;2;06;096;Les Bottereaux;346;11;357
28;Normandie;27;1;01;097;Bouafles;661;12;673
28;Normandie;27;1;19;098;Bouchevilliers;83;3;86
28;Normandie;27;3;10;099;Le Boulay-Morin;798;10;808
28;Normandie;27;2;03;100;Boulleville;1185;24;1209
28;Normandie;27;2;04;101;Bouquelon;523;10;533
28;Normandie;27;2;04;102;Bouquetot;1033;22;1055
28;Normandie;27;2;04;103;Bourg-Achard;3942;73;4015
28;Normandie;27;1;19;104;Bourg-Beaudouin;702;10;712
28;Normandie;27;2;05;105;Grand Bourgtheroulde;3957;79;4036
28;Normandie;27;2;03;106;Bournainville-Faverolles;478;5;483
28;Normandie;27;2;04;107;Bourneville-Sainte-Croix;1324;25;1349
28;Normandie;27;2;22;108;Bourth;1204;33;1237
28;Normandie;27;2;07;109;Bray;398;7;405
28;Normandie;27;2;17;110;Brestot;627;8;635
28;Normandie;27;3;20;111;Bretagnolles;202;5;207
28;Normandie;27;2;06;112;Breteuil;4331;125;4456
28;Normandie;27;2;07;113;Brétigny;139;2;141
28;Normandie;27;1;16;114;Breuilpont;1216;23;1239
28;Normandie;27;2;22;115;Breux-sur-Avre;338;7;345
28;Normandie;27;2;07;116;Brionne;4199;152;4351
28;Normandie;27;2;06;117;Broglie;1024;20;1044
28;Normandie;27;2;15;118;Brosville;646;10;656
28;Normandie;27;1;16;119;Bueil;1615;29;1644
28;Normandie;27;3;08;120;Burey;404;5;409
28;Normandie;27;1;16;123;Caillouet-Orgeville;491;12;503
28;Normandie;27;1;12;124;Cailly-sur-Eure;214;1;215
28;Normandie;27;2;07;125;Calleville;660;10;670
28;Normandie;27;2;17;126;Campigny;1134;22;1156
28;Normandie;27;2;15;127;Canappeville;699;22;721
28;Normandie;27;2;02;129;Caorches-Saint-Nicolas;594;15;609
28;Normandie;27;2;06;130;Capelle-les-Grands;419;11;430
28;Normandie;27;3;08;132;Caugé;860;24;884
28;Normandie;27;2;04;133;Caumont;1062;10;1072
28;Normandie;27;2;04;134;Cauverville-en-Roumois;215;0;215
28;Normandie;27;2;15;135;Cesseville;459;11;470
28;Normandie;27;1;16;136;Chaignes;276;4;280
28;Normandie;27;2;06;137;Chaise-Dieu-du-Theil;201;5;206
28;Normandie;27;2;06;138;Chamblac;396;10;406
28;Normandie;27;2;06;139;Chambord;172;6;178
28;Normandie;27;1;16;140;Chambray;412;11;423
28;Normandie;27;3;08;141;Champ-Dolent;63;0;63
28;Normandie;27;1;12;142;Champenard;281;7;288
28;Normandie;27;3;20;144;Champigny-la-Futelaye;278;5;283
28;Normandie;27;2;03;146;La Chapelle-Bayvel;375;5;380
28;Normandie;27;3;10;147;La Chapelle-du-Bois-des-Faulx;688;11;699
28;Normandie;27;2;06;148;La Chapelle-Gauthier;408;10;418
28;Normandie;27;2;03;149;La Chapelle-Hareng;113;3;116
28;Normandie;27;1;19;151;Charleval;1734;22;1756
28;Normandie;27;1;01;152;Château-sur-Epte;556;9;565
28;Normandie;27;1;13;153;Chauvincourt-Provemont;367;6;373
28;Normandie;27;3;20;154;Chavigny-Bailleul;598;16;614
28;Normandie;27;2;22;155;Chennebrun;107;2;109
28;Normandie;27;2;06;156;Chéronvilliers;472;17;489
28;Normandie;27;2;06;157;Marbois;1326;20;1346
28;Normandie;27;3;11;158;Cierrey;768;28;796
28;Normandie;27;3;08;161;Claville;1083;21;1104
28;Normandie;27;3;08;162;Collandres-Quincarnon;243;5;248
28;Normandie;27;2;17;163;Colletot;207;1;208
28;Normandie;27;2;07;164;Combon;819;8;827
28;Normandie;27;3;08;165;Conches-en-Ouche;4995;65;5060
28;Normandie;27;2;17;167;Condé-sur-Risle;657;6;663
28;Normandie;27;1;21;168;Connelles;180;7;187
28;Normandie;27;2;03;169;Conteville;1010;12;1022
28;Normandie;27;2;03;170;Cormeilles;1193;21;1214
28;Normandie;27;1;16;171;Le Cormier;385;10;395
28;Normandie;27;2;02;173;Corneville-la-Fouquetière;122;3;125
28;Normandie;27;2;17;174;Corneville-sur-Risle;1370;26;1396
28;Normandie;27;1;13;176;Coudray;218;5;223
28;Normandie;27;3;20;177;Coudres;549;13;562
28;Normandie;27;2;02;179;Courbépine;716;16;732
28;Normandie;27;1;12;180;Courcelles-sur-Seine;2098;38;2136
28;Normandie;27;3;22;181;Courdemanche;603;12;615
28;Normandie;27;2;22;182;Courteilles;157;3;160
28;Normandie;27;3;20;183;La Couture-Boussey;2308;43;2351
28;Normandie;27;1;18;184;Crasville;124;3;127
28;Normandie;27;2;15;185;Crestot;594;6;600
28;Normandie;27;2;15;187;Criquebeuf-la-Campagne;330;6;336
28;Normandie;27;1;18;188;Criquebeuf-sur-Seine;1489;14;1503
28;Normandie;27;3;08;189;La Croisille;432;7;439
28;Normandie;27;1;16;190;Croisy-sur-Eure;207;4;211
28;Normandie;27;1;12;191;Clef Vallée d'Eure;2500;64;2564
28;Normandie;27;2;15;192;Crosville-la-Vieille;608;11;619
28;Normandie;27;3;20;193;Croth;1377;16;1393
28;Normandie;27;1;01;194;Cuverville;250;2;252
28;Normandie;27;1;18;196;Les Damps;1371;8;1379
28;Normandie;27;2;88;198;Mesnils-sur-Iton;6126;254;6380
28;Normandie;27;1;13;199;Dangu;571;12;583
28;Normandie;27;3;10;200;Dardez;149;7;156
28;Normandie;27;2;15;201;Daubeuf-la-Campagne;235;6;241
28;Normandie;27;1;01;202;Daubeuf-près-Vatteville;464;8;472
28;Normandie;27;1;16;203;Douains;478;17;495
28;Normandie;27;1;13;204;Doudeauville-en-Vexin;284;7;291
28;Normandie;27;1;19;205;Douville-sur-Andelle;452;4;456
28;Normandie;27;3;22;206;Droisy;451;3;454
28;Normandie;27;2;03;207;Drucourt;591;7;598
28;Normandie;27;2;03;208;Duranville;151;2;153
28;Normandie;27;2;17;209;Écaquelon;601;11;612
28;Normandie;27;2;07;210;Écardenville-la-Campagne;474;12;486
28;Normandie;27;2;15;212;Écauville;109;2;111
28;Normandie;27;1;01;213;Vexin-sur-Epte;5952;136;6088
28;Normandie;27;1;01;214;Écouis;816;14;830
28;Normandie;27;2;15;215;Ecquetot;391;10;401
28;Normandie;27;3;10;216;Émalleville;493;25;518
28;Normandie;27;2;15;217;Émanville;556;9;565
28;Normandie;27;2;03;218;Épaignes;1580;23;1603
28;Normandie;27;2;15;219;Épégard;549;7;556
28;Normandie;27;3;20;220;Épieds;349;8;357
28;Normandie;27;2;03;222;Épreville-en-Lieuvin;198;4;202
28;Normandie;27;2;15;224;Épreville-près-le-Neubourg;460;10;470
28;Normandie;27;1;13;226;Étrépagny;3730;82;3812
28;Normandie;27;2;04;227;Étréville;665;11;676
28;Normandie;27;2;04;228;Éturqueraye;300;3;303
28;Normandie;27;3;99;229;Évreux;46349;1225;47574
28;Normandie;27;3;20;230;Ézy-sur-Eure;3702;55;3757
28;Normandie;27;1;16;231;Fains;447;7;454
28;Normandie;27;1;13;232;Farceaux;344;7;351
28;Normandie;27;2;03;233;Fatouville-Grestain;727;11;738
28;Normandie;27;3;11;234;Fauville;348;6;354
28;Normandie;27;3;08;235;Faverolles-la-Campagne;171;3;174
28;Normandie;27;2;03;237;Le Favril;166;2;168
28;Normandie;27;3;08;238;Ferrières-Haut-Clocher;1162;29;1191
28;Normandie;27;2;06;239;Ferrières-Saint-Hilaire;419;7;426
28;Normandie;27;3;08;240;La Ferrière-sur-Risle;221;4;225
28;Normandie;27;2;15;241;Feuguerolles;175;5;180
28;Normandie;27;3;08;242;Le Fidelaire;1017;14;1031
28;Normandie;27;2;03;243;Fiquefleur-Équainville;739;10;749
28;Normandie;27;1;19;245;Fleury-la-Forêt;259;8;267
28;Normandie;27;1;19;246;Fleury-sur-Andelle;1834;19;1853
28;Normandie;27;1;19;247;Flipou;324;3;327
28;Normandie;27;2;03;248;Folleville;197;3;200
28;Normandie;27;1;12;249;Fontaine-Bellenger;1155;21;1176
28;Normandie;27;2;02;251;Fontaine-l'Abbé;549;8;557
28;Normandie;27;2;03;252;Fontaine-la-Louvet;328;7;335
28;Normandie;27;1;16;254;Fontaine-sous-Jouy;846;23;869
28;Normandie;27;3;20;256;La Forêt-du-Parc;624;9;633
28;Normandie;27;2;03;258;Fort-Moville;522;7;529
28;Normandie;27;3;20;259;Foucrainville;90;4;94
28;Normandie;27;2;03;260;Foulbec;663;8;671
28;Normandie;27;2;05;261;Fouqueville;448;12;460
28;Normandie;27;2;17;263;Le Perrey;1244;13;1257
28;Normandie;27;2;07;266;Franqueville;317;2;319
28;Normandie;27;2;17;267;Freneuse-sur-Risle;350;4;354
28;Normandie;27;2;03;269;Fresne-Cauverville;194;3;197
28;Normandie;27;3;20;271;Fresney;329;13;342
28;Normandie;27;1;16;273;Gadencourt;381;7;388
28;Normandie;27;1;12;275;Gaillon;6860;98;6958
28;Normandie;27;1;13;276;Gamaches-en-Vexin;285;8;293
28;Normandie;27;3;20;277;La Baronnie;737;15;752
28;Normandie;27;3;20;278;Garennes-sur-Eure;1945;38;1983
28;Normandie;27;1;23;279;Gasny;3058;52;3110
28;Normandie;27;3;11;280;Gauciel;837;7;844
28;Normandie;27;3;08;281;Gaudreville-la-Rivière;226;8;234
28;Normandie;27;3;08;282;Gauville-la-Campagne;606;13;619
28;Normandie;27;1;13;284;Gisors;11696;166;11862
28;Normandie;27;1;23;285;Giverny;494;13;507
28;Normandie;27;2;03;286;Giverville;409;5;414
28;Normandie;27;3;08;287;Glisolles;865;17;882
28;Normandie;27;2;17;288;Glos-sur-Risle;599;14;613
28;Normandie;27;2;06;289;La Goulafrière;168;3;171
28;Normandie;27;2;07;290;Goupil-Othon;1256;16;1272
28;Normandie;27;2;22;291;Gournay-le-Guérin;126;11;137
28;Normandie;27;1;19;294;Val d'Orger;991;16;1007
28;Normandie;27;2;06;295;Grand-Camp;478;15;493
28;Normandie;27;2;15;298;Graveron-Sémerville;315;6;321
28;Normandie;27;3;10;299;Gravigny;3994;81;4075
28;Normandie;27;2;07;300;Grosley-sur-Risle;527;4;531
28;Normandie;27;3;20;301;Grossœuvre;1334;28;1362
28;Normandie;27;2;15;302;Le Bosc du Theil;1305;13;1318
28;Normandie;27;1;13;304;Guerny;166;4;170
28;Normandie;27;3;11;306;Guichainville;2954;60;3014
28;Normandie;27;1;01;307;Guiseniers;466;7;473
28;Normandie;27;3;20;309;L'Habit;504;7;511
28;Normandie;27;1;13;310;Hacqueville;426;8;434
28;Normandie;27;2;07;311;Harcourt;1086;5;1091
28;Normandie;27;1;16;312;Hardencourt-Cocherel;273;13;286
28;Normandie;27;2;05;313;La Harengère;609;5;614
28;Normandie;27;1;01;315;Harquency;269;8;277
28;Normandie;27;2;04;316;Hauville;1278;27;1305
28;Normandie;27;2;04;317;La Haye-Aubrée;458;10;468
28;Normandie;27;2;07;318;La Haye-de-Calleville;259;3;262
28;Normandie;27;2;04;319;La Haye-de-Routot;307;5;312
28;Normandie;27;2;05;320;La Haye-du-Theil;304;0;304
28;Normandie;27;1;18;321;La Haye-le-Comte;134;5;139
28;Normandie;27;1;18;322;La Haye-Malherbe;1392;19;1411
28;Normandie;27;2;06;323;La Haye-Saint-Sylvestre;281;3;284
28;Normandie;27;1;13;324;Hébécourt;617;14;631
28;Normandie;27;2;07;325;Hecmanville;187;3;190
28;Normandie;27;1;16;326;Hécourt;318;13;331
28;Normandie;27;2;15;327;Hectomare;212;8;220
28;Normandie;27;1;01;329;Hennezis;771;22;793
28;Normandie;27;1;21;330;Herqueville;133;4;137
28;Normandie;27;1;01;331;Heubécourt-Haricourt;456;10;466
28;Normandie;27;1;14;332;Heudebouville;782;12;794
28;Normandie;27;1;13;333;Heudicourt;718;7;725
28;Normandie;27;2;03;334;Heudreville-en-Lieuvin;109;1;110
28;Normandie;27;1;12;335;Heudreville-sur-Eure;1077;32;1109
28;Normandie;27;1;16;336;La Heunière;431;4;435
28;Normandie;27;1;01;337;Heuqueville;356;6;362
28;Normandie;27;1;19;338;Les Hogues;674;8;682
28;Normandie;27;2;15;339;Hondouville;790;15;805
28;Normandie;27;2;04;340;Honguemare-Guenouville;710;8;718
28;Normandie;27;2;22;341;L'Hosmes;67;3;70
28;Normandie;27;2;15;342;Houetteville;202;6;208
28;Normandie;27;1;16;343;Houlbec-Cocherel;1280;55;1335
28;Normandie;27;2;07;345;La Houssaye;209;2;211
28;Normandie;27;1;19;346;Houville-en-Vexin;234;4;238
28;Normandie;27;3;11;347;Huest;785;26;811
28;Normandie;27;1;18;348;Igoville;1756;20;1776
28;Normandie;27;2;17;349;Illeville-sur-Montfort;867;13;880
28;Normandie;27;3;22;350;Illiers-l'Évêque;999;17;1016
28;Normandie;27;1;14;351;Incarville;1423;24;1447
28;Normandie;27;3;10;353;Irreville;470;8;478
28;Normandie;27;2;15;354;Iville;426;4;430
28;Normandie;27;3;20;355;Ivry-la-Bataille;2665;30;2695
28;Normandie;27;1;16;358;Jouy-sur-Eure;591;13;604
28;Normandie;27;2;06;359;Juignettes;226;1;227
28;Normandie;27;3;20;360;Jumelles;329;7;336
28;Normandie;27;2;03;361;La Lande-Saint-Léger;386;5;391
28;Normandie;27;2;04;363;Le Landin;221;7;228
28;Normandie;27;2;07;364;Launay;195;3;198
28;Normandie;27;1;21;365;Léry;2028;38;2066
28;Normandie;27;1;19;366;Letteguives;207;3;210
28;Normandie;27;2;03;367;Lieurey;1487;15;1502
28;Normandie;27;3;20;368;Lignerolles;335;9;344
28;Normandie;27;1;19;369;Lilly;79;2;81
28;Normandie;27;1;19;370;Lisors;329;9;338
28;Normandie;27;2;07;371;Livet-sur-Authou;159;1;160
28;Normandie;27;1;13;372;Longchamps;682;5;687
28;Normandie;27;1;19;373;Lorleau;118;2;120
28;Normandie;27;3;08;374;Louversey;530;14;544
28;Normandie;27;1;14;375;Louviers;18518;403;18921
28;Normandie;27;3;20;376;Louye;223;5;228
28;Normandie;27;1;19;377;Lyons-la-Forêt;712;6;718
28;Normandie;27;3;22;378;La Madeleine-de-Nonancourt;1143;24;1167
28;Normandie;27;1;19;379;Mainneville;444;8;452
28;Normandie;27;2;07;380;Malleville-sur-le-Bec;265;4;269
28;Normandie;27;2;02;381;Malouy;162;0;162
28;Normandie;27;2;15;382;Mandeville;319;9;328
28;Normandie;27;2;22;383;Mandres;376;11;387
28;Normandie;27;2;03;384;Manneville-la-Raoult;498;11;509
28;Normandie;27;2;17;385;Manneville-sur-Risle;1497;41;1538
28;Normandie;27;1;18;386;Le Manoir;1329;7;1336
28;Normandie;27;2;04;388;Marais-Vernier;487;9;496
28;Normandie;27;2;15;389;Marbeuf;462;17;479
28;Normandie;27;3;22;390;Marcilly-la-Campagne;1121;16;1137
28;Normandie;27;3;20;391;Marcilly-sur-Eure;1599;21;1620
28;Normandie;27;1;19;392;Martagny;150;4;154
28;Normandie;27;2;03;393;Martainville;503;2;505
28;Normandie;27;1;18;394;Martot;492;11;503
28;Normandie;27;2;06;395;Mélicourt;88;1;89
28;Normandie;27;1;19;396;Ménesqueville;467;9;476
28;Normandie;27;1;16;397;Ménilles;1737;42;1779
28;Normandie;27;2;02;398;Menneval;1476;105;1581
28;Normandie;27;1;16;399;Mercey;52;1;53
28;Normandie;27;1;16;400;Merey;342;4;346
28;Normandie;27;3;15;401;Le Mesnil-Fuguet;177;3;180
28;Normandie;27;1;18;403;Le Mesnil-Jourdain;236;12;248
28;Normandie;27;2;06;404;Mesnil-Rousset;91;1;92
28;Normandie;27;1;19;405;Mesnil-sous-Vienne;102;5;107
28;Normandie;27;3;20;406;Mesnil-sur-l'Estrée;889;24;913
28;Normandie;27;1;01;407;Mesnil-Verclives;325;9;334
28;Normandie;27;1;01;408;Mézières-en-Vexin;603;19;622
28;Normandie;27;3;11;410;Miserey;643;7;650
28;Normandie;27;3;22;411;Moisville;232;2;234
28;Normandie;27;1;18;412;Terres de Bord;1491;35;1526
28;Normandie;27;2;17;413;Montfort-sur-Risle;777;12;789
28;Normandie;27;2;06;414;Montreuil-l'Argillé;843;10;853
28;Normandie;27;2;03;415;Morainville-Jouveaux;369;7;376
28;Normandie;27;1;13;417;Morgny;669;12;681
28;Normandie;27;2;07;418;Morsan;105;0;105
28;Normandie;27;3;20;419;Mouettes;760;17;777
28;Normandie;27;1;13;420;Mouflaines;164;7;171
28;Normandie;27;3;20;421;Mousseaux-Neuville;640;13;653
28;Normandie;27;1;01;422;Muids;876;22;898
28;Normandie;27;3;20;423;Muzy;772;18;790
28;Normandie;27;3;08;424;Nagel-Séez-Mesnil;326;8;334
28;Normandie;27;2;07;425;Nassandres sur Risle;2406;46;2452
28;Normandie;27;1;13;426;Neaufles-Saint-Martin;1318;7;1325
28;Normandie;27;2;06;427;Neaufles-Auvergny;420;8;428
28;Normandie;27;2;15;428;Le Neubourg;4241;221;4462
28;Normandie;27;1;16;429;Neuilly;183;0;183
28;Normandie;27;1;13;430;La Neuve-Grange;343;3;346
28;Normandie;27;2;06;431;La Neuve-Lyre;578;6;584
28;Normandie;27;2;07;432;La Neuville-du-Bosc;697;7;704
28;Normandie;27;2;07;433;Neuville-sur-Authou;191;2;193
28;Normandie;27;2;03;434;Noards;55;0;55
28;Normandie;27;2;03;435;La Noë-Poulain;285;3;288
28;Normandie;27;3;08;436;Nogent-le-Sec;440;6;446
28;Normandie;27;1;13;437;Nojeon-en-Vexin;340;6;346
28;Normandie;27;3;22;438;Nonancourt;2275;40;2315
28;Normandie;27;3;10;439;Normanville;1133;37;1170
28;Normandie;27;1;01;440;Notre-Dame-de-l'Isle;659;22;681
28;Normandie;27;2;07;441;Notre-Dame-d'Épine;74;1;75
28;Normandie;27;2;06;442;Notre-Dame-du-Hamel;198;7;205
28;Normandie;27;2;02;444;Le Noyer-en-Ouche;230;2;232
28;Normandie;27;1;13;445;Noyers;253;4;257
28;Normandie;27;3;08;446;Ormes;479;3;482
28;Normandie;27;3;08;447;Le Val-Doré;898;56;954
28;Normandie;27;1;16;448;Pacy-sur-Eure;5056;127;5183
28;Normandie;27;3;08;451;Parville;292;6;298
28;Normandie;27;1;19;453;Perriers-sur-Andelle;1802;20;1822
28;Normandie;27;1;19;454;Perruel;465;7;472
28;Normandie;27;2;03;455;Piencourt;165;3;168
28;Normandie;27;1;18;456;Pinterville;760;18;778
28;Normandie;27;2;22;457;Piseux;696;12;708
28;Normandie;27;1;18;458;Pîtres;2648;27;2675
28;Normandie;27;2;03;459;Les Places;73;2;75
28;Normandie;27;2;02;460;Plainville;205;5;210
28;Normandie;27;2;03;462;Le Planquay;161;1;162
28;Normandie;27;2;02;463;Plasnes;721;8;729
28;Normandie;27;3;11;464;Le Plessis-Grohan;911;19;930
28;Normandie;27;1;16;465;Le Plessis-Hébert;402;13;415
28;Normandie;27;2;07;466;Le Plessis-Sainte-Opportune;336;5;341
28;Normandie;27;2;17;467;Pont-Audemer;9982;272;10254
28;Normandie;27;2;17;468;Pont-Authou;602;8;610
28;Normandie;27;1;18;469;Pont-de-l'Arche;4146;58;4204
28;Normandie;27;1;19;470;Pont-Saint-Pierre;1134;22;1156
28;Normandie;27;1;21;471;Porte-de-Seine;205;7;212
28;Normandie;27;3;08;472;Portes;276;3;279
28;Normandie;27;1;01;473;Port-Mort;909;26;935
28;Normandie;27;1;21;474;Poses;1158;22;1180
28;Normandie;27;2;03;475;La Poterie-Mathieu;164;1;165
28;Normandie;27;2;17;476;Les Préaux;388;8;396
28;Normandie;27;1;01;477;Pressagny-l'Orgueilleux;697;26;723
28;Normandie;27;3;20;478;Prey;949;25;974
28;Normandie;27;1;13;480;Puchay;652;7;659
28;Normandie;27;2;22;481;Pullay;403;54;457
28;Normandie;27;2;15;482;La Pyle;169;4;173
28;Normandie;27;1;18;483;Quatremare;435;6;441
28;Normandie;27;2;04;485;Quillebeuf-sur-Seine;833;8;841
28;Normandie;27;2;15;486;Quittebeuf;654;18;672
28;Normandie;27;1;19;487;Radepont;662;2;664
28;Normandie;27;1;19;488;Renneville;194;4;198
28;Normandie;27;3;10;489;Reuilly;521;13;534
28;Normandie;27;1;13;490;Richeville;267;4;271
28;Normandie;27;2;07;492;Romilly-la-Puthenaye;317;10;327
28;Normandie;27;1;19;493;Romilly-sur-Andelle;3288;52;3340
28;Normandie;27;1;01;495;La Roquette;237;2;239
28;Normandie;27;1;19;496;Rosay-sur-Lieure;516;6;522
28;Normandie;27;2;04;497;Rougemontiers;1045;17;1062
28;Normandie;27;2;07;498;Rouge-Perriers;367;4;371
28;Normandie;27;2;04;500;Routot;1679;56;1735
28;Normandie;27;1;16;501;Rouvray;259;6;265
28;Normandie;27;2;06;502;Rugles;2214;28;2242
28;Normandie;27;3;15;504;Sacquenville;1288;38;1326
28;Normandie;27;2;06;505;Saint-Agnan-de-Cernières;165;1;166
28;Normandie;27;3;20;507;Saint-André-de-l'Eure;4031;66;4097
28;Normandie;27;2;06;508;Saint-Antonin-de-Sommaire;198;2;200
28;Normandie;27;2;15;511;Saint-Aubin-d'Écrosville;721;11;732
28;Normandie;27;2;03;512;Saint-Aubin-de-Scellon;336;7;343
28;Normandie;27;2;06;514;Saint-Aubin-du-Thenney;380;2;382
28;Normandie;27;2;02;516;Treis-Sants-en-Ouche;1412;34;1446
28;Normandie;27;1;12;517;Saint-Aubin-sur-Gaillon;2093;47;2140
28;Normandie;27;2;04;518;Saint-Aubin-sur-Quillebeuf;749;13;762
28;Normandie;27;2;03;520;Saint-Benoît-des-Ombres;142;1;143
28;Normandie;27;2;22;521;Saint-Christophe-sur-Avre;138;6;144
28;Normandie;27;2;03;522;Saint-Christophe-sur-Condé;436;4;440
28;Normandie;27;2;15;524;Sainte-Colombe-la-Commanderie;868;6;874
28;Normandie;27;1;16;525;Sainte-Colombe-près-Vernon;298;18;316
28;Normandie;27;2;07;527;Saint-Cyr-de-Salerne;205;7;212
28;Normandie;27;1;21;528;Le Vaudreuil;3681;82;3763
28;Normandie;27;2;05;529;Saint-Cyr-la-Campagne;435;9;444
28;Normandie;27;2;06;530;Saint-Denis-d'Augerons;82;3;85
28;Normandie;27;2;05;531;Saint-Denis-des-Monts;206;4;210
28;Normandie;27;1;13;533;Saint-Denis-le-Ferment;494;20;514
28;Normandie;27;2;05;534;Saint-Didier-des-Bois;886;10;896
28;Normandie;27;3;08;535;Saint-Élier;438;9;447
28;Normandie;27;2;07;536;Saint-Éloi-de-Fourques;538;15;553
28;Normandie;27;1;14;537;Saint-Étienne-du-Vauvray;876;14;890
28;Normandie;27;2;03;538;Saint-Étienne-l'Allier;547;9;556
28;Normandie;27;1;12;539;Saint-Étienne-sous-Bailleul;385;13;398
28;Normandie;27;1;23;540;Sainte-Geneviève-lès-Gasny;670;15;685
28;Normandie;27;2;03;541;Le Mesnil-Saint-Jean;220;6;226
28;Normandie;27;2;03;542;Saint-Georges-du-Vièvre;887;15;902
28;Normandie;27;3;20;543;Saint-Georges-Motel;887;11;898
28;Normandie;27;3;20;544;Saint-Germain-de-Fresney;204;5;209
28;Normandie;27;2;05;545;Saint-Germain-de-Pasquier;123;5;128
28;Normandie;27;3;10;546;Saint-Germain-des-Angles;168;2;170
28;Normandie;27;2;03;547;Saint-Germain-la-Campagne;871;21;892
28;Normandie;27;3;22;548;Saint-Germain-sur-Avre;1174;25;1199
28;Normandie;27;2;03;550;Saint-Grégoire-du-Vièvre;307;7;314
28;Normandie;27;2;06;552;Saint-Jean-du-Thenney;249;5;254
28;Normandie;27;1;12;553;Saint-Julien-de-la-Liègue;422;2;424
28;Normandie;27;1;16;554;La Chapelle-Longueville;3338;105;3443
28;Normandie;27;3;20;555;Saint-Laurent-des-Bois;246;5;251
28;Normandie;27;2;06;556;Saint-Laurent-du-Tencement;65;0;65
28;Normandie;27;2;02;557;Saint-Léger-de-Rôtes;464;6;470
28;Normandie;27;2;05;558;Saint-Léger-du-Gennetey;179;6;185
28;Normandie;27;3;11;560;Saint-Luc;251;12;263
28;Normandie;27;2;03;561;Saint-Maclou;652;11;663
28;Normandie;27;1;16;562;Saint-Marcel;4425;136;4561
28;Normandie;27;2;17;563;Saint-Mards-de-Blacarville;825;23;848
28;Normandie;27;2;03;564;Saint-Mards-de-Fresne;333;6;339
28;Normandie;27;2;06;565;Le Lesme;681;9;690
28;Normandie;27;1;13;567;Sainte-Marie-de-Vatimesnil;280;6;286
28;Normandie;27;3;08;568;Sainte-Marthe;495;8;503
28;Normandie;27;2;02;569;Saint-Martin-du-Tilleul;245;10;255
28;Normandie;27;3;15;570;Saint-Martin-la-Campagne;100;2;102
28;Normandie;27;2;03;571;Saint-Martin-Saint-Firmin;336;10;346
28;Normandie;27;2;15;572;Saint-Meslin-du-Bosc;289;4;293
28;Normandie;27;2;07;576;Sainte-Opportune-du-Bosc;650;15;665
28;Normandie;27;2;04;577;Sainte-Opportune-la-Mare;435;11;446
28;Normandie;27;2;06;578;Sainte-Marie-d'Attez;596;16;612
28;Normandie;27;2;05;579;Saint-Ouen-de-Pontcheuil;99;2;101
28;Normandie;27;2;04;580;Saint-Ouen-de-Thouberville;2426;31;2457
28;Normandie;27;2;05;582;Saint-Ouen-du-Tilleul;1696;16;1712
28;Normandie;27;2;07;584;Saint-Paul-de-Fourques;282;9;291
28;Normandie;27;2;05;586;Saint-Philbert-sur-Boissey;173;1;174
28;Normandie;27;2;17;587;Saint-Philbert-sur-Risle;789;6;795
28;Normandie;27;1;12;589;Saint-Pierre-de-Bailleul;968;32;1000
28;Normandie;27;2;06;590;Saint-Pierre-de-Cernières;236;3;239
28;Normandie;27;2;03;591;Saint-Pierre-de-Cormeilles;595;12;607
28;Normandie;27;2;07;592;Saint-Pierre-de-Salerne;246;3;249
28;Normandie;27;2;05;593;Saint-Pierre-des-Fleurs;1614;22;1636
28;Normandie;27;2;03;594;Saint-Pierre-des-Ifs;276;1;277
28;Normandie;27;2;05;595;Saint-Pierre-du-Bosguérard;1012;13;1025
28;Normandie;27;2;03;597;Saint-Pierre-du-Val;585;1;586
28;Normandie;27;1;14;598;Saint-Pierre-du-Vauvray;1249;26;1275
28;Normandie;27;1;12;599;Saint-Pierre-la-Garenne;911;10;921
28;Normandie;27;2;04;601;Saint-Samson-de-la-Roque;433;10;443
28;Normandie;27;3;09;602;Saint-Sébastien-de-Morsent;5594;169;5763
28;Normandie;27;2;03;603;Saint-Siméon;313;6;319
28;Normandie;27;2;03;604;Saint-Sulpice-de-Grimbouville;157;2;159
28;Normandie;27;2;03;605;Saint-Sylvestre-de-Cormeilles;237;5;242
28;Normandie;27;2;17;606;Saint-Symphorien;488;1;489
28;Normandie;27;2;02;608;Saint-Victor-de-Chrétienville;446;9;455
28;Normandie;27;2;07;609;Saint-Victor-d'Épine;333;6;339
28;Normandie;27;2;22;610;Saint-Victor-sur-Avre;56;1;57
28;Normandie;27;3;10;611;Saint-Vigor;321;10;331
28;Normandie;27;1;16;612;Saint-Vincent-des-Bois;333;6;339
28;Normandie;27;2;03;613;Saint-Vincent-du-Boulay;379;4;383
28;Normandie;27;1;13;614;Sancourt;167;2;169
28;Normandie;27;3;11;615;Sassey;192;3;195
28;Normandie;27;2;05;616;La Saussaye;1890;52;1942
28;Normandie;27;1;13;617;Saussay-la-Campagne;530;9;539
28;Normandie;27;3;08;618;Sébécourt;470;11;481
28;Normandie;27;2;17;620;Selles;465;2;467
28;Normandie;27;3;20;621;Serez;170;5;175
28;Normandie;27;2;02;622;Serquigny;1852;55;1907
28;Normandie;27;1;18;623;Surtauville;492;9;501
28;Normandie;27;1;18;624;Surville;883;24;907
28;Normandie;27;1;01;625;Suzay;359;2;361
28;Normandie;27;2;03;627;Le Theil-Nolent;245;12;257
28;Normandie;27;2;03;629;Thiberville;1789;16;1805
28;Normandie;27;2;07;630;Thibouville;318;40;358
28;Normandie;27;2;17;631;Thierville;372;4;376
28;Normandie;27;1;13;632;Le Thil;579;8;587
28;Normandie;27;1;13;633;Les Thilliers-en-Vexin;495;4;499
28;Normandie;27;1;01;635;Le Thuit;141;1;142
28;Normandie;27;2;05;638;Le Thuit de l'Oison;3700;52;3752
28;Normandie;27;3;08;640;Tilleul-Dame-Agnès;192;4;196
28;Normandie;27;2;15;641;Le Tilleul-Lambert;260;5;265
28;Normandie;27;2;22;643;Tillières-sur-Avre;1069;23;1092
28;Normandie;27;1;01;644;Tilly;558;41;599
28;Normandie;27;2;04;645;Tocqueville;155;4;159
28;Normandie;27;2;03;646;Le Torpt;446;5;451
28;Normandie;27;1;19;649;Touffreville;353;7;360
28;Normandie;27;2;15;650;Tournedos-Bois-Hubert;468;8;476
28;Normandie;27;3;15;652;Tourneville;310;8;318
28;Normandie;27;2;05;654;Tourville-la-Campagne;1121;12;1133
28;Normandie;27;2;17;655;Tourville-sur-Pont-Audemer;730;160;890
28;Normandie;27;2;17;656;Toutainville;1311;31;1342
28;Normandie;27;2;15;658;Le Tremblay-Omonville;362;6;368
28;Normandie;27;3;11;659;La Trinité;123;6;129
28;Normandie;27;2;06;660;La Trinité-de-Réville;237;2;239
28;Normandie;27;2;04;661;La Trinité-de-Thouberville;425;9;434
28;Normandie;27;2;17;662;Triqueville;330;11;341
28;Normandie;27;2;15;663;Le Troncq;167;4;171
28;Normandie;27;1;19;664;Le Tronquay;513;7;520
28;Normandie;27;2;04;665;Trouville-la-Haule;762;13;775
28;Normandie;27;1;18;666;La Vacherie;565;19;584
28;Normandie;27;2;02;667;Valailles;384;9;393
28;Normandie;27;3;11;668;Le Val-David;701;11;712
28;Normandie;27;2;04;669;Valletot;441;6;447
28;Normandie;27;1;19;670;Vandrimare;961;18;979
28;Normandie;27;2;03;671;Vannecrocq;164;7;171
28;Normandie;27;1;19;672;Vascœuil;357;1;358
28;Normandie;27;1;01;673;Vatteville;178;4;182
28;Normandie;27;1;16;674;Vaux-sur-Eure;267;7;274
28;Normandie;27;2;15;677;Venon;413;8;421
28;Normandie;27;3;08;678;Les Ventes;1040;24;1064
28;Normandie;27;2;86;679;Verneuil d'Avre et d'Iton;7614;364;7978
28;Normandie;27;2;06;680;Verneusses;193;6;199
28;Normandie;27;1;23;681;Vernon;23727;677;24404
28;Normandie;27;1;13;682;Vesly;657;16;673
28;Normandie;27;1;01;683;Vézillon;232;3;235
28;Normandie;27;3;11;684;Le Vieil-Évreux;831;14;845
28;Normandie;27;2;06;685;La Vieille-Lyre;659;18;677
28;Normandie;27;2;04;686;Vieux-Port;48;0;48
28;Normandie;27;1;16;689;Villegats;348;16;364
28;Normandie;27;1;13;690;Villers-en-Vexin;311;1;312
28;Normandie;27;1;12;691;Villers-sur-le-Roule;863;19;882
28;Normandie;27;2;15;692;Villettes;161;6;167
28;Normandie;27;2;22;693;Sylvains-Lès-Moulins;1296;32;1328
28;Normandie;27;1;16;694;Villez-sous-Bailleul;314;15;329
28;Normandie;27;2;15;695;Villez-sur-le-Neubourg;281;6;287
28;Normandie;27;1;16;696;Villiers-en-Désœuvre;932;17;949
28;Normandie;27;1;14;697;Vironvay;330;17;347
28;Normandie;27;2;15;698;Vitot;559;13;572
28;Normandie;27;2;05;699;Voiscreville;119;3;122
28;Normandie;27;2;15;700;Vraiville;728;5;733
28;Normandie;27;1;21;701;Val-de-Reuil;12910;287;13197
24;Centre-Val de Loire;28;3;01;001;Abondant;2390;56;2446
24;Centre-Val de Loire;28;3;08;003;Allainville;139;4;143
24;Centre-Val de Loire;28;1;15;004;Allonnes;316;3;319
24;Centre-Val de Loire;28;2;07;005;Alluyes;747;90;837
24;Centre-Val de Loire;28;1;12;006;Amilly;1825;47;1872
24;Centre-Val de Loire;28;3;01;007;Anet;2697;103;2800
24;Centre-Val de Loire;28;3;14;008;Ardelles;206;2;208
24;Centre-Val de Loire;28;1;02;009;Ardelu;72;1;73
24;Centre-Val de Loire;28;4;13;010;Argenvilliers;325;8;333
24;Centre-Val de Loire;28;2;03;012;Commune nouvelle d'Arrou;3653;63;3716
24;Centre-Val de Loire;28;1;02;013;Aunay-sous-Auneau;1549;25;1574
24;Centre-Val de Loire;28;3;08;014;Aunay-sous-Crécy;668;7;675
24;Centre-Val de Loire;28;1;02;015;Auneau-Bleury-Saint-Symphorien;6090;87;6177
24;Centre-Val de Loire;28;4;03;016;Les Autels-Villevillon;131;6;137
24;Centre-Val de Loire;28;4;03;018;Authon-du-Perche;1501;16;1517
24;Centre-Val de Loire;28;2;15;019;Baigneaux;208;4;212
24;Centre-Val de Loire;28;1;11;021;Bailleau-le-Pin;1581;30;1611
24;Centre-Val de Loire;28;1;06;022;Bailleau-l'Évêque;1139;31;1170
24;Centre-Val de Loire;28;1;02;023;Bailleau-Armenonville;1376;26;1402
24;Centre-Val de Loire;28;1;12;024;Barjouville;1722;60;1782
24;Centre-Val de Loire;28;1;15;025;Barmainville;107;2;109
24;Centre-Val de Loire;28;1;15;026;Baudreville;246;0;246
24;Centre-Val de Loire;28;4;03;027;La Bazoche-Gouet;1224;20;1244
24;Centre-Val de Loire;28;2;15;028;Bazoches-en-Dunois;260;5;265
24;Centre-Val de Loire;28;2;15;029;Bazoches-les-Hautes;318;7;325
24;Centre-Val de Loire;28;3;14;030;Beauche;275;8;283
24;Centre-Val de Loire;28;4;03;031;Beaumont-les-Autels;390;111;501
24;Centre-Val de Loire;28;1;15;032;Beauvilliers;339;4;343
24;Centre-Val de Loire;28;4;13;033;Belhomert-Guéhouville;799;32;831
24;Centre-Val de Loire;28;1;04;034;Berchères-Saint-Germain;888;12;900
24;Centre-Val de Loire;28;1;05;035;Berchères-les-Pierres;979;23;1002
24;Centre-Val de Loire;28;3;01;036;Berchères-sur-Vesgre;847;20;867
24;Centre-Val de Loire;28;3;14;037;Bérou-la-Mulotière;334;5;339
24;Centre-Val de Loire;28;4;03;038;Béthonvilliers;112;5;117
24;Centre-Val de Loire;28;1;02;039;Béville-le-Comte;1671;31;1702
24;Centre-Val de Loire;28;1;11;040;Billancelles;324;9;333
24;Centre-Val de Loire;28;1;11;041;Blandainville;276;2;278
24;Centre-Val de Loire;28;3;08;045;Boissy-en-Drouais;224;6;230
24;Centre-Val de Loire;28;3;14;046;Boissy-lès-Perche;485;9;494
24;Centre-Val de Loire;28;1;15;047;Boisville-la-Saint-Père;724;15;739
24;Centre-Val de Loire;28;1;05;048;La Bourdinière-Saint-Loup;742;14;756
24;Centre-Val de Loire;28;1;15;049;Boncé;244;5;249
24;Centre-Val de Loire;28;3;01;050;Boncourt;267;6;273
24;Centre-Val de Loire;28;2;07;051;Bonneval;4846;100;4946
24;Centre-Val de Loire;28;1;10;052;Bouglainval;752;15;767
24;Centre-Val de Loire;28;3;14;053;Le Boullay-les-Deux-Églises;250;3;253
24;Centre-Val de Loire;28;3;09;054;Le Boullay-Mivoye;504;11;515
24;Centre-Val de Loire;28;3;09;055;Le Boullay-Thierry;560;9;569
24;Centre-Val de Loire;28;3;01;056;Boutigny-Prouais;1699;46;1745
24;Centre-Val de Loire;28;2;15;057;Bouville;592;9;601
24;Centre-Val de Loire;28;3;09;058;Bréchamps;358;4;362
24;Centre-Val de Loire;28;3;14;059;Brezolles;1823;28;1851
24;Centre-Val de Loire;28;1;04;060;Briconville;263;5;268
24;Centre-Val de Loire;28;2;03;061;Brou;3311;36;3347
24;Centre-Val de Loire;28;3;01;062;Broué;899;15;914
24;Centre-Val de Loire;28;3;01;064;Bû;2007;51;2058
24;Centre-Val de Loire;28;2;15;065;Bullainville;108;5;113
24;Centre-Val de Loire;28;1;11;067;Cernay;90;2;92
24;Centre-Val de Loire;28;1;04;068;Challet;433;10;443
24;Centre-Val de Loire;28;1;04;070;Champhol;3715;109;3824
24;Centre-Val de Loire;28;4;13;071;Champrond-en-Gâtine;688;3;691
24;Centre-Val de Loire;28;4;13;072;Champrond-en-Perchet;413;0;413
24;Centre-Val de Loire;28;1;02;073;Champseru;343;1;344
24;Centre-Val de Loire;28;1;02;074;La Chapelle-d'Aunainville;256;4;260
24;Centre-Val de Loire;28;2;07;075;La Chapelle-du-Noyer;1016;181;1197
24;Centre-Val de Loire;28;3;01;076;La Chapelle-Forainvilliers;194;3;197
24;Centre-Val de Loire;28;3;14;077;La Chapelle-Fortin;176;3;179
24;Centre-Val de Loire;28;4;03;078;Chapelle-Guillaume;184;4;188
24;Centre-Val de Loire;28;4;03;079;Chapelle-Royale;300;4;304
24;Centre-Val de Loire;28;4;03;080;Charbonnières;254;3;257
24;Centre-Val de Loire;28;1;11;081;Charonville;306;5;311
24;Centre-Val de Loire;28;3;09;082;Charpont;634;14;648
24;Centre-Val de Loire;28;1;10;084;Chartainvilliers;711;9;720
24;Centre-Val de Loire;28;1;98;085;Chartres;38534;1164;39698
24;Centre-Val de Loire;28;4;13;086;Chassant;327;8;335
24;Centre-Val de Loire;28;3;14;087;Châtaincourt;239;4;243
24;Centre-Val de Loire;28;2;07;088;Châteaudun;13096;336;13432
24;Centre-Val de Loire;28;3;14;089;Châteauneuf-en-Thymerais;2596;32;2628
24;Centre-Val de Loire;28;3;14;090;Les Châtelets;104;3;107
24;Centre-Val de Loire;28;1;11;091;Les Châtelliers-Notre-Dame;145;3;148
24;Centre-Val de Loire;28;1;02;092;Châtenay;232;6;238
24;Centre-Val de Loire;28;3;09;094;Chaudon;1670;27;1697
24;Centre-Val de Loire;28;1;11;095;Chauffours;275;6;281
24;Centre-Val de Loire;28;3;01;096;La Chaussée-d'Ivry;1226;18;1244
24;Centre-Val de Loire;28;3;01;098;Cherisy;1841;49;1890
24;Centre-Val de Loire;28;1;11;099;Chuisnes;1106;22;1128
24;Centre-Val de Loire;28;1;12;100;Cintray;447;6;453
24;Centre-Val de Loire;28;1;04;102;Clévilliers;722;9;731
24;Centre-Val de Loire;28;2;03;103;Cloyes-les-Trois-Rivières;5618;124;5742
24;Centre-Val de Loire;28;1;04;104;Coltainville;898;28;926
24;Centre-Val de Loire;28;4;13;105;Combres;555;6;561
24;Centre-Val de Loire;28;2;07;106;Conie-Molitard;406;11;417
24;Centre-Val de Loire;28;1;05;107;Corancez;363;9;372
24;Centre-Val de Loire;28;2;15;108;Cormainville;232;8;240
24;Centre-Val de Loire;28;4;13;109;Les Corvées-les-Yys;318;5;323
24;Centre-Val de Loire;28;1;05;110;Le Coudray;4078;118;4196
24;Centre-Val de Loire;28;4;03;111;Coudray-au-Perche;358;13;371
24;Centre-Val de Loire;28;3;10;113;Coulombs;1343;32;1375
24;Centre-Val de Loire;28;2;15;114;Courbehaye;136;0;136
24;Centre-Val de Loire;28;1;11;116;Courville-sur-Eure;2831;61;2892
24;Centre-Val de Loire;28;3;08;117;Crécy-Couvé;267;9;276
24;Centre-Val de Loire;28;3;09;118;Croisilles;427;15;442
24;Centre-Val de Loire;28;4;13;119;La Croix-du-Perche;153;2;155
24;Centre-Val de Loire;28;3;14;120;Crucey-Villages;455;2;457
24;Centre-Val de Loire;28;2;15;121;Dambron;108;0;108
24;Centre-Val de Loire;28;1;05;122;Dammarie;1504;23;1527
24;Centre-Val de Loire;28;2;03;123;Dampierre-sous-Brou;451;8;459
24;Centre-Val de Loire;28;3;14;124;Dampierre-sur-Avre;738;20;758
24;Centre-Val de Loire;28;2;07;126;Dancy;200;4;204
24;Centre-Val de Loire;28;2;07;127;Dangeau;1259;27;1286
24;Centre-Val de Loire;28;1;11;128;Dangers;432;5;437
24;Centre-Val de Loire;28;1;02;129;Denonville;758;19;777
24;Centre-Val de Loire;28;3;14;130;Digny;996;13;1009
24;Centre-Val de Loire;28;2;07;132;Donnemain-Saint-Mamès;659;16;675
24;Centre-Val de Loire;28;3;99;134;Dreux;30646;519;31165
24;Centre-Val de Loire;28;1;10;135;Droue-sur-Drouette;1222;57;1279
24;Centre-Val de Loire;28;3;09;136;Écluzelles;166;5;171
24;Centre-Val de Loire;28;1;02;137;Écrosnes;838;17;855
24;Centre-Val de Loire;28;1;11;139;Épeautrolles;191;2;193
24;Centre-Val de Loire;28;1;10;140;Épernon;5634;67;5701
24;Centre-Val de Loire;28;1;11;141;Ermenonville-la-Grande;317;11;328
24;Centre-Val de Loire;28;1;11;142;Ermenonville-la-Petite;184;2;186
24;Centre-Val de Loire;28;3;14;143;Escorpain;245;3;248
24;Centre-Val de Loire;28;4;03;144;Les Étilleux;212;7;219
24;Centre-Val de Loire;28;3;10;146;Faverolles;855;12;867
24;Centre-Val de Loire;28;3;14;147;Favières;600;10;610
24;Centre-Val de Loire;28;1;11;148;Le Favril;368;11;379
24;Centre-Val de Loire;28;3;14;149;La Ferté-Vidame;621;18;639
24;Centre-Val de Loire;28;3;14;151;Fessanvilliers-Mattanvilliers;176;5;181
24;Centre-Val de Loire;28;2;07;153;Flacey;208;7;215
24;Centre-Val de Loire;28;1;11;154;Fontaine-la-Guyon;1696;33;1729
24;Centre-Val de Loire;28;3;14;155;Fontaine-les-Ribouts;205;2;207
24;Centre-Val de Loire;28;4;13;156;Fontaine-Simon;900;16;916
24;Centre-Val de Loire;28;2;15;157;Fontenay-sur-Conie;121;4;125
24;Centre-Val de Loire;28;1;12;158;Fontenay-sur-Eure;1070;27;1097
24;Centre-Val de Loire;28;3;14;159;La Framboisière;341;4;345
24;Centre-Val de Loire;28;1;02;160;Francourville;834;8;842
24;Centre-Val de Loire;28;4;03;161;Frazé;502;7;509
24;Centre-Val de Loire;28;1;05;162;Fresnay-le-Comte;305;5;310
24;Centre-Val de Loire;28;1;04;163;Fresnay-le-Gilmert;213;3;216
24;Centre-Val de Loire;28;1;15;164;Fresnay-l'Évêque;735;10;745
24;Centre-Val de Loire;28;4;11;166;Friaize;253;2;255
24;Centre-Val de Loire;28;1;11;167;Fruncé;386;6;392
24;Centre-Val de Loire;28;1;02;168;Gallardon;3693;57;3750
24;Centre-Val de Loire;28;1;02;169;Garancières-en-Beauce;223;7;230
24;Centre-Val de Loire;28;3;08;170;Garancières-en-Drouais;281;6;287
24;Centre-Val de Loire;28;3;08;171;Garnay;921;22;943
24;Centre-Val de Loire;28;1;10;172;Gas;797;15;812
24;Centre-Val de Loire;28;1;04;173;Gasville-Oisème;1494;34;1528
24;Centre-Val de Loire;28;4;13;175;La Gaudaine;169;4;173
24;Centre-Val de Loire;28;2;15;176;Le Gault-Saint-Denis;679;13;692
24;Centre-Val de Loire;28;1;05;177;Gellainville;666;12;678
24;Centre-Val de Loire;28;3;01;178;Germainville;313;6;319
24;Centre-Val de Loire;28;3;01;180;Gilles;501;13;514
24;Centre-Val de Loire;28;2;03;182;Gohory;315;2;317
24;Centre-Val de Loire;28;1;15;183;Gommerville;690;3;693
24;Centre-Val de Loire;28;1;15;184;Gouillons;342;4;346
24;Centre-Val de Loire;28;3;01;185;Goussainville;1302;22;1324
24;Centre-Val de Loire;28;3;01;187;Guainville;656;13;669
24;Centre-Val de Loire;28;1;02;188;Le Gué-de-Longroi;947;16;963
24;Centre-Val de Loire;28;1;15;189;Guilleville;178;4;182
24;Centre-Val de Loire;28;2;15;190;Guillonville;458;12;470
24;Centre-Val de Loire;28;1;10;191;Hanches;2682;57;2739
24;Centre-Val de Loire;28;4;13;192;Happonvilliers;316;3;319
24;Centre-Val de Loire;28;3;01;193;Havelu;135;3;138
24;Centre-Val de Loire;28;1;02;194;Houville-la-Branche;411;16;427
24;Centre-Val de Loire;28;1;10;195;Houx;748;22;770
24;Centre-Val de Loire;28;1;11;196;Illiers-Combray;3266;50;3316
24;Centre-Val de Loire;28;1;15;197;Intréville;148;3;151
24;Centre-Val de Loire;28;2;07;198;Jallans;801;31;832
24;Centre-Val de Loire;28;1;15;199;Janville-en-Beauce;2571;50;2621
24;Centre-Val de Loire;28;3;14;200;Jaudrais;422;5;427
24;Centre-Val de Loire;28;1;04;201;Jouy;1961;41;2002
24;Centre-Val de Loire;28;3;14;202;Lamblore;325;6;331
24;Centre-Val de Loire;28;1;11;203;Landelles;638;7;645
24;Centre-Val de Loire;28;3;14;206;Laons;679;12;691
24;Centre-Val de Loire;28;1;02;207;Léthuin;230;4;234
24;Centre-Val de Loire;28;1;02;208;Levainville;382;14;396
24;Centre-Val de Loire;28;1;06;209;Lèves;5686;160;5846
24;Centre-Val de Loire;28;1;15;210;Levesville-la-Chenard;220;2;222
24;Centre-Val de Loire;28;2;07;211;Logron;578;7;585
24;Centre-Val de Loire;28;2;15;212;Loigny-la-Bataille;196;8;204
24;Centre-Val de Loire;28;3;10;213;Lormaye;665;10;675
24;Centre-Val de Loire;28;4;13;214;La Loupe;3329;81;3410
24;Centre-Val de Loire;28;1;15;215;Louville-la-Chenard;253;6;259
24;Centre-Val de Loire;28;3;08;216;Louvilliers-en-Drouais;203;1;204
24;Centre-Val de Loire;28;3;14;217;Louvilliers-lès-Perche;180;2;182
24;Centre-Val de Loire;28;1;12;218;Lucé;15403;215;15618
24;Centre-Val de Loire;28;4;03;219;Luigny;389;10;399
24;Centre-Val de Loire;28;1;12;220;Luisant;6689;320;7009
24;Centre-Val de Loire;28;2;15;221;Lumeau;140;8;148
24;Centre-Val de Loire;28;1;11;222;Luplanté;385;6;391
24;Centre-Val de Loire;28;3;09;223;Luray;1542;22;1564
24;Centre-Val de Loire;28;1;11;225;Magny;649;11;660
24;Centre-Val de Loire;28;3;14;226;Maillebois;906;16;922
24;Centre-Val de Loire;28;1;10;227;Maintenon;4457;82;4539
24;Centre-Val de Loire;28;1;06;229;Mainvilliers;11127;258;11385
24;Centre-Val de Loire;28;1;02;230;Maisons;383;7;390
24;Centre-Val de Loire;28;3;14;231;La Mancelière;178;3;181
24;Centre-Val de Loire;28;4;13;232;Manou;592;30;622
24;Centre-Val de Loire;28;2;07;233;Marboué;1152;26;1178
24;Centre-Val de Loire;28;1;11;234;Marchéville;461;11;472
24;Centre-Val de Loire;28;3;01;235;Marchezais;369;3;372
24;Centre-Val de Loire;28;4;13;236;Arcisses;2181;60;2241
24;Centre-Val de Loire;28;4;13;237;Marolles-les-Buis;207;4;211
24;Centre-Val de Loire;28;3;08;239;Marville-Moutiers-Brûlé;983;25;1008
24;Centre-Val de Loire;28;4;13;240;Meaucé;513;8;521
24;Centre-Val de Loire;28;1;11;242;Méréglise;98;3;101
24;Centre-Val de Loire;28;1;15;243;Mérouville;214;6;220
24;Centre-Val de Loire;28;1;11;245;Meslay-le-Grenet;360;9;369
24;Centre-Val de Loire;28;2;15;246;Meslay-le-Vidame;530;9;539
24;Centre-Val de Loire;28;3;01;247;Le Mesnil-Simon;568;15;583
24;Centre-Val de Loire;28;3;14;248;Le Mesnil-Thomas;329;6;335
24;Centre-Val de Loire;28;1;10;249;Mévoisins;614;18;632
24;Centre-Val de Loire;28;3;09;251;Mézières-en-Drouais;1061;27;1088
24;Centre-Val de Loire;28;4;03;252;Miermaigne;189;3;192
24;Centre-Val de Loire;28;1;05;253;Mignières;1067;84;1151
24;Centre-Val de Loire;28;1;11;254;Mittainvilliers-Vérigny;795;13;808
24;Centre-Val de Loire;28;1;02;255;Moinville-la-Jeulin;170;0;170
24;Centre-Val de Loire;28;2;07;256;Moléans;449;14;463
24;Centre-Val de Loire;28;1;02;257;Mondonville-Saint-Jean;87;2;89
24;Centre-Val de Loire;28;2;07;259;Montboissier;330;5;335
24;Centre-Val de Loire;28;2;07;260;Montharville;99;5;104
24;Centre-Val de Loire;28;4;03;261;Montigny-le-Chartif;599;12;611
24;Centre-Val de Loire;28;3;14;263;Montigny-sur-Avre;252;7;259
24;Centre-Val de Loire;28;4;13;264;Montireau;139;5;144
24;Centre-Val de Loire;28;4;13;265;Montlandon;252;2;254
24;Centre-Val de Loire;28;3;01;267;Montreuil;508;5;513
24;Centre-Val de Loire;28;1;02;268;Morainville;17;2;19
24;Centre-Val de Loire;28;1;05;269;Morancez;1899;41;1940
24;Centre-Val de Loire;28;2;07;270;Moriers;223;4;227
24;Centre-Val de Loire;28;3;14;271;Morvilliers;140;4;144
24;Centre-Val de Loire;28;2;03;272;Mottereau;159;3;162
24;Centre-Val de Loire;28;4;03;273;Moulhard;139;2;141
24;Centre-Val de Loire;28;1;15;274;Moutiers;242;6;248
24;Centre-Val de Loire;28;3;10;275;Néron;659;15;674
24;Centre-Val de Loire;28;1;15;276;Neuvy-en-Beauce;208;8;216
24;Centre-Val de Loire;28;2;15;277;Neuvy-en-Dunois;306;13;319
24;Centre-Val de Loire;28;1;05;278;Nogent-le-Phaye;1480;34;1514
24;Centre-Val de Loire;28;3;10;279;Nogent-le-Roi;3981;65;4046
24;Centre-Val de Loire;28;4;13;280;Nogent-le-Rotrou;9491;450;9941
24;Centre-Val de Loire;28;1;11;281;Nogent-sur-Eure;518;9;527
24;Centre-Val de Loire;28;4;13;282;Nonvilliers-Grandhoux;431;11;442
24;Centre-Val de Loire;28;2;15;283;Nottonville;289;5;294
24;Centre-Val de Loire;28;1;15;284;Oinville-Saint-Liphard;277;9;286
24;Centre-Val de Loire;28;1;02;285;Oinville-sous-Auneau;349;9;358
24;Centre-Val de Loire;28;1;11;286;Ollé;622;15;637
24;Centre-Val de Loire;28;2;15;287;Orgères-en-Beauce;1012;15;1027
24;Centre-Val de Loire;28;3;09;289;Ormoy;220;6;226
24;Centre-Val de Loire;28;1;11;290;Orrouer;287;9;296
24;Centre-Val de Loire;28;1;15;291;Ouarville;526;16;542
24;Centre-Val de Loire;28;3;09;292;Ouerre;734;16;750
24;Centre-Val de Loire;28;3;01;293;Oulins;1197;28;1225
24;Centre-Val de Loire;28;1;02;294;Oysonville;524;13;537
24;Centre-Val de Loire;28;2;15;296;Péronville;269;4;273
24;Centre-Val de Loire;28;1;10;298;Pierres;2756;57;2813
24;Centre-Val de Loire;28;3;10;299;Les Pinthières;171;6;177
24;Centre-Val de Loire;28;1;15;300;Poinville;154;6;160
24;Centre-Val de Loire;28;1;04;301;Poisvilliers;444;6;450
24;Centre-Val de Loire;28;1;11;302;Pontgouin;1099;319;1418
24;Centre-Val de Loire;28;2;15;303;Poupry;101;3;104
24;Centre-Val de Loire;28;1;15;304;Prasville;433;6;439
24;Centre-Val de Loire;28;2;15;305;Pré-Saint-Évroult;299;5;304
24;Centre-Val de Loire;28;2;15;306;Pré-Saint-Martin;204;6;210
24;Centre-Val de Loire;28;3;14;308;Prudemanche;259;11;270
24;Centre-Val de Loire;28;1;05;309;Prunay-le-Gillon;1071;16;1087
24;Centre-Val de Loire;28;3;14;310;La Puisaye;264;6;270
24;Centre-Val de Loire;28;3;14;312;Puiseux;130;2;132
24;Centre-Val de Loire;28;1;15;313;Réclainville;194;1;195
24;Centre-Val de Loire;28;3;14;314;Les Ressuintes;116;8;124
24;Centre-Val de Loire;28;3;14;315;Revercourt;22;1;23
24;Centre-Val de Loire;28;3;14;316;Rohaire;126;3;129
24;Centre-Val de Loire;28;1;02;317;Roinville;564;5;569
24;Centre-Val de Loire;28;1;15;319;Rouvray-Saint-Denis;373;13;386
24;Centre-Val de Loire;28;3;01;321;Rouvres;838;14;852
24;Centre-Val de Loire;28;3;14;322;Rueil-la-Gadelière;498;9;507
24;Centre-Val de Loire;28;3;14;323;Saint-Ange-et-Torçay;285;1;286
24;Centre-Val de Loire;28;1;11;324;Saint-Arnoult-des-Bois;886;23;909
24;Centre-Val de Loire;28;1;06;325;Saint-Aubin-des-Bois;1055;27;1082
24;Centre-Val de Loire;28;2;11;326;Saint-Avit-les-Guespières;360;2;362
24;Centre-Val de Loire;28;4;03;327;Saint-Bomer;189;2;191
24;Centre-Val de Loire;28;2;07;329;Saint-Christophe;159;2;161
24;Centre-Val de Loire;28;2;07;330;Villemaury;1375;32;1407
24;Centre-Val de Loire;28;4;13;331;Saintigny;973;19;992
24;Centre-Val de Loire;28;3;09;332;Sainte-Gemme-Moronval;1090;21;1111
24;Centre-Val de Loire;28;1;11;333;Saint-Denis-des-Puits;140;3;143
24;Centre-Val de Loire;28;2;07;334;Saint-Denis-Lanneray;2195;54;2249
24;Centre-Val de Loire;28;4;13;335;Saint-Éliph;853;24;877
24;Centre-Val de Loire;28;1;11;336;Saint-Éman;107;1;108
24;Centre-Val de Loire;28;1;11;337;Saint-Georges-sur-Eure;2817;67;2884
24;Centre-Val de Loire;28;1;11;339;Saint-Germain-le-Gaillard;355;11;366
24;Centre-Val de Loire;28;3;14;341;Saint-Jean-de-Rebervilliers;249;5;254
24;Centre-Val de Loire;28;4;13;342;Saint-Jean-Pierre-Fixte;263;5;268
24;Centre-Val de Loire;28;3;10;343;Saint-Laurent-la-Gâtine;444;11;455
24;Centre-Val de Loire;28;1;02;344;Saint-Léger-des-Aubées;264;10;274
24;Centre-Val de Loire;28;3;14;346;Saint-Lubin-de-Cravant;57;3;60
24;Centre-Val de Loire;28;3;01;347;Saint-Lubin-de-la-Haye;933;29;962
24;Centre-Val de Loire;28;3;14;348;Saint-Lubin-des-Joncherets;4019;71;4090
24;Centre-Val de Loire;28;3;10;349;Saint-Lucien;257;8;265
24;Centre-Val de Loire;28;1;11;350;Saint-Luperce;934;21;955
24;Centre-Val de Loire;28;3;14;351;Saint-Maixme-Hauterive;408;8;416
24;Centre-Val de Loire;28;1;10;352;Saint-Martin-de-Nigelles;1569;41;1610
24;Centre-Val de Loire;28;2;07;353;Saint-Maur-sur-le-Loir;403;5;408
24;Centre-Val de Loire;28;4;13;354;Saint-Maurice-Saint-Germain;419;69;488
24;Centre-Val de Loire;28;3;01;355;Saint-Ouen-Marchefroy;296;9;305
24;Centre-Val de Loire;28;1;10;357;Saint-Piat;1059;30;1089
24;Centre-Val de Loire;28;1;04;358;Saint-Prest;2072;67;2139
24;Centre-Val de Loire;28;3;14;359;Saint-Rémy-sur-Avre;4041;46;4087
24;Centre-Val de Loire;28;3;14;360;Saint-Sauveur-Marville;920;17;937
24;Centre-Val de Loire;28;4;13;362;Saint-Victor-de-Buthon;503;12;515
24;Centre-Val de Loire;28;1;02;363;Sainville;1024;13;1037
24;Centre-Val de Loire;28;2;15;364;Sancheville;766;13;779
24;Centre-Val de Loire;28;1;11;365;Sandarville;409;9;418
24;Centre-Val de Loire;28;1;02;366;Santeuil;320;3;323
24;Centre-Val de Loire;28;1;15;367;Santilly;330;6;336
24;Centre-Val de Loire;28;3;14;368;La Saucelle;197;3;200
24;Centre-Val de Loire;28;3;08;369;Saulnières;758;10;768
24;Centre-Val de Loire;28;2;07;370;Saumeray;505;11;516
24;Centre-Val de Loire;28;3;01;371;Saussay;1101;20;1121
24;Centre-Val de Loire;28;3;10;372;Senantes;568;12;580
24;Centre-Val de Loire;28;3;14;373;Senonches;3032;47;3079
24;Centre-Val de Loire;28;3;14;374;Serazereux;538;3;541
24;Centre-Val de Loire;28;3;01;375;Serville;369;6;375
24;Centre-Val de Loire;28;3;01;377;Sorel-Moussel;1761;44;1805
24;Centre-Val de Loire;28;4;13;378;Souancé-au-Perche;524;11;535
24;Centre-Val de Loire;28;1;10;379;Soulaires;467;10;477
24;Centre-Val de Loire;28;1;05;380;Sours;1998;171;2169
24;Centre-Val de Loire;28;2;15;382;Terminiers;889;15;904
24;Centre-Val de Loire;28;1;15;383;Theuville;706;6;712
24;Centre-Val de Loire;28;4;11;385;Le Thieulin;452;34;486
24;Centre-Val de Loire;28;3;14;386;Thimert-Gâtelles;1245;21;1266
24;Centre-Val de Loire;28;4;13;387;Thiron-Gardais;982;11;993
24;Centre-Val de Loire;28;1;05;388;Thivars;1044;32;1076
24;Centre-Val de Loire;28;2;07;389;Thiville;341;8;349
24;Centre-Val de Loire;28;2;15;390;Tillay-le-Péneux;312;6;318
24;Centre-Val de Loire;28;1;15;391;Toury;2595;32;2627
24;Centre-Val de Loire;28;1;15;392;Trancrainville;164;2;166
24;Centre-Val de Loire;28;3;14;393;Tremblay-les-Villages;2243;66;2309
24;Centre-Val de Loire;28;3;08;394;Tréon;1422;28;1450
24;Centre-Val de Loire;28;4;13;395;Trizay-Coutretot-Saint-Serge;433;14;447
24;Centre-Val de Loire;28;2;07;396;Trizay-lès-Bonneval;310;4;314
24;Centre-Val de Loire;28;1;02;397;Umpeau;407;13;420
24;Centre-Val de Loire;28;2;03;398;Unverre;1167;22;1189
24;Centre-Val de Loire;28;2;15;400;Varize;194;8;202
24;Centre-Val de Loire;28;4;13;401;Vaupillon;454;8;462
24;Centre-Val de Loire;28;1;05;403;Ver-lès-Chartres;770;21;791
24;Centre-Val de Loire;28;3;08;404;Vernouillet;12472;150;12622
24;Centre-Val de Loire;28;3;08;405;Vert-en-Drouais;1070;21;1091
24;Centre-Val de Loire;28;1;15;406;Éole-en-Beauce;1247;19;1266
24;Centre-Val de Loire;28;4;13;407;Vichères;295;8;303
24;Centre-Val de Loire;28;1;02;408;Vierville;121;3;124
24;Centre-Val de Loire;28;2;11;409;Vieuvicq;455;15;470
24;Centre-Val de Loire;28;2;07;410;Villampuy;303;4;307
24;Centre-Val de Loire;28;1;15;411;Villars;172;2;174
24;Centre-Val de Loire;28;1;11;414;Villebon;65;5;70
24;Centre-Val de Loire;28;3;09;415;Villemeux-sur-Eure;1688;31;1719
24;Centre-Val de Loire;28;3;10;417;Villiers-le-Morhier;1335;28;1363
24;Centre-Val de Loire;28;2;07;418;Villiers-Saint-Orien;163;5;168
24;Centre-Val de Loire;28;2;15;419;Vitray-en-Beauce;344;8;352
24;Centre-Val de Loire;28;1;02;421;Voise;275;5;280
24;Centre-Val de Loire;28;1;15;422;Les Villages Vovéens;3914;61;3975
24;Centre-Val de Loire;28;1;02;423;Yermenonville;598;14;612
24;Centre-Val de Loire;28;2;03;424;Yèvres;1616;39;1655
24;Centre-Val de Loire;28;1;02;425;Ymeray;575;11;586
24;Centre-Val de Loire;28;1;15;426;Ymonville;498;9;507
53;Bretagne;29;2;09;001;Argol;998;19;1017
53;Bretagne;29;4;25;002;Arzano;1376;33;1409
53;Bretagne;29;4;10;003;Audierne;3692;66;3758
53;Bretagne;29;4;16;004;Bannalec;5668;157;5825
53;Bretagne;29;4;25;005;Baye;1239;31;1270
53;Bretagne;29;4;11;006;Bénodet;3616;63;3679
53;Bretagne;29;2;07;007;Berrien;892;31;923
53;Bretagne;29;4;10;008;Beuzec-Cap-Sizun;1000;21;1021
53;Bretagne;29;3;14;010;Bodilis;1645;34;1679
53;Bretagne;29;1;04;011;Bohars;3530;86;3616
53;Bretagne;29;2;07;012;Bolazec;188;2;190
53;Bretagne;29;2;07;013;Botmeur;218;6;224
53;Bretagne;29;3;20;014;Botsorhel;430;9;439
53;Bretagne;29;1;18;015;Bourg-Blanc;3553;63;3616
53;Bretagne;29;2;07;016;Brasparts;1028;11;1039
53;Bretagne;29;1;27;017;Brélès;861;27;888
53;Bretagne;29;2;07;018;Brennilis;438;5;443
53;Bretagne;29;1;98;019;Brest;139926;2629;142555
53;Bretagne;29;4;06;020;Briec;5675;114;5789
53;Bretagne;29;1;15;021;Plounéour-Brignogan-plages;1912;49;1961
53;Bretagne;29;2;09;022;Camaret-sur-Mer;2466;55;2521
53;Bretagne;29;3;17;023;Carantec;3189;103;3292
53;Bretagne;29;2;07;024;Carhaix-Plouguer;7155;613;7768
53;Bretagne;29;2;09;025;Cast;1538;45;1583
53;Bretagne;29;2;09;026;Châteaulin;5164;422;5586
53;Bretagne;29;2;06;027;Châteauneuf-du-Faou;3650;100;3750
53;Bretagne;29;4;10;028;Cléden-Cap-Sizun;921;20;941
53;Bretagne;29;2;07;029;Cléden-Poher;1145;18;1163
53;Bretagne;29;3;26;030;Cléder;3683;115;3798
53;Bretagne;29;4;25;031;Clohars-Carnoët;4528;114;4642
53;Bretagne;29;4;11;032;Clohars-Fouesnant;2080;50;2130
53;Bretagne;29;2;06;033;Le Cloître-Pleyben;524;10;534
53;Bretagne;29;3;20;034;Le Cloître-Saint-Thégonnec;658;6;664
53;Bretagne;29;1;18;035;Coat-Méal;1114;19;1133
53;Bretagne;29;2;07;036;Collorec;608;7;615
53;Bretagne;29;4;19;037;Combrit;4187;125;4312
53;Bretagne;29;3;14;038;Commana;998;26;1024
53;Bretagne;29;4;08;039;Concarneau;19816;856;20672
53;Bretagne;29;1;27;040;Le Conquet;2750;76;2826
53;Bretagne;29;2;06;041;Coray;1890;31;1921
53;Bretagne;29;2;09;042;Crozon;7386;219;7605
53;Bretagne;29;1;21;043;Daoulas;1817;46;1863
53;Bretagne;29;2;09;044;Dinéault;1967;39;2006
53;Bretagne;29;1;21;045;Dirinon;2215;66;2281
53;Bretagne;29;4;10;046;Douarnenez;14000;365;14365
53;Bretagne;29;1;15;047;Le Drennec;1877;35;1912
53;Bretagne;29;4;06;048;Edern;2251;43;2294
53;Bretagne;29;4;08;049;Elliant;3320;141;3461
53;Bretagne;29;4;11;051;Ergué-Gabéric;8434;203;8637
53;Bretagne;29;2;21;053;Le Faou;1744;41;1785
53;Bretagne;29;2;07;054;La Feuillée;642;15;657
53;Bretagne;29;1;15;055;Le Folgoët;3215;78;3293
53;Bretagne;29;1;13;056;La Forest-Landerneau;1947;31;1978
53;Bretagne;29;4;11;057;La Forêt-Fouesnant;3438;122;3560
53;Bretagne;29;4;11;058;Fouesnant;9864;484;10348
53;Bretagne;29;3;20;059;Garlan;1050;32;1082
53;Bretagne;29;4;11;060;Gouesnach;2786;79;2865
53;Bretagne;29;1;04;061;Gouesnou;6215;135;6350
53;Bretagne;29;2;06;062;Gouézec;1098;35;1133
53;Bretagne;29;4;10;063;Goulien;433;7;440
53;Bretagne;29;1;15;064;Goulven;447;4;451
53;Bretagne;29;4;19;065;Gourlizon;908;15;923
53;Bretagne;29;4;23;066;Guengat;1828;30;1858
53;Bretagne;29;3;20;067;Guerlesquin;1298;41;1339
53;Bretagne;29;3;14;068;Guiclan;2502;52;2554
53;Bretagne;29;1;04;069;Guilers;8061;160;8221
53;Bretagne;29;4;19;070;Guiler-sur-Goyen;526;10;536
53;Bretagne;29;4;25;071;Guilligomarc'h;783;3;786
53;Bretagne;29;4;22;072;Guilvinec;2681;48;2729
53;Bretagne;29;3;20;073;Guimaëc;939;34;973
53;Bretagne;29;3;14;074;Guimiliau;1008;17;1025
53;Bretagne;29;1;12;075;Guipavas;15050;357;15407
53;Bretagne;29;1;27;076;Milizac-Guipronvel;4550;65;4615
53;Bretagne;29;1;15;077;Guissény;1991;47;2038
53;Bretagne;29;1;21;078;Hanvec;2036;47;2083
53;Bretagne;29;3;17;079;Henvic;1267;43;1310
53;Bretagne;29;1;21;080;Hôpital-Camfrout;2232;69;2301
53;Bretagne;29;2;07;081;Huelgoat;1406;27;1433
53;Bretagne;29;3;26;082;Île-de-Batz;452;13;465
53;Bretagne;29;4;10;083;Île-de-Sein;260;2;262
53;Bretagne;29;1;27;084;Île-Molène;160;6;166
53;Bretagne;29;4;19;085;Île-Tudy;733;18;751
53;Bretagne;29;1;21;086;Irvillac;1453;22;1475
53;Bretagne;29;4;10;087;Le Juch;725;16;741
53;Bretagne;29;2;07;089;Kergloff;857;23;880
53;Bretagne;29;4;10;090;Kerlaz;782;25;807
53;Bretagne;29;1;15;091;Kerlouan;2097;39;2136
53;Bretagne;29;1;15;093;Kernilis;1422;31;1453
53;Bretagne;29;1;15;094;Kernouës;665;14;679
53;Bretagne;29;1;18;095;Kersaint-Plabennec;1495;26;1521
53;Bretagne;29;3;14;097;Lampaul-Guimiliau;2028;52;2080
53;Bretagne;29;1;27;098;Lampaul-Plouarzel;2145;53;2198
53;Bretagne;29;1;18;099;Lampaul-Ploudalmézeau;821;22;843
53;Bretagne;29;1;15;100;Lanarvily;414;12;426
53;Bretagne;29;1;18;101;Landéda;3576;112;3688
53;Bretagne;29;2;07;102;Landeleau;959;12;971
53;Bretagne;29;1;13;103;Landerneau;15918;614;16532
53;Bretagne;29;2;09;104;Landévennec;345;6;351
53;Bretagne;29;3;14;105;Landivisiau;9151;320;9471
53;Bretagne;29;4;06;106;Landrévarzec;1850;41;1891
53;Bretagne;29;4;06;107;Landudal;884;13;897
53;Bretagne;29;4;19;108;Landudec;1479;40;1519
53;Bretagne;29;1;18;109;Landunvez;1486;36;1522
53;Bretagne;29;4;06;110;Langolen;861;14;875
53;Bretagne;29;3;26;111;Lanhouarneau;1314;25;1339
53;Bretagne;29;1;27;112;Lanildut;957;18;975
53;Bretagne;29;3;20;113;Lanmeur;2362;39;2401
53;Bretagne;29;3;20;114;Lannéanou;351;7;358
53;Bretagne;29;2;06;115;Lannédern;290;4;294
53;Bretagne;29;1;13;116;Lanneuffret;154;2;156
53;Bretagne;29;1;18;117;Lannilis;5672;118;5790
53;Bretagne;29;1;27;119;Lanrivoaré;1460;37;1497
53;Bretagne;29;2;09;120;Lanvéoc;1970;65;2035
53;Bretagne;29;2;06;122;Laz;676;16;692
53;Bretagne;29;2;06;123;Lennon;784;20;804
53;Bretagne;29;1;15;124;Lesneven;7322;229;7551
53;Bretagne;29;2;06;125;Leuhan;826;17;843
53;Bretagne;29;1;15;126;Loc-Brévalaire;207;6;213
53;Bretagne;29;3;14;128;Loc-Eguiner;406;6;412
53;Bretagne;29;1;27;130;Locmaria-Plouzané;5092;131;5223
53;Bretagne;29;3;14;131;Locmélar;474;14;488
53;Bretagne;29;3;17;132;Locquénolé;795;31;826
53;Bretagne;29;3;20;133;Locquirec;1513;43;1556
53;Bretagne;29;4;23;134;Locronan;795;26;821
53;Bretagne;29;4;22;135;Loctudy;4013;107;4120
53;Bretagne;29;4;25;136;Locunolé;1158;23;1181
53;Bretagne;29;1;21;137;Logonna-Daoulas;2133;53;2186
53;Bretagne;29;2;07;139;Lopérec;874;141;1015
53;Bretagne;29;1;21;140;Loperhet;3910;86;3996
53;Bretagne;29;2;07;141;Loqueffret;348;4;352
53;Bretagne;29;2;06;142;Lothey;460;4;464
53;Bretagne;29;4;10;143;Mahalon;968;21;989
53;Bretagne;29;1;21;144;La Martyre;759;9;768
53;Bretagne;29;4;10;145;Confort-Meilars;873;28;901
53;Bretagne;29;4;08;146;Melgven;3408;50;3458
53;Bretagne;29;4;25;147;Mellac;3242;79;3321
53;Bretagne;29;3;26;148;Mespaul;943;30;973
53;Bretagne;29;4;16;150;Moëlan-sur-Mer;6742;133;6875
53;Bretagne;29;3;17;151;Morlaix;14845;457;15302
53;Bretagne;29;2;07;152;Motreff;701;15;716
53;Bretagne;29;4;16;153;Névez;2686;52;2738
53;Bretagne;29;1;27;155;Ouessant;833;19;852
53;Bretagne;29;1;13;156;Pencran;2049;43;2092
53;Bretagne;29;4;22;158;Penmarch;5149;100;5249
53;Bretagne;29;4;19;159;Peumerit;844;17;861
53;Bretagne;29;1;18;160;Plabennec;8515;164;8679
53;Bretagne;29;4;11;161;Pleuven;3188;82;3270
53;Bretagne;29;2;06;162;Pleyben;3640;265;3905
53;Bretagne;29;3;17;163;Pleyber-Christ;3184;77;3261
53;Bretagne;29;4;22;165;Plobannalec-Lesconil;3568;84;3652
53;Bretagne;29;2;09;166;Ploéven;507;19;526
53;Bretagne;29;4;19;167;Plogastel-Saint-Germain;1985;44;2029
53;Bretagne;29;4;10;168;Plogoff;1230;20;1250
53;Bretagne;29;4;23;169;Plogonnec;3178;76;3254
53;Bretagne;29;4;23;170;Plomelin;4191;163;4354
53;Bretagne;29;4;19;171;Plomeur;3828;75;3903
53;Bretagne;29;2;09;172;Plomodiern;2245;68;2313
53;Bretagne;29;4;23;173;Plonéis;2471;55;2526
53;Bretagne;29;4;19;174;Plonéour-Lanvern;6223;187;6410
53;Bretagne;29;2;07;175;Plonévez-du-Faou;2108;51;2159
53;Bretagne;29;2;09;176;Plonévez-Porzay;1784;44;1828
53;Bretagne;29;1;27;177;Plouarzel;3854;91;3945
53;Bretagne;29;1;18;178;Ploudalmézeau;6312;128;6440
53;Bretagne;29;1;15;179;Ploudaniel;3737;117;3854
53;Bretagne;29;1;21;180;Ploudiry;913;22;935
53;Bretagne;29;1;13;181;Plouédern;2944;71;3015
53;Bretagne;29;3;20;182;Plouégat-Guérand;1063;22;1085
53;Bretagne;29;3;20;183;Plouégat-Moysan;714;9;723
53;Bretagne;29;3;26;184;Plouénan;2535;57;2592
53;Bretagne;29;3;26;185;Plouescat;3497;93;3590
53;Bretagne;29;3;20;186;Plouezoc'h;1610;61;1671
53;Bretagne;29;3;14;187;Plougar;791;28;819
53;Bretagne;29;3;20;188;Plougasnou;2737;124;2861
53;Bretagne;29;1;12;189;Plougastel-Daoulas;13161;365;13526
53;Bretagne;29;1;27;190;Plougonvelin;4183;105;4288
53;Bretagne;29;3;20;191;Plougonven;3454;94;3548
53;Bretagne;29;3;26;192;Plougoulm;1761;45;1806
53;Bretagne;29;3;14;193;Plougourvest;1430;29;1459
53;Bretagne;29;1;15;195;Plouguerneau;6640;130;6770
53;Bretagne;29;1;18;196;Plouguin;2166;42;2208
53;Bretagne;29;4;10;197;Plouhinec;3951;109;4060
53;Bretagne;29;1;15;198;Plouider;1838;46;1884
53;Bretagne;29;3;20;199;Plouigneau;5086;171;5257
53;Bretagne;29;1;27;201;Ploumoguer;2119;38;2157
53;Bretagne;29;3;17;202;Plounéour-Ménez;1279;36;1315
53;Bretagne;29;3;14;204;Plounéventer;2084;35;2119
53;Bretagne;29;2;07;205;Plounévézel;1174;26;1200
53;Bretagne;29;3;26;206;Plounévez-Lochrist;2294;96;2390
53;Bretagne;29;3;20;207;Plourin-lès-Morlaix;4517;291;4808
53;Bretagne;29;1;27;208;Plourin;1245;29;1274
53;Bretagne;29;1;18;209;Plouvien;3832;104;3936
53;Bretagne;29;3;14;210;Plouvorn;2862;72;2934
53;Bretagne;29;2;07;211;Plouyé;659;18;677
53;Bretagne;29;1;03;212;Plouzané;13496;245;13741
53;Bretagne;29;3;14;213;Plouzévédé;1760;40;1800
53;Bretagne;29;4;19;214;Plovan;681;26;707
53;Bretagne;29;4;19;215;Plozévet;2948;74;3022
53;Bretagne;29;4;23;216;Pluguffan;4179;103;4282
53;Bretagne;29;4;16;217;Pont-Aven;2821;58;2879
53;Bretagne;29;4;10;218;Pont-Croix;1567;31;1598
53;Bretagne;29;4;22;220;Pont-l'Abbé;8369;395;8764
53;Bretagne;29;1;27;221;Porspoder;1779;53;1832
53;Bretagne;29;2;09;222;Port-Launay;398;7;405
53;Bretagne;29;4;10;224;Pouldergat;1213;26;1239
53;Bretagne;29;4;19;225;Pouldreuzic;2165;45;2210
53;Bretagne;29;4;10;226;Poullan-sur-Mer;1507;96;1603
53;Bretagne;29;2;07;227;Poullaouen;1480;32;1512
53;Bretagne;29;4;10;228;Primelin;657;16;673
53;Bretagne;29;4;09;229;Quéménéven;1114;34;1148
53;Bretagne;29;4;25;230;Querrien;1689;33;1722
53;Bretagne;29;4;99;232;Quimper;63283;2478;65761
53;Bretagne;29;4;25;233;Quimperlé;12220;458;12678
53;Bretagne;29;4;25;234;Rédené;2917;62;2979
53;Bretagne;29;1;12;235;Le Relecq-Kerhuon;11717;234;11951
53;Bretagne;29;4;16;236;Riec-sur-Bélon;4180;118;4298
53;Bretagne;29;1;13;237;La Roche-Maurice;1814;44;1858
53;Bretagne;29;2;09;238;Roscanvel;836;29;865
53;Bretagne;29;3;26;239;Roscoff;3489;85;3574
53;Bretagne;29;2;21;240;Rosnoën;959;26;985
53;Bretagne;29;4;08;241;Rosporden;7614;162;7776
53;Bretagne;29;2;09;243;Saint-Coulitz;456;10;466
53;Bretagne;29;3;14;244;Saint-Derrien;821;13;834
53;Bretagne;29;1;13;245;Saint-Divy;1557;21;1578
53;Bretagne;29;1;21;246;Saint-Eloy;212;5;217
53;Bretagne;29;4;11;247;Saint-Évarzec;3503;113;3616
53;Bretagne;29;1;15;248;Saint-Frégant;846;8;854
53;Bretagne;29;2;06;249;Saint-Goazec;712;10;722
53;Bretagne;29;2;07;250;Saint-Hernin;755;17;772
53;Bretagne;29;3;20;251;Saint-Jean-du-Doigt;655;12;667
53;Bretagne;29;4;19;252;Saint-Jean-Trolimon;933;25;958
53;Bretagne;29;3;17;254;Saint-Martin-des-Champs;4621;146;4767
53;Bretagne;29;1;15;255;Saint-Méen;926;20;946
53;Bretagne;29;2;09;256;Saint-Nic;760;20;780
53;Bretagne;29;1;18;257;Saint-Pabu;2069;62;2131
53;Bretagne;29;3;26;259;Saint-Pol-de-Léon;6709;244;6953
53;Bretagne;29;1;27;260;Saint-Renan;8163;195;8358
53;Bretagne;29;2;07;261;Saint-Rivoal;211;3;214
53;Bretagne;29;3;14;262;Saint-Sauveur;786;10;796
53;Bretagne;29;2;21;263;Saint-Ségal;1117;17;1134
53;Bretagne;29;3;14;264;Saint-Servais;777;11;788
53;Bretagne;29;3;17;265;Sainte-Sève;1044;31;1075
53;Bretagne;29;3;17;266;Saint-Thégonnec Loc-Eguiner;3044;78;3122
53;Bretagne;29;2;06;267;Saint-Thois;720;18;738
53;Bretagne;29;1;13;268;Saint-Thonan;1899;36;1935
53;Bretagne;29;4;25;269;Saint-Thurien;1038;15;1053
53;Bretagne;29;1;21;270;Saint-Urbain;1646;35;1681
53;Bretagne;29;3;14;271;Saint-Vougay;893;32;925
53;Bretagne;29;4;08;272;Saint-Yvi;3249;68;3317
53;Bretagne;29;3;26;273;Santec;2393;77;2470
53;Bretagne;29;4;16;274;Scaër;5295;111;5406
53;Bretagne;29;2;07;275;Scrignac;736;20;756
53;Bretagne;29;3;26;276;Sibiril;1196;29;1225
53;Bretagne;29;3;14;277;Sizun;2289;78;2367
53;Bretagne;29;2;07;278;Spézet;1758;43;1801
53;Bretagne;29;3;17;279;Taulé;2898;77;2975
53;Bretagne;29;2;09;280;Telgruc-sur-Mer;2098;60;2158
53;Bretagne;29;4;08;281;Tourch;997;27;1024
53;Bretagne;29;1;27;282;Trébabu;360;10;370
53;Bretagne;29;4;22;284;Treffiagat;2406;99;2505
53;Bretagne;29;3;26;285;Tréflaouénan;521;7;528
53;Bretagne;29;1;21;286;Tréflévénez;242;9;251
53;Bretagne;29;3;26;287;Tréflez;973;21;994
53;Bretagne;29;1;15;288;Trégarantec;611;7;618
53;Bretagne;29;2;09;289;Trégarvan;114;6;120
53;Bretagne;29;1;18;290;Tréglonou;684;15;699
53;Bretagne;29;2;06;291;Trégourez;957;18;975
53;Bretagne;29;4;19;292;Tréguennec;316;6;322
53;Bretagne;29;4;16;293;Trégunc;7064;224;7288
53;Bretagne;29;1;21;294;Le Tréhou;648;14;662
53;Bretagne;29;1;13;295;Trémaouézan;532;22;554
53;Bretagne;29;4;19;296;Tréméoc;1347;40;1387
53;Bretagne;29;4;25;297;Tréméven;2321;44;2365
53;Bretagne;29;4;19;298;Tréogat;575;11;586
53;Bretagne;29;1;27;299;Tréouergat;333;3;336
53;Bretagne;29;4;16;300;Le Trévoux;1597;51;1648
53;Bretagne;29;3;14;301;Trézilidé;392;2;394
53;Bretagne;29;2;21;302;Pont-de-Buis-lès-Quimerch;3639;136;3775
94;Corse;2A;1;08;001;Afa;3229;57;3286
94;Corse;2A;1;98;004;Ajaccio;71361;867;72228
94;Corse;2A;1;05;006;Alata;3456;69;3525
94;Corse;2A;1;11;008;Albitreccia;1771;26;1797
94;Corse;2A;4;09;011;Altagène;53;2;55
94;Corse;2A;1;10;014;Ambiegna;72;1;73
94;Corse;2A;1;08;017;Appietto;1813;37;1850
94;Corse;2A;4;09;018;Arbellara;160;2;162
94;Corse;2A;1;10;019;Arbori;55;0;55
94;Corse;2A;4;11;021;Argiusta-Moriccio;77;1;78
94;Corse;2A;1;10;022;Arro;80;0;80
94;Corse;2A;4;09;024;Aullène;187;1;188
94;Corse;2A;1;11;026;Azilone-Ampaza;187;3;190
94;Corse;2A;1;10;027;Azzana;54;0;54
94;Corse;2A;1;10;028;Balogna;145;6;151
94;Corse;2A;1;08;031;Bastelica;520;6;526
94;Corse;2A;1;05;032;Bastelicaccia;4124;109;4233
94;Corse;2A;4;09;035;Belvédère-Campomoro;161;2;163
94;Corse;2A;4;09;038;Bilia;50;1;51
94;Corse;2A;1;08;040;Bocognano;374;7;381
94;Corse;2A;4;07;041;Bonifacio;3192;55;3247
94;Corse;2A;1;10;048;Calcatoggio;499;5;504
94;Corse;2A;1;11;056;Campo;105;5;110
94;Corse;2A;1;10;060;Cannelle;71;1;72
94;Corse;2A;4;07;061;Carbini;112;1;113
94;Corse;2A;1;08;062;Carbuccia;381;9;390
94;Corse;2A;1;11;064;Cardo-Torgia;32;2;34
94;Corse;2A;1;10;065;Cargèse;1297;22;1319
94;Corse;2A;4;09;066;Cargiaca;58;0;58
94;Corse;2A;1;10;070;Casaglione;389;6;395
94;Corse;2A;4;11;071;Casalabriva;214;5;219
94;Corse;2A;1;11;085;Cauro;1493;37;1530
94;Corse;2A;1;11;089;Ciamannacce;133;0;133
94;Corse;2A;1;10;090;Coggia;679;18;697
94;Corse;2A;1;11;091;Cognocoli-Monticchi;171;1;172
94;Corse;2A;4;06;092;Conca;1145;20;1165
94;Corse;2A;1;11;094;Corrano;71;2;73
94;Corse;2A;1;11;098;Coti-Chiavari;713;9;722
94;Corse;2A;1;11;099;Cozzano;276;0;276
94;Corse;2A;1;10;100;Cristinacce;68;0;68
94;Corse;2A;1;08;103;Cuttoli-Corticchiato;2017;33;2050
94;Corse;2A;1;11;104;Eccica-Suarella;1295;36;1331
94;Corse;2A;1;10;108;Évisa;214;5;219
94;Corse;2A;4;07;114;Figari;1466;29;1495
94;Corse;2A;4;09;115;Foce;150;7;157
94;Corse;2A;1;11;117;Forciolo;81;0;81
94;Corse;2A;4;09;118;Fozzano;205;5;210
94;Corse;2A;1;11;119;Frasseto;137;3;140
94;Corse;2A;4;09;127;Giuncheto;89;2;91
94;Corse;2A;4;09;128;Granace;94;0;94
94;Corse;2A;4;09;129;Grossa;43;1;44
94;Corse;2A;1;11;130;Grosseto-Prugna;3402;55;3457
94;Corse;2A;1;10;131;Guagno;160;2;162
94;Corse;2A;1;11;132;Guargualé;148;1;149
94;Corse;2A;1;11;133;Guitera-les-Bains;151;3;154
94;Corse;2A;4;06;139;Lecci;1838;31;1869
94;Corse;2A;1;10;141;Letia;127;1;128
94;Corse;2A;4;07;142;Levie;669;13;682
94;Corse;2A;1;10;144;Lopigna;103;3;106
94;Corse;2A;4;09;146;Loreto-di-Tallano;52;1;53
94;Corse;2A;1;10;154;Marignana;107;6;113
94;Corse;2A;4;09;158;Mela;29;1;30
94;Corse;2A;4;11;160;Moca-Croce;257;2;259
94;Corse;2A;4;07;163;Monacia-d'Aullène;549;15;564
94;Corse;2A;1;10;174;Murzo;100;3;103
94;Corse;2A;1;08;181;Ocana;629;17;646
94;Corse;2A;1;11;186;Olivese;221;1;222
94;Corse;2A;4;09;189;Olmeto;1218;30;1248
94;Corse;2A;4;09;191;Olmiccia;121;3;124
94;Corse;2A;1;10;196;Orto;51;1;52
94;Corse;2A;1;10;197;Osani;99;0;99
94;Corse;2A;1;10;198;Ota;539;11;550
94;Corse;2A;1;11;200;Palneca;143;3;146
94;Corse;2A;1;10;203;Partinello;97;0;97
94;Corse;2A;1;10;204;Pastricciola;96;1;97
94;Corse;2A;1;08;209;Peri;2015;33;2048
94;Corse;2A;4;11;211;Petreto-Bicchisano;563;17;580
94;Corse;2A;1;10;212;Piana;468;9;477
94;Corse;2A;4;07;215;Pianottoli-Caldarello;910;7;917
94;Corse;2A;1;11;228;Pietrosella;1859;19;1878
94;Corse;2A;1;11;232;Pila-Canale;280;3;283
94;Corse;2A;1;10;240;Poggiolo;113;0;113
94;Corse;2A;4;99;247;Porto-Vecchio;11132;180;11312
94;Corse;2A;4;09;249;Propriano;3699;40;3739
94;Corse;2A;1;11;253;Quasquara;51;0;51
94;Corse;2A;4;09;254;Quenza;200;4;204
94;Corse;2A;1;10;258;Renno;60;4;64
94;Corse;2A;1;10;259;Rezza;62;1;63
94;Corse;2A;1;10;262;Rosazia;49;3;52
94;Corse;2A;1;10;266;Salice;89;4;93
94;Corse;2A;1;11;268;Sampolo;80;0;80
94;Corse;2A;4;06;269;Sari-Solenzara;1392;32;1424
94;Corse;2A;1;10;270;Sari-d'Orcino;344;3;347
94;Corse;2A;1;08;271;Sarrola-Carcopino;3289;52;3341
94;Corse;2A;4;09;272;Sartène;3248;124;3372
94;Corse;2A;1;11;276;Serra-di-Ferro;489;12;501
94;Corse;2A;4;09;278;Serra-di-Scopamène;83;3;86
94;Corse;2A;1;10;279;Serriera;122;0;122
94;Corse;2A;1;10;282;Soccia;148;4;152
94;Corse;2A;4;11;284;Sollacaro;374;5;379
94;Corse;2A;4;09;285;Sorbollano;76;0;76
94;Corse;2A;4;07;288;Sotta;1401;24;1425
94;Corse;2A;1;10;295;Sant'Andréa-d'Orcino;116;0;116
94;Corse;2A;4;06;300;San-Gavino-di-Carbini;1088;21;1109
94;Corse;2A;4;09;308;Sainte-Lucie-de-Tallano;383;7;390
94;Corse;2A;4;09;310;Santa-Maria-Figaniella;102;0;102
94;Corse;2A;1;11;312;Santa-Maria-Siché;404;9;413
94;Corse;2A;1;11;322;Tasso;95;0;95
94;Corse;2A;1;08;323;Tavaco;402;7;409
94;Corse;2A;1;08;324;Tavera;399;4;403
94;Corse;2A;1;08;326;Tolla;122;0;122
94;Corse;2A;1;08;330;Ucciani;501;2;503
94;Corse;2A;1;11;331;Urbalacone;61;0;61
94;Corse;2A;1;08;336;Valle-di-Mezzana;512;11;523
94;Corse;2A;1;08;345;Vero;598;4;602
94;Corse;2A;1;10;348;Vico;889;14;903
94;Corse;2A;4;09;349;Viggianello;846;18;864
94;Corse;2A;1;05;351;Villanova;389;5;394
94;Corse;2A;4;09;357;Zérubia;50;3;53
94;Corse;2A;1;11;358;Zévaco;54;1;55
94;Corse;2A;1;11;359;Zicavo;225;2;227
94;Corse;2A;1;11;360;Zigliara;129;5;134
94;Corse;2A;4;06;362;Zonza;2759;35;2794
94;Corse;2A;4;09;363;Zoza;62;0;62
94;Corse;2B;3;13;002;Aghione;240;4;244
94;Corse;2B;3;14;003;Aiti;25;0;25
94;Corse;2B;3;14;005;Alando;29;2;31
94;Corse;2B;3;14;007;Albertacce;206;3;209
94;Corse;2B;3;13;009;Aléria;2185;26;2211
94;Corse;2B;5;07;010;Algajola;354;6;360
94;Corse;2B;3;13;012;Altiani;50;0;50
94;Corse;2B;3;14;013;Alzi;25;0;25
94;Corse;2B;3;13;015;Ampriani;25;0;25
94;Corse;2B;3;13;016;Antisanti;551;0;551
94;Corse;2B;5;07;020;Aregno;598;15;613
94;Corse;2B;3;14;023;Asco;115;2;117
94;Corse;2B;5;07;025;Avapessa;84;2;86
94;Corse;2B;5;05;029;Barbaggio;294;3;297
94;Corse;2B;2;08;030;Barrettali;132;4;136
94;Corse;2B;2;99;033;Bastia;48503;695;49198
94;Corse;2B;5;15;034;Belgodère;671;9;680
94;Corse;2B;3;14;036;Bigorno;88;0;88
94;Corse;2B;2;05;037;Biguglia;7810;126;7936
94;Corse;2B;3;14;039;Bisinchi;225;2;227
94;Corse;2B;2;06;042;Borgo;8832;141;8973
94;Corse;2B;2;08;043;Brando;1624;40;1664
94;Corse;2B;3;14;045;Bustanico;66;0;66
94;Corse;2B;2;08;046;Cagnano;155;3;158
94;Corse;2B;3;14;047;Calacuccia;272;3;275
94;Corse;2B;5;07;049;Calenzana;2461;29;2490
94;Corse;2B;5;07;050;Calvi;5774;82;5856
94;Corse;2B;3;14;051;Cambia;73;0;73
94;Corse;2B;3;10;052;Campana;20;0;20
94;Corse;2B;3;13;053;Campi;19;2;21
94;Corse;2B;3;14;054;Campile;188;4;192
94;Corse;2B;3;14;055;Campitello;121;1;122
94;Corse;2B;3;10;057;Canale-di-Verde;317;10;327
94;Corse;2B;2;08;058;Canari;318;1;319
94;Corse;2B;3;14;059;Canavaggia;108;1;109
94;Corse;2B;3;10;063;Carcheto-Brustico;30;1;31
94;Corse;2B;3;10;067;Carpineto;34;0;34
94;Corse;2B;3;14;068;Carticasi;26;0;26
94;Corse;2B;3;09;069;Casabianca;105;1;106
94;Corse;2B;3;09;072;Casalta;54;1;55
94;Corse;2B;3;14;073;Casamaccioli;107;0;107
94;Corse;2B;3;11;074;Casanova;404;6;410
94;Corse;2B;3;13;075;Casevecchie;70;2;72
94;Corse;2B;3;09;077;Castellare-di-Casinca;696;5;701
94;Corse;2B;3;14;078;Castellare-di-Mercurio;28;1;29
94;Corse;2B;3;14;079;Castello-di-Rostino;490;1;491
94;Corse;2B;3;14;080;Castifao;142;1;143
94;Corse;2B;3;14;081;Castiglione;42;0;42
94;Corse;2B;3;14;082;Castineta;40;1;41
94;Corse;2B;3;14;083;Castirla;159;2;161
94;Corse;2B;5;07;084;Cateri;234;1;235
94;Corse;2B;2;08;086;Centuri;189;1;190
94;Corse;2B;3;10;087;Cervione;2199;26;2225
94;Corse;2B;3;10;088;Chiatra;209;5;214
94;Corse;2B;5;15;093;Corbara;895;32;927
94;Corse;2B;3;14;095;Corscia;128;3;131
94;Corse;2B;3;11;096;Corte;7485;117;7602
94;Corse;2B;5;15;097;Costa;55;1;56
94;Corse;2B;3;09;101;Croce;80;3;83
94;Corse;2B;3;14;102;Crocicchia;77;0;77
94;Corse;2B;3;14;105;Erbajolo;116;0;116
94;Corse;2B;3;14;106;Érone;12;0;12
94;Corse;2B;2;08;107;Ersa;155;1;156
94;Corse;2B;5;08;109;Farinole;235;2;237
94;Corse;2B;3;14;110;Favalello;70;1;71
94;Corse;2B;3;10;111;Felce;51;0;51
94;Corse;2B;5;15;112;Feliceto;232;4;236
94;Corse;2B;3;09;113;Ficaja;56;1;57
94;Corse;2B;3;14;116;Focicchia;28;1;29
94;Corse;2B;2;04;120;Furiani;5608;127;5735
94;Corse;2B;5;07;121;Galéria;361;5;366
94;Corse;2B;3;14;122;Gavignano;57;0;57
94;Corse;2B;3;13;123;Ghisonaccia;4219;55;4274
94;Corse;2B;3;12;124;Ghisoni;210;6;216
94;Corse;2B;3;09;125;Giocatojo;54;0;54
94;Corse;2B;3;13;126;Giuncaggio;69;0;69
94;Corse;2B;5;15;134;L'Île-Rousse;3163;72;3235
94;Corse;2B;3;12;135;Isolaccio-di-Fiumorbo;307;2;309
94;Corse;2B;5;15;136;Lama;146;2;148
94;Corse;2B;3;14;137;Lano;23;0;23
94;Corse;2B;5;07;138;Lavatoggio;149;2;151
94;Corse;2B;3;14;140;Lento;102;0;102
94;Corse;2B;3;13;143;Linguizzetta;1104;8;1112
94;Corse;2B;3;09;145;Loreto-di-Casinca;209;6;215
94;Corse;2B;3;14;147;Lozzi;113;2;115
94;Corse;2B;2;06;148;Lucciana;6007;51;6058
94;Corse;2B;3;12;149;Lugo-di-Nazza;82;1;83
94;Corse;2B;5;07;150;Lumio;1260;38;1298
94;Corse;2B;2;08;152;Luri;848;9;857
94;Corse;2B;5;07;153;Manso;117;2;119
94;Corse;2B;3;13;155;Matra;47;0;47
94;Corse;2B;5;15;156;Mausoléo;23;0;23
94;Corse;2B;3;14;157;Mazzola;29;0;29
94;Corse;2B;2;08;159;Meria;81;1;82
94;Corse;2B;3;13;161;Moïta;65;0;65
94;Corse;2B;3;14;162;Moltifao;703;11;714
94;Corse;2B;3;10;164;Monacia-d'Orezza;23;0;23
94;Corse;2B;5;07;165;Moncale;332;6;338
94;Corse;2B;3;14;166;Monte;632;5;637
94;Corse;2B;5;07;167;Montegrosso;425;14;439
94;Corse;2B;5;15;168;Monticello;1972;42;2014
94;Corse;2B;3;14;169;Morosaglia;981;10;991
94;Corse;2B;2;08;170;Morsiglia;109;2;111
94;Corse;2B;3;11;171;Muracciole;34;1;35
94;Corse;2B;5;05;172;Murato;577;7;584
94;Corse;2B;5;15;173;Muro;253;3;256
94;Corse;2B;5;15;175;Nessa;108;2;110
94;Corse;2B;3;10;176;Nocario;73;2;75
94;Corse;2B;3;12;177;Noceta;59;2;61
94;Corse;2B;2;08;178;Nonza;75;2;77
94;Corse;2B;3;10;179;Novale;64;0;64
94;Corse;2B;5;15;180;Novella;78;1;79
94;Corse;2B;5;15;182;Occhiatana;256;2;258
94;Corse;2B;2;08;183;Ogliastro;94;2;96
94;Corse;2B;2;08;184;Olcani;89;1;90
94;Corse;2B;5;05;185;Oletta;1781;14;1795
94;Corse;2B;2;08;187;Olmeta-di-Capocorso;133;1;134
94;Corse;2B;5;05;188;Olmeta-di-Tuda;533;9;542
94;Corse;2B;5;15;190;Olmi-Cappella;183;5;188
94;Corse;2B;3;14;192;Olmo;151;1;152
94;Corse;2B;3;14;193;Omessa;601;3;604
94;Corse;2B;3;10;194;Ortale;26;0;26
94;Corse;2B;3;14;195;Ortiporio;124;1;125
94;Corse;2B;5;15;199;Palasca;184;5;189
94;Corse;2B;3;13;201;Pancheraccia;197;1;198
94;Corse;2B;3;10;202;Parata;23;0;23
94;Corse;2B;5;08;205;Patrimonio;876;12;888
94;Corse;2B;3;14;206;Penta-Acquatella;37;0;37
94;Corse;2B;3;09;207;Penta-di-Casinca;3370;40;3410
94;Corse;2B;3;10;208;Perelli;108;0;108
94;Corse;2B;3;09;210;Pero-Casevecchie;117;0;117
94;Corse;2B;3;13;213;Pianello;63;0;63
94;Corse;2B;3;09;214;Piano;22;0;22
94;Corse;2B;3;10;216;Piazzali;19;0;19
94;Corse;2B;3;10;217;Piazzole;41;3;44
94;Corse;2B;3;13;218;Piedicorte-di-Gaggio;98;3;101
94;Corse;2B;3;10;219;Piedicroce;82;1;83
94;Corse;2B;3;14;220;Piedigriggio;133;3;136
94;Corse;2B;3;10;221;Piedipartino;16;0;16
94;Corse;2B;3;10;222;Pie-d'Orezza;38;0;38
94;Corse;2B;5;14;223;Pietralba;502;3;505
94;Corse;2B;2;08;224;Pietracorbara;654;11;665
94;Corse;2B;3;10;225;Pietra-di-Verde;100;2;102
94;Corse;2B;3;13;226;Pietraserena;59;1;60
94;Corse;2B;3;10;227;Pietricaggio;34;1;35
94;Corse;2B;3;12;229;Pietroso;350;0;350
94;Corse;2B;5;05;230;Piève;109;5;114
94;Corse;2B;5;15;231;Pigna;105;6;111
94;Corse;2B;2;08;233;Pino;167;2;169
94;Corse;2B;3;10;234;Piobetta;18;0;18
94;Corse;2B;5;15;235;Pioggiola;84;0;84
94;Corse;2B;3;12;236;Poggio-di-Nazza;181;3;184
94;Corse;2B;3;11;238;Poggio-di-Venaco;210;8;218
94;Corse;2B;5;05;239;Poggio-d'Oletta;214;11;225
94;Corse;2B;3;09;241;Poggio-Marinaccio;31;1;32
94;Corse;2B;3;10;242;Poggio-Mezzana;697;13;710
94;Corse;2B;3;09;243;Polveroso;42;0;42
94;Corse;2B;3;14;244;Popolasca;42;0;42
94;Corse;2B;3;09;245;Porri;42;1;43
94;Corse;2B;3;09;246;La Porta;191;1;192
94;Corse;2B;3;14;248;Prato-di-Giovellina;42;1;43
94;Corse;2B;3;14;250;Prunelli-di-Casacconi;150;0;150
94;Corse;2B;3;12;251;Prunelli-di-Fiumorbo;3667;40;3707
94;Corse;2B;3;09;252;Pruno;183;2;185
94;Corse;2B;3;09;255;Quercitello;42;0;42
94;Corse;2B;3;10;256;Rapaggio;26;0;26
94;Corse;2B;5;05;257;Rapale;158;0;158
94;Corse;2B;3;11;260;Riventosa;156;3;159
94;Corse;2B;2;08;261;Rogliano;538;11;549
94;Corse;2B;3;12;263;Rospigliani;69;5;74
94;Corse;2B;3;14;264;Rusio;62;1;63
94;Corse;2B;5;05;265;Rutali;360;6;366
94;Corse;2B;3;14;267;Saliceto;45;3;48
94;Corse;2B;3;09;273;Scata;44;5;49
94;Corse;2B;3;14;274;Scolca;93;1;94
94;Corse;2B;3;14;275;Sermano;71;2;73
94;Corse;2B;3;12;277;Serra-di-Fiumorbo;337;3;340
94;Corse;2B;3;09;280;Silvareccio;114;0;114
94;Corse;2B;2;08;281;Sisco;1157;9;1166
94;Corse;2B;3;12;283;Solaro;722;13;735
94;Corse;2B;3;09;286;Sorbo-Ocagnano;873;8;881
94;Corse;2B;5;05;287;Sorio;142;0;142
94;Corse;2B;3;14;289;Soveria;117;0;117
94;Corse;2B;5;15;290;Speloncato;285;4;289
94;Corse;2B;3;10;291;Stazzona;34;1;35
94;Corse;2B;3;14;292;Sant'Andréa-di-Bozio;71;2;73
94;Corse;2B;3;10;293;Sant'Andréa-di-Cotone;210;2;212
94;Corse;2B;5;07;296;Sant'Antonino;134;5;139
94;Corse;2B;3;09;297;San-Damiano;57;0;57
94;Corse;2B;5;05;298;Saint-Florent;1681;19;1700
94;Corse;2B;3;09;299;San-Gavino-d'Ampugnani;105;1;106
94;Corse;2B;5;05;301;San-Gavino-di-Tenda;57;1;58
94;Corse;2B;3;10;302;San-Giovanni-di-Moriani;91;2;93
94;Corse;2B;3;10;303;San-Giuliano;755;6;761
94;Corse;2B;3;14;304;San-Lorenzo;143;0;143
94;Corse;2B;2;08;305;San-Martino-di-Lota;2913;42;2955
94;Corse;2B;3;14;306;Santa-Lucia-di-Mercurio;119;0;119
94;Corse;2B;3;10;307;Santa-Lucia-di-Moriani;1490;29;1519
94;Corse;2B;2;08;309;Santa-Maria-di-Lota;1888;86;1974
94;Corse;2B;3;10;311;Santa-Maria-Poggio;781;11;792
94;Corse;2B;3;10;313;San-Nicolao;2027;22;2049
94;Corse;2B;5;05;314;Santo-Pietro-di-Tenda;346;1;347
94;Corse;2B;3;11;315;Santo-Pietro-di-Venaco;281;5;286
94;Corse;2B;5;15;316;Santa-Reparata-di-Balagna;990;15;1005
94;Corse;2B;3;10;317;Santa-Reparata-di-Moriani;60;0;60
94;Corse;2B;3;09;318;Taglio-Isolaccio;583;12;595
94;Corse;2B;3;09;319;Talasani;796;7;803
94;Corse;2B;3;13;320;Tallone;282;2;284
94;Corse;2B;3;10;321;Tarrano;16;0;16
94;Corse;2B;2;08;327;Tomino;188;3;191
94;Corse;2B;3;13;328;Tox;96;0;96
94;Corse;2B;3;14;329;Tralonca;110;1;111
94;Corse;2B;5;15;332;Urtaca;231;3;234
94;Corse;2B;5;05;333;Vallecalle;138;3;141
94;Corse;2B;3;10;334;Valle-d'Alesani;107;1;108
94;Corse;2B;3;10;335;Valle-di-Campoloro;353;7;360
94;Corse;2B;3;14;337;Valle-di-Rostino;128;0;128
94;Corse;2B;3;10;338;Valle-d'Orezza;29;0;29
94;Corse;2B;5;15;339;Vallica;28;0;28
94;Corse;2B;3;10;340;Velone-Orneto;123;0;123
94;Corse;2B;3;11;341;Venaco;713;17;730
94;Corse;2B;3;12;342;Ventiseri;2512;46;2558
94;Corse;2B;3;09;343;Venzolasca;1795;14;1809
94;Corse;2B;3;10;344;Verdèse;42;2;44
94;Corse;2B;3;09;346;Vescovato;2851;32;2883
94;Corse;2B;3;12;347;Vezzani;266;0;266
94;Corse;2B;2;06;350;Vignale;195;4;199
94;Corse;2B;5;15;352;Ville-di-Paraso;209;5;214
94;Corse;2B;2;01;353;Ville-di-Pietrabugno;3328;87;3415
94;Corse;2B;3;11;354;Vivario;428;5;433
94;Corse;2B;3;14;355;Volpajola;358;7;365
94;Corse;2B;3;13;356;Zalana;144;1;145
94;Corse;2B;5;07;361;Zilia;289;5;294
94;Corse;2B;3;13;364;Zuani;34;0;34
94;Corse;2B;3;12;365;San-Gavino-di-Fiumorbo;104;2;106
94;Corse;2B;3;12;366;Chisa;102;2;104
76;Occitanie;30;2;20;001;Aigaliers;518;13;531
76;Occitanie;30;3;15;002;Aigremont;777;15;792
76;Occitanie;30;2;01;003;Aigues-Mortes;8560;80;8640
76;Occitanie;30;2;21;004;Aigues-Vives;3338;62;3400
76;Occitanie;30;2;14;005;Aiguèze;215;3;218
76;Occitanie;30;2;01;006;Aimargues;5717;53;5770
76;Occitanie;30;1;98;007;Alès;41837;615;42452
76;Occitanie;30;1;18;008;Allègre-les-Fumades;953;17;970
76;Occitanie;30;3;22;009;Alzon;172;3;175
76;Occitanie;30;1;02;010;Anduze;3327;41;3368
76;Occitanie;30;2;23;011;Les Angles;8476;205;8681
76;Occitanie;30;2;06;012;Aramon;4219;76;4295
76;Occitanie;30;2;16;013;Argilliers;456;21;477
76;Occitanie;30;2;20;014;Arpaillargues-et-Aureillac;1022;27;1049
76;Occitanie;30;3;22;015;Arphy;152;5;157
76;Occitanie;30;3;22;016;Arre;288;10;298
76;Occitanie;30;3;22;017;Arrigas;210;2;212
76;Occitanie;30;2;07;018;Aspères;514;13;527
76;Occitanie;30;2;01;019;Aubais;2895;60;2955
76;Occitanie;30;2;21;020;Aubord;2363;43;2406
76;Occitanie;30;2;20;021;Aubussargues;321;4;325
76;Occitanie;30;1;08;022;Aujac;179;7;186
76;Occitanie;30;2;07;023;Aujargues;787;16;803
76;Occitanie;30;3;22;024;Aulas;456;7;463
76;Occitanie;30;3;22;025;Aumessas;230;3;233
76;Occitanie;30;3;22;026;Avèze;1075;33;1108
76;Occitanie;30;1;02;027;Bagard;2556;59;2615
76;Occitanie;30;2;05;028;Bagnols-sur-Cèze;18091;358;18449
76;Occitanie;30;1;18;029;Barjac;1620;26;1646
76;Occitanie;30;2;20;030;Baron;368;4;372
76;Occitanie;30;2;20;031;La Bastide-d'Engras;200;2;202
76;Occitanie;30;2;06;032;Beaucaire;15906;139;16045
76;Occitanie;30;2;21;033;Beauvoisin;5104;55;5159
76;Occitanie;30;2;06;034;Bellegarde;7353;85;7438
76;Occitanie;30;2;03;035;Belvézet;239;1;240
76;Occitanie;30;2;21;036;Bernis;3421;27;3448
76;Occitanie;30;1;18;037;Bessèges;2835;34;2869
76;Occitanie;30;3;22;038;Bez-et-Esparon;328;11;339
76;Occitanie;30;2;16;039;Bezouce;2304;31;2335
76;Occitanie;30;3;22;040;Blandas;129;2;131
76;Occitanie;30;2;20;041;Blauzac;1237;21;1258
76;Occitanie;30;1;02;042;Boisset-et-Gaujac;2552;44;2596
76;Occitanie;30;2;07;043;Boissières;581;11;592
76;Occitanie;30;1;08;044;Bonnevaux;90;0;90
76;Occitanie;30;1;18;045;Bordezac;390;4;394
76;Occitanie;30;1;15;046;Boucoiran-et-Nozières;981;14;995
76;Occitanie;30;2;09;047;Bouillargues;6272;135;6407
76;Occitanie;30;2;03;048;Bouquet;175;3;178
76;Occitanie;30;2;20;049;Bourdic;374;17;391
76;Occitanie;30;3;15;050;Bragassargues;170;1;171
76;Occitanie;30;1;08;051;Branoux-les-Taillades;1338;30;1368
76;Occitanie;30;3;22;052;Bréau-Mars;643;18;661
76;Occitanie;30;1;15;053;Brignon;787;12;799
76;Occitanie;30;3;15;054;Brouzet-lès-Quissac;301;4;305
76;Occitanie;30;1;03;055;Brouzet-lès-Alès;671;12;683
76;Occitanie;30;2;20;056;La Bruguière;331;7;338
76;Occitanie;30;2;16;057;Cabrières;1698;29;1727
76;Occitanie;30;3;22;058;La Cadière-et-Cambo;212;10;222
76;Occitanie;30;2;01;059;Le Cailar;2418;28;2446
76;Occitanie;30;2;09;060;Caissargues;4150;81;4231
76;Occitanie;30;2;20;061;La Calmette;2363;27;2390
76;Occitanie;30;2;07;062;Calvisson;5898;99;5997
76;Occitanie;30;3;22;064;Campestre-et-Luc;122;2;124
76;Occitanie;30;3;15;065;Canaules-et-Argentières;466;4;470
76;Occitanie;30;2;07;066;Cannes-et-Clairan;533;12;545
76;Occitanie;30;2;20;067;La Capelle-et-Masmolène;412;6;418
76;Occitanie;30;3;15;068;Cardet;900;22;922
76;Occitanie;30;3;15;069;Carnas;504;12;516
76;Occitanie;30;2;14;070;Carsan;750;24;774
76;Occitanie;30;3;15;071;Cassagnoles;395;2;397
76;Occitanie;30;1;04;072;Castelnau-Valence;465;10;475
76;Occitanie;30;2;16;073;Castillon-du-Gard;1672;87;1759
76;Occitanie;30;3;22;074;Causse-Bégon;24;0;24
76;Occitanie;30;2;19;075;Caveirac;4308;112;4420
76;Occitanie;30;2;05;076;Cavillargues;854;29;883
76;Occitanie;30;1;08;077;Cendras;1715;34;1749
76;Occitanie;30;1;08;079;Chambon;261;6;267
76;Occitanie;30;1;08;080;Chamborigaud;876;5;881
76;Occitanie;30;2;05;081;Chusclan;964;29;993
76;Occitanie;30;2;19;082;Clarensac;4209;96;4305
76;Occitanie;30;2;21;083;Codognan;2418;38;2456
76;Occitanie;30;2;17;084;Codolet;618;11;629
76;Occitanie;30;2;16;085;Collias;1065;15;1080
76;Occitanie;30;2;20;086;Collorgues;634;10;644
76;Occitanie;30;3;15;087;Colognac;228;6;234
76;Occitanie;30;2;07;088;Combas;635;15;650
76;Occitanie;30;2;06;089;Comps;1756;31;1787
76;Occitanie;30;1;08;090;Concoules;262;4;266
76;Occitanie;30;2;07;091;Congénies;1667;34;1701
76;Occitanie;30;2;05;092;Connaux;1692;49;1741
76;Occitanie;30;3;22;093;Conqueyrac;95;2;97
76;Occitanie;30;1;08;094;Corbès;146;1;147
76;Occitanie;30;3;15;095;Corconne;587;12;599
76;Occitanie;30;2;14;096;Cornillon;949;21;970
76;Occitanie;30;1;18;097;Courry;279;5;284
76;Occitanie;30;2;07;098;Crespian;435;4;439
76;Occitanie;30;3;15;099;Cros;241;8;249
76;Occitanie;30;1;15;100;Cruviers-Lascours;700;9;709
76;Occitanie;30;1;04;101;Deaux;651;16;667
76;Occitanie;30;2;20;102;Dions;543;9;552
76;Occitanie;30;2;16;103;Domazan;939;11;950
76;Occitanie;30;2;15;104;Domessargues;743;18;761
76;Occitanie;30;3;22;105;Dourbies;139;5;144
76;Occitanie;30;3;15;106;Durfort-et-Saint-Martin-de-Sossenac;728;17;745
76;Occitanie;30;2;16;107;Estézargues;601;12;613
76;Occitanie;30;3;22;108;L'Estréchure;157;5;162
76;Occitanie;30;1;04;109;Euzet;466;7;473
76;Occitanie;30;2;20;110;Flaux;379;9;388
76;Occitanie;30;2;20;111;Foissac;438;9;447
76;Occitanie;30;2;07;112;Fons;1593;15;1608
76;Occitanie;30;2;03;113;Fons-sur-Lussan;237;3;240
76;Occitanie;30;2;07;114;Fontanès;685;10;695
76;Occitanie;30;2;20;115;Fontarèches;252;8;260
76;Occitanie;30;2;16;116;Fournès;1077;12;1089
76;Occitanie;30;2;06;117;Fourques;2796;56;2852
76;Occitanie;30;3;15;119;Fressac;157;5;162
76;Occitanie;30;1;18;120;Gagnières;1084;15;1099
76;Occitanie;30;3;15;121;Gailhan;250;4;254
76;Occitanie;30;2;07;122;Gajan;705;13;718
76;Occitanie;30;2;01;123;Gallargues-le-Montueux;3632;102;3734
76;Occitanie;30;2;14;124;Le Garn;214;2;216
76;Occitanie;30;2;09;125;Garons;4940;50;4990
76;Occitanie;30;2;20;126;Garrigues-Sainte-Eulalie;731;18;749
76;Occitanie;30;2;05;127;Gaujac;1079;26;1105
76;Occitanie;30;2;19;128;Générac;4071;68;4139
76;Occitanie;30;1;02;129;Générargues;694;20;714
76;Occitanie;30;1;08;130;Génolhac;826;20;846
76;Occitanie;30;2;14;131;Goudargues;1106;33;1139
76;Occitanie;30;1;08;132;La Grand-Combe;4998;96;5094
76;Occitanie;30;2;01;133;Le Grau-du-Roi;8419;73;8492
76;Occitanie;30;2;14;134;Issirac;309;4;313
76;Occitanie;30;2;06;135;Jonquières-Saint-Vincent;3850;39;3889
76;Occitanie;30;2;07;136;Junas;1129;17;1146
76;Occitanie;30;1;08;137;Lamelouze;137;3;140
76;Occitanie;30;2;19;138;Langlade;2222;55;2277
76;Occitanie;30;3;22;139;Lanuéjols;350;23;373
76;Occitanie;30;3;22;140;Lasalle;1106;11;1117
76;Occitanie;30;2;17;141;Laudun-l'Ardoise;6331;118;6449
76;Occitanie;30;1;08;142;Laval-Pradel;1133;22;1155
76;Occitanie;30;2;14;143;Laval-Saint-Roman;213;5;218
76;Occitanie;30;2;07;144;Lecques;462;9;471
76;Occitanie;30;2;16;145;Lédenon;1620;25;1645
76;Occitanie;30;3;15;146;Lédignan;1481;24;1505
76;Occitanie;30;1;15;147;Lézan;1512;27;1539
76;Occitanie;30;3;15;148;Liouc;323;7;330
76;Occitanie;30;2;17;149;Lirac;927;20;947
76;Occitanie;30;3;15;150;Logrian-Florian;264;6;270
76;Occitanie;30;2;03;151;Lussan;503;7;510
76;Occitanie;30;1;18;152;Les Mages;2044;34;2078
76;Occitanie;30;1;08;153;Malons-et-Elze;125;0;125
76;Occitanie;30;3;22;154;Mandagout;399;7;406
76;Occitanie;30;2;09;155;Manduel;6943;97;7040
76;Occitanie;30;2;09;156;Marguerittes;8656;164;8820
76;Occitanie;30;1;04;158;Martignargues;432;9;441
76;Occitanie;30;1;18;159;Le Martinet;741;5;746
76;Occitanie;30;3;15;160;Maruéjols-lès-Gardon;261;4;265
76;Occitanie;30;1;15;161;Massanes;201;6;207
76;Occitanie;30;1;15;162;Massillargues-Attuech;667;15;682
76;Occitanie;30;2;15;163;Mauressargues;170;6;176
76;Occitanie;30;1;18;164;Méjannes-le-Clap;716;14;730
76;Occitanie;30;1;04;165;Méjannes-lès-Alès;1195;35;1230
76;Occitanie;30;2;16;166;Meynes;2503;151;2654
76;Occitanie;30;1;18;167;Meyrannes;794;16;810
76;Occitanie;30;1;08;168;Mialet;619;17;636
76;Occitanie;30;2;19;169;Milhaud;5721;134;5855
76;Occitanie;30;3;22;170;Molières-Cavaillac;924;31;955
76;Occitanie;30;1;18;171;Molières-sur-Cèze;1219;12;1231
76;Occitanie;30;3;15;172;Monoblet;758;8;766
76;Occitanie;30;1;03;173;Mons;1725;32;1757
76;Occitanie;30;2;20;174;Montaren-et-Saint-Médiers;1403;37;1440
76;Occitanie;30;2;14;175;Montclus;194;1;195
76;Occitanie;30;3;22;176;Montdardier;195;3;198
76;Occitanie;30;1;04;177;Monteils;656;10;666
76;Occitanie;30;2;17;178;Montfaucon;1521;38;1559
76;Occitanie;30;2;16;179;Montfrin;3163;52;3215
76;Occitanie;30;2;07;180;Montignargues;578;9;587
76;Occitanie;30;2;07;181;Montmirat;458;5;463
76;Occitanie;30;2;07;182;Montpezat;1367;22;1389
76;Occitanie;30;2;15;183;Moulézan;665;4;669
76;Occitanie;30;2;15;184;Moussac;1523;12;1535
76;Occitanie;30;2;21;185;Mus;1431;19;1450
76;Occitanie;30;2;07;186;Nages-et-Solorgues;1921;51;1972
76;Occitanie;30;1;18;187;Navacelles;305;8;313
76;Occitanie;30;1;15;188;Ners;710;13;723
76;Occitanie;30;2;99;189;Nîmes;148561;2225;150786
76;Occitanie;30;2;05;191;Orsan;1186;28;1214
76;Occitanie;30;3;15;192;Orthoux-Sérignac-Quilhan;429;12;441
76;Occitanie;30;2;07;193;Parignargues;694;6;700
76;Occitanie;30;1;18;194;Peyremale;280;2;282
76;Occitanie;30;3;22;195;Peyrolles;34;3;37
76;Occitanie;30;2;05;196;Le Pin;454;11;465
76;Occitanie;30;1;03;197;Les Plans;273;8;281
76;Occitanie;30;3;22;198;Les Plantiers;259;6;265
76;Occitanie;30;3;22;199;Pommiers;55;1;56
76;Occitanie;30;3;22;200;Pompignan;957;14;971
76;Occitanie;30;1;08;201;Ponteils-et-Brésis;369;6;375
76;Occitanie;30;2;14;202;Pont-Saint-Esprit;10369;192;10561
76;Occitanie;30;1;08;203;Portes;334;8;342
76;Occitanie;30;1;18;204;Potelières;363;5;368
76;Occitanie;30;2;20;205;Pougnadoresse;249;4;253
76;Occitanie;30;2;09;206;Poulx;4131;121;4252
76;Occitanie;30;2;16;207;Pouzilhac;733;6;739
76;Occitanie;30;3;15;208;Puechredon;45;0;45
76;Occitanie;30;2;23;209;Pujaut;3921;131;4052
76;Occitanie;30;3;15;210;Quissac;3299;33;3332
76;Occitanie;30;2;16;211;Redessan;4097;58;4155
76;Occitanie;30;2;16;212;Remoulins;2259;43;2302
76;Occitanie;30;3;22;213;Revens;20;0;20
76;Occitanie;30;1;02;214;Ribaute-les-Tavernes;2113;48;2161
76;Occitanie;30;1;18;215;Rivières;391;3;394
76;Occitanie;30;1;18;216;Robiac-Rochessadoule;823;15;838
76;Occitanie;30;2;23;217;Rochefort-du-Gard;7629;185;7814
76;Occitanie;30;1;18;218;Rochegude;257;3;260
76;Occitanie;30;3;22;219;Rogues;106;2;108
76;Occitanie;30;3;22;220;Roquedur;260;6;266
76;Occitanie;30;2;17;221;Roquemaure;5545;66;5611
76;Occitanie;30;2;14;222;La Roque-sur-Cèze;179;7;186
76;Occitanie;30;1;18;223;Rousson;4251;114;4365
76;Occitanie;30;2;07;224;La Rouvière;607;15;622
76;Occitanie;30;2;05;225;Sabran;1628;53;1681
76;Occitanie;30;2;14;226;Saint-Alexandre;1242;26;1268
76;Occitanie;30;1;18;227;Saint-Ambroix;3351;40;3391
76;Occitanie;30;2;20;228;Sainte-Anastasie;1722;33;1755
76;Occitanie;30;3;22;229;Saint-André-de-Majencoules;599;9;608
76;Occitanie;30;2;14;230;Saint-André-de-Roquepertuis;589;9;598
76;Occitanie;30;3;22;231;Saint-André-de-Valborgne;364;11;375
76;Occitanie;30;2;14;232;Saint-André-d'Olérargues;435;14;449
76;Occitanie;30;2;07;233;Saint-Bauzély;656;10;666
76;Occitanie;30;3;15;234;Saint-Bénézet;284;7;291
76;Occitanie;30;2;16;235;Saint-Bonnet-du-Gard;853;12;865
76;Occitanie;30;1;08;236;Saint-Bonnet-de-Salendrinque;117;3;120
76;Occitanie;30;1;18;237;Saint-Brès;651;12;663
76;Occitanie;30;3;22;238;Saint-Bresson;62;0;62
76;Occitanie;30;1;08;239;Sainte-Cécile-d'Andorge;594;3;597
76;Occitanie;30;1;04;240;Saint-Césaire-de-Gauzignan;386;4;390
76;Occitanie;30;2;20;241;Saint-Chaptes;1915;30;1945
76;Occitanie;30;2;14;242;Saint-Christol-de-Rodières;162;2;164
76;Occitanie;30;1;02;243;Saint-Christol-lez-Alès;7055;182;7237
76;Occitanie;30;2;07;244;Saint-Clément;359;6;365
76;Occitanie;30;2;19;245;Saint-Côme-et-Maruéjols;804;14;818
76;Occitanie;30;1;08;246;Sainte-Croix-de-Caderle;109;7;116
76;Occitanie;30;1;18;247;Saint-Denis;288;9;297
76;Occitanie;30;2;20;248;Saint-Dézéry;462;4;466
76;Occitanie;30;2;19;249;Saint-Dionisy;1070;13;1083
76;Occitanie;30;1;04;250;Saint-Étienne-de-l'Olm;405;12;417
76;Occitanie;30;2;05;251;Saint-Étienne-des-Sorts;548;12;560
76;Occitanie;30;3;15;252;Saint-Félix-de-Pallières;227;7;234
76;Occitanie;30;1;18;253;Saint-Florent-sur-Auzonnet;1169;16;1185
76;Occitanie;30;2;17;254;Saint-Geniès-de-Comolas;1997;39;2036
76;Occitanie;30;2;07;255;Saint-Geniès-de-Malgoirès;3052;32;3084
76;Occitanie;30;2;14;256;Saint-Gervais;761;16;777
76;Occitanie;30;2;16;257;Saint-Gervasy;1999;27;2026
76;Occitanie;30;2;19;258;Saint-Gilles;13931;108;14039
76;Occitanie;30;1;04;259;Saint-Hilaire-de-Brethmas;4503;79;4582
76;Occitanie;30;2;16;260;Saint-Hilaire-d'Ozilhan;1080;22;1102
76;Occitanie;30;1;04;261;Saint-Hippolyte-de-Caton;233;4;237
76;Occitanie;30;2;20;262;Saint-Hippolyte-de-Montaigu;255;12;267
76;Occitanie;30;3;22;263;Saint-Hippolyte-du-Fort;3804;138;3942
76;Occitanie;30;1;04;264;Saint-Jean-de-Ceyrargues;170;1;171
76;Occitanie;30;3;15;265;Saint-Jean-de-Crieulon;241;2;243
76;Occitanie;30;1;18;266;Saint-Jean-de-Maruéjols-et-Avéjan;852;11;863
76;Occitanie;30;1;15;267;Saint-Jean-de-Serres;524;11;535
76;Occitanie;30;1;18;268;Saint-Jean-de-Valériscle;626;15;641
76;Occitanie;30;1;08;269;Saint-Jean-du-Gard;2437;171;2608
76;Occitanie;30;1;02;270;Saint-Jean-du-Pin;1517;39;1556
76;Occitanie;30;1;18;271;Saint-Julien-de-Cassagnas;721;15;736
76;Occitanie;30;3;22;272;Saint-Julien-de-la-Nef;143;6;149
76;Occitanie;30;2;14;273;Saint-Julien-de-Peyrolas;1442;27;1469
76;Occitanie;30;1;18;274;Saint-Julien-les-Rosiers;3401;62;3463
76;Occitanie;30;1;03;275;Saint-Just-et-Vacquières;315;5;320
76;Occitanie;30;2;01;276;Saint-Laurent-d'Aigouze;3536;45;3581
76;Occitanie;30;2;14;277;Saint-Laurent-de-Carnols;500;9;509
76;Occitanie;30;2;17;278;Saint-Laurent-des-Arbres;3000;68;3068
76;Occitanie;30;2;20;279;Saint-Laurent-la-Vernède;658;11;669
76;Occitanie;30;3;22;280;Saint-Laurent-le-Minier;360;11;371
76;Occitanie;30;2;07;281;Saint-Mamert-du-Gard;1652;23;1675
76;Occitanie;30;2;14;282;Saint-Marcel-de-Careiret;861;17;878
76;Occitanie;30;3;22;283;Saint-Martial;183;3;186
76;Occitanie;30;1;03;284;Saint-Martin-de-Valgalgues;4497;62;4559
76;Occitanie;30;1;04;285;Saint-Maurice-de-Cazevieille;754;8;762
76;Occitanie;30;2;20;286;Saint-Maximin;770;18;788
76;Occitanie;30;2;14;287;Saint-Michel-d'Euzet;657;11;668
76;Occitanie;30;2;14;288;Saint-Nazaire;1262;19;1281
76;Occitanie;30;3;15;289;Saint-Nazaire-des-Gardies;86;2;88
76;Occitanie;30;2;14;290;Saint-Paulet-de-Caisson;1830;59;1889
76;Occitanie;30;1;08;291;Saint-Paul-la-Coste;291;5;296
76;Occitanie;30;2;05;292;Saint-Pons-la-Calm;454;10;464
76;Occitanie;30;1;18;293;Saint-Privat-de-Champclos;349;5;354
76;Occitanie;30;1;03;294;Saint-Privat-des-Vieux;5275;128;5403
76;Occitanie;30;2;20;295;Saint-Quentin-la-Poterie;3064;63;3127
76;Occitanie;30;3;22;296;Saint-Roman-de-Codières;151;14;165
76;Occitanie;30;3;22;297;Saint-Sauveur-Camprieu;224;11;235
76;Occitanie;30;1;08;298;Saint-Sébastien-d'Aigrefeuille;503;19;522
76;Occitanie;30;2;20;299;Saint-Siffret;1097;48;1145
76;Occitanie;30;3;15;300;Saint-Théodorit;538;12;550
76;Occitanie;30;2;20;301;Saint-Victor-des-Oules;310;4;314
76;Occitanie;30;2;17;302;Saint-Victor-la-Coste;2135;46;2181
76;Occitanie;30;1;18;303;Saint-Victor-de-Malcap;839;21;860
76;Occitanie;30;2;14;304;Salazac;189;3;192
76;Occitanie;30;1;03;305;Salindres;3571;39;3610
76;Occitanie;30;2;07;306;Salinelles;554;8;562
76;Occitanie;30;1;08;307;Les Salles-du-Gardon;2600;26;2626
76;Occitanie;30;2;20;308;Sanilhac-Sagriès;774;51;825
76;Occitanie;30;3;15;309;Sardan;337;1;338
76;Occitanie;30;3;22;310;Saumane;281;6;287
76;Occitanie;30;3;15;311;Sauve;1903;22;1925
76;Occitanie;30;2;17;312;Sauveterre;2061;47;2108
76;Occitanie;30;2;07;313;Sauzet;758;7;765
76;Occitanie;30;3;15;314;Savignargues;235;4;239
76;Occitanie;30;2;23;315;Saze;2119;39;2158
76;Occitanie;30;1;08;316;Sénéchas;241;7;248
76;Occitanie;30;2;16;317;Sernhac;1765;16;1781
76;Occitanie;30;1;03;318;Servas;208;4;212
76;Occitanie;30;2;20;319;Serviers-et-Labaume;618;23;641
76;Occitanie;30;1;03;320;Seynes;159;2;161
76;Occitanie;30;2;07;321;Sommières;5050;63;5113
76;Occitanie;30;3;22;322;Soudorgues;267;6;273
76;Occitanie;30;1;08;323;Soustelle;122;2;124
76;Occitanie;30;2;07;324;Souvignargues;877;15;892
76;Occitanie;30;3;22;325;Sumène;1388;34;1422
76;Occitanie;30;2;17;326;Tavel;2029;37;2066
76;Occitanie;30;1;18;327;Tharaux;56;2;58
76;Occitanie;30;2;16;328;Théziers;1039;19;1058
76;Occitanie;30;1;08;329;Thoiras;438;16;454
76;Occitanie;30;1;15;330;Tornac;935;25;960
76;Occitanie;30;2;05;331;Tresques;1806;50;1856
76;Occitanie;30;3;22;332;Trèves;113;1;114
76;Occitanie;30;2;21;333;Uchaud;4424;43;4467
76;Occitanie;30;2;20;334;Uzès;8387;329;8716
76;Occitanie;30;1;08;335;Vabres;134;4;138
76;Occitanie;30;2;06;336;Vallabrègues;1388;20;1408
76;Occitanie;30;2;20;337;Vallabrix;422;6;428
76;Occitanie;30;2;03;338;Vallérargues;142;4;146
76;Occitanie;30;3;22;339;Val-d'Aigoual;1415;21;1436
76;Occitanie;30;2;16;340;Valliguières;591;11;602
76;Occitanie;30;2;21;341;Vauvert;11492;118;11610
76;Occitanie;30;2;14;342;Vénéjan;1270;42;1312
76;Occitanie;30;2;14;343;Verfeuil;604;8;612
76;Occitanie;30;2;21;344;Vergèze;5308;76;5384
76;Occitanie;30;1;08;345;La Vernarède;343;1;344
76;Occitanie;30;2;16;346;Vers-Pont-du-Gard;1794;33;1827
76;Occitanie;30;2;21;347;Vestric-et-Candiac;1379;21;1400
76;Occitanie;30;1;04;348;Vézénobres;1816;102;1918
76;Occitanie;30;3;15;349;Vic-le-Fesq;546;3;549
76;Occitanie;30;3;22;350;Le Vigan;3772;118;3890
76;Occitanie;30;2;23;351;Villeneuve-lès-Avignon;12216;401;12617
76;Occitanie;30;2;07;352;Villevieille;1791;35;1826
76;Occitanie;30;3;22;353;Vissec;67;1;68
76;Occitanie;30;2;15;354;Montagnac;200;4;204
76;Occitanie;30;2;17;355;Saint-Paul-les-Fonts;1029;21;1050
76;Occitanie;30;2;09;356;Rodilhan;2851;172;3023
76;Occitanie;31;2;06;001;Agassac;122;3;125
76;Occitanie;31;3;07;002;Aignes;241;6;247
76;Occitanie;31;3;07;003;Aigrefeuille;1272;29;1301
76;Occitanie;31;3;07;004;Ayguesvives;2679;50;2729
76;Occitanie;31;2;06;005;Alan;293;8;301
76;Occitanie;31;3;13;006;Albiac;221;6;227
76;Occitanie;31;2;06;007;Ambax;64;0;64
76;Occitanie;31;2;06;008;Anan;253;4;257
76;Occitanie;31;2;02;009;Antichan-de-Frontignes;186;3;189
76;Occitanie;31;2;02;010;Antignac;99;3;102
76;Occitanie;31;2;02;011;Arbas;268;6;274
76;Occitanie;31;2;02;012;Arbon;99;2;101
76;Occitanie;31;2;02;013;Ardiège;358;11;369
76;Occitanie;31;2;02;014;Arguenos;81;4;85
76;Occitanie;31;2;02;015;Argut-Dessous;22;1;23
76;Occitanie;31;2;02;017;Arlos;101;2;103
76;Occitanie;31;2;02;018;Arnaud-Guilhem;227;4;231
76;Occitanie;31;2;02;019;Artigue;32;1;33
76;Occitanie;31;2;02;020;Aspet;874;72;946
76;Occitanie;31;2;14;021;Aspret-Sarrat;128;5;133
76;Occitanie;31;3;05;022;Aucamville;8968;94;9062
76;Occitanie;31;2;06;023;Aulon;310;5;315
76;Occitanie;31;1;07;024;Auragne;421;5;426
76;Occitanie;31;3;04;025;Aureville;921;15;936
76;Occitanie;31;3;13;026;Auriac-sur-Vendinelle;1055;21;1076
76;Occitanie;31;1;01;027;Auribail;200;5;205
76;Occitanie;31;2;06;028;Aurignac;1243;70;1313
76;Occitanie;31;3;13;029;Aurin;335;6;341
76;Occitanie;31;2;02;030;Ausseing;78;1;79
76;Occitanie;31;2;14;031;Ausson;590;20;610
76;Occitanie;31;3;03;032;Aussonne;7209;80;7289
76;Occitanie;31;1;01;033;Auterive;9923;95;10018
76;Occitanie;31;2;02;034;Auzas;231;9;240
76;Occitanie;31;3;04;035;Auzeville-Tolosane;4088;247;4335
76;Occitanie;31;3;04;036;Auzielle;1578;48;1626
76;Occitanie;31;3;13;037;Avignonet-Lauragais;1602;12;1614
76;Occitanie;31;3;10;038;Azas;664;11;675
76;Occitanie;31;2;06;039;Bachas;81;2;83
76;Occitanie;31;2;02;040;Bachos;35;1;36
76;Occitanie;31;2;02;041;Bagiry;113;2;115
76;Occitanie;31;2;02;042;Bagnères-de-Luchon;2285;143;2428
76;Occitanie;31;2;14;043;Balesta;140;6;146
76;Occitanie;31;3;24;044;Balma;16625;287;16912
76;Occitanie;31;2;02;045;Barbazan;496;10;506
76;Occitanie;31;2;02;046;Baren;12;0;12
76;Occitanie;31;1;01;047;Bax;92;1;93
76;Occitanie;31;3;07;048;Baziège;3395;58;3453
76;Occitanie;31;3;10;049;Bazus;579;14;593
76;Occitanie;31;2;02;050;Beauchalot;643;9;652
76;Occitanie;31;1;06;051;Beaufort;467;5;472
76;Occitanie;31;1;01;052;Beaumont-sur-Lèze;1587;32;1619
76;Occitanie;31;3;24;053;Beaupuy;1340;28;1368
76;Occitanie;31;3;13;054;Beauteville;184;1;185
76;Occitanie;31;3;13;055;Beauville;173;3;176
76;Occitanie;31;3;03;056;Beauzelle;6973;83;7056
76;Occitanie;31;3;07;057;Belberaud;1505;51;1556
76;Occitanie;31;3;07;058;Belbèze-de-Lauragais;128;1;129
76;Occitanie;31;2;02;059;Belbèze-en-Comminges;114;6;120
76;Occitanie;31;3;13;060;Bélesta-en-Lauragais;111;5;116
76;Occitanie;31;3;08;061;Bellegarde-Sainte-Marie;191;12;203
76;Occitanie;31;3;08;062;Bellesserre;107;4;111
76;Occitanie;31;2;06;063;Benque;166;2;168
76;Occitanie;31;2;02;064;Benque-Dessous-et-Dessus;27;0;27
76;Occitanie;31;1;06;065;Bérat;3034;59;3093
76;Occitanie;31;3;27;066;Bessières;4127;62;4189
76;Occitanie;31;2;02;067;Bezins-Garraux;42;0;42
76;Occitanie;31;2;02;068;Billière;27;0;27
76;Occitanie;31;3;03;069;Blagnac;25525;489;26014
76;Occitanie;31;2;14;070;Blajan;451;8;459
76;Occitanie;31;1;01;071;Bois-de-la-Pierre;441;3;444
76;Occitanie;31;2;06;072;Boissède;68;2;70
76;Occitanie;31;3;27;073;Bondigoux;659;21;680
76;Occitanie;31;3;10;074;Bonrepos-Riquet;289;7;296
76;Occitanie;31;1;11;075;Bonrepos-sur-Aussonnelle;1225;22;1247
76;Occitanie;31;2;14;076;Bordes-de-Rivière;471;12;483
76;Occitanie;31;3;27;077;Le Born;593;15;608
76;Occitanie;31;2;14;078;Boudrac;147;2;149
76;Occitanie;31;3;27;079;Bouloc;4723;89;4812
76;Occitanie;31;2;14;080;Boulogne-sur-Gesse;1648;34;1682
76;Occitanie;31;2;02;081;Bourg-d'Oueil;5;0;5
76;Occitanie;31;3;13;082;Bourg-Saint-Bernard;1111;21;1132
76;Occitanie;31;2;06;083;Boussan;233;2;235
76;Occitanie;31;1;06;084;Boussens;1061;24;1085
76;Occitanie;31;2;02;085;Boutx;249;3;252
76;Occitanie;31;2;06;086;Bouzin;88;4;92
76;Occitanie;31;1;11;087;Bragayrac;323;2;325
76;Occitanie;31;3;21;088;Brax;2862;95;2957
76;Occitanie;31;3;08;089;Bretx;679;6;685
76;Occitanie;31;3;08;090;Brignemont;374;5;379
76;Occitanie;31;3;05;091;Bruguières;5947;105;6052
76;Occitanie;31;2;02;092;Burgalays;120;0;120
76;Occitanie;31;3;08;093;Le Burgaud;957;11;968
76;Occitanie;31;3;27;094;Buzet-sur-Tarn;2870;51;2921
76;Occitanie;31;2;02;095;Cabanac-Cazaux;128;1;129
76;Occitanie;31;3;08;096;Cabanac-Séguenville;180;1;181
76;Occitanie;31;3;13;097;Le Cabanial;462;12;474
76;Occitanie;31;3;08;098;Cadours;1089;19;1108
76;Occitanie;31;3;07;099;Caignac;399;4;403
76;Occitanie;31;3;07;100;Calmont;2371;31;2402
76;Occitanie;31;1;06;101;Cambernard;467;4;471
76;Occitanie;31;3;13;102;Cambiac;220;3;223
76;Occitanie;31;1;01;103;Canens;59;0;59
76;Occitanie;31;1;01;104;Capens;677;13;690
76;Occitanie;31;3;13;105;Caragoudes;228;5;233
76;Occitanie;31;3;13;106;Caraman;2544;47;2591
76;Occitanie;31;1;01;107;Carbonne;5791;111;5902
76;Occitanie;31;2;14;108;Cardeilhac;269;2;271
76;Occitanie;31;2;06;109;Cassagnabère-Tournas;467;3;470
76;Occitanie;31;2;02;110;Cassagne;644;13;657
76;Occitanie;31;1;01;111;Castagnac;279;4;283
76;Occitanie;31;2;02;112;Castagnède;190;5;195
76;Occitanie;31;3;04;113;Castanet-Tolosan;14213;249;14462
76;Occitanie;31;2;02;114;Castelbiague;241;3;244
76;Occitanie;31;2;06;115;Castelgaillard;59;1;60
76;Occitanie;31;3;05;116;Castelginest;10682;117;10799
76;Occitanie;31;3;10;117;Castelmaurou;4359;99;4458
76;Occitanie;31;3;27;118;Castelnau-d'Estrétefonds;6579;103;6682
76;Occitanie;31;1;06;119;Castelnau-Picampeau;208;5;213
76;Occitanie;31;3;08;120;Le Castéra;718;18;736
76;Occitanie;31;2;14;121;Castéra-Vignoles;63;1;64
76;Occitanie;31;1;06;122;Casties-Labrande;113;2;115
76;Occitanie;31;2;02;123;Castillon-de-Larboust;74;1;75
76;Occitanie;31;2;02;124;Castillon-de-Saint-Martory;387;9;396
76;Occitanie;31;2;02;125;Cathervielle;36;0;36
76;Occitanie;31;3;08;126;Caubiac;396;10;406
76;Occitanie;31;2;02;127;Caubous;4;1;5
76;Occitanie;31;1;01;128;Caujac;850;22;872
76;Occitanie;31;2;02;129;Cazarilh-Laspènes;17;4;21
76;Occitanie;31;2;14;130;Cazaril-Tambourès;84;3;87
76;Occitanie;31;2;02;131;Cazaunous;70;1;71
76;Occitanie;31;2;02;132;Cazaux-Layrisse;64;1;65
76;Occitanie;31;2;02;133;Cazeaux-de-Larboust;99;4;103
76;Occitanie;31;2;06;134;Cazeneuve-Montaut;83;0;83
76;Occitanie;31;1;06;135;Cazères;4799;72;4871
76;Occitanie;31;3;27;136;Cépet;2171;26;2197
76;Occitanie;31;3;13;137;Cessales;155;0;155
76;Occitanie;31;2;14;138;Charlas;250;6;256
76;Occitanie;31;2;02;139;Chaum;195;4;199
76;Occitanie;31;2;02;140;Chein-Dessus;177;7;184
76;Occitanie;31;2;14;141;Ciadoux;218;2;220
76;Occitanie;31;2;02;142;Cier-de-Luchon;239;7;246
76;Occitanie;31;2;02;143;Cier-de-Rivière;277;8;285
76;Occitanie;31;2;02;144;Cierp-Gaud;730;12;742
76;Occitanie;31;1;01;145;Cintegabelle;2914;65;2979
76;Occitanie;31;2;02;146;Cirès;14;0;14
76;Occitanie;31;2;14;147;Clarac;658;12;670
76;Occitanie;31;3;04;148;Clermont-le-Fort;507;17;524
76;Occitanie;31;3;21;149;Colomiers;39968;561;40529
76;Occitanie;31;3;03;150;Cornebarrieu;7372;106;7478
76;Occitanie;31;3;07;151;Corronsac;859;23;882
76;Occitanie;31;2;06;152;Coueilles;94;5;99
76;Occitanie;31;1;06;153;Couladère;416;12;428
76;Occitanie;31;2;02;155;Couret;231;2;233
76;Occitanie;31;3;08;156;Cox;358;12;370
76;Occitanie;31;3;26;157;Cugnaux;19344;253;19597
76;Occitanie;31;2;14;158;Cuguron;178;7;185
76;Occitanie;31;2;14;159;Le Cuing;472;5;477
76;Occitanie;31;3;08;160;Daux;2432;28;2460
76;Occitanie;31;3;07;161;Deyme;1236;22;1258
76;Occitanie;31;3;07;162;Donneville;1080;86;1166
76;Occitanie;31;3;24;163;Drémil-Lafage;2649;65;2714
76;Occitanie;31;3;08;164;Drudas;202;6;208
76;Occitanie;31;1;12;165;Eaunes;6349;98;6447
76;Occitanie;31;1;11;166;Empeaux;279;4;283
76;Occitanie;31;2;02;167;Encausse-les-Thermes;700;14;714
76;Occitanie;31;2;06;168;Eoux;130;0;130
76;Occitanie;31;3;07;169;Escalquens;6967;162;7129
76;Occitanie;31;2;14;170;Escanecrabe;246;10;256
76;Occitanie;31;3;07;171;Espanès;302;9;311
76;Occitanie;31;2;06;172;Esparron;47;1;48
76;Occitanie;31;1;01;173;Esperce;266;3;269
76;Occitanie;31;2;02;174;Estadens;538;4;542
76;Occitanie;31;2;14;175;Estancarbon;608;10;618
76;Occitanie;31;2;02;176;Esténos;191;5;196
76;Occitanie;31;2;02;177;Eup;136;2;138
76;Occitanie;31;2;06;178;Fabas;200;3;203
76;Occitanie;31;3;13;179;Le Faget;322;20;342
76;Occitanie;31;3;13;180;Falga;139;6;145
76;Occitanie;31;1;09;181;Le Fauga;2089;28;2117
76;Occitanie;31;3;05;182;Fenouillet;5307;59;5366
76;Occitanie;31;2;02;183;Figarol;317;9;326
76;Occitanie;31;3;24;184;Flourens;2056;38;2094
76;Occitanie;31;3;13;185;Folcarde;117;1;118
76;Occitanie;31;3;05;186;Fonbeauzard;3011;30;3041
76;Occitanie;31;1;11;187;Fonsorbes;12170;329;12499
76;Occitanie;31;1;11;188;Fontenilles;5893;161;6054
76;Occitanie;31;1;06;189;Forgues;220;4;224
76;Occitanie;31;2;02;190;Fos;233;0;233
76;Occitanie;31;2;02;191;Fougaron;96;2;98
76;Occitanie;31;3;07;192;Fourquevaux;776;21;797
76;Occitanie;31;1;06;193;Le Fousseret;1904;30;1934
76;Occitanie;31;3;13;194;Francarville;169;2;171
76;Occitanie;31;2;02;195;Francazal;32;0;32
76;Occitanie;31;1;06;196;Francon;244;3;247
76;Occitanie;31;2;14;197;Franquevielle;327;8;335
76;Occitanie;31;2;02;198;Le Fréchet;101;3;104
76;Occitanie;31;2;02;199;Fronsac;200;7;207
76;Occitanie;31;2;02;200;Frontignan-de-Comminges;79;4;83
76;Occitanie;31;2;06;201;Frontignan-Savès;73;0;73
76;Occitanie;31;3;27;202;Fronton;6271;149;6420
76;Occitanie;31;1;09;203;Frouzins;9292;162;9454
76;Occitanie;31;1;06;204;Fustignac;82;3;85
76;Occitanie;31;3;05;205;Gagnac-sur-Garonne;3130;27;3157
76;Occitanie;31;1;01;206;Gaillac-Toulza;1311;15;1326
76;Occitanie;31;2;02;207;Galié;78;6;84
76;Occitanie;31;2;02;208;Ganties;327;5;332
76;Occitanie;31;3;08;209;Garac;147;4;151
76;Occitanie;31;3;13;210;Gardouch;1283;24;1307
76;Occitanie;31;3;27;211;Gargas;702;8;710
76;Occitanie;31;3;10;212;Garidech;1928;14;1942
76;Occitanie;31;2;02;213;Garin;155;3;158
76;Occitanie;31;3;10;215;Gauré;467;15;482
76;Occitanie;31;3;10;216;Gémil;269;10;279
76;Occitanie;31;2;02;217;Génos;68;1;69
76;Occitanie;31;2;14;218;Gensac-de-Boulogne;115;4;119
76;Occitanie;31;1;01;219;Gensac-sur-Garonne;447;2;449
76;Occitanie;31;3;07;220;Gibel;376;5;381
76;Occitanie;31;2;02;221;Gouaux-de-Larboust;69;0;69
76;Occitanie;31;2;02;222;Gouaux-de-Luchon;46;0;46
76;Occitanie;31;2;06;223;Goudex;43;1;44
76;Occitanie;31;2;02;224;Gourdan-Polignan;1203;186;1389
76;Occitanie;31;1;01;225;Goutevernisse;186;3;189
76;Occitanie;31;1;01;226;Gouzens;81;6;87
76;Occitanie;31;3;04;227;Goyrans;843;36;879
76;Occitanie;31;3;10;228;Gragnague;1974;43;2017
76;Occitanie;31;1;06;229;Gratens;696;17;713
76;Occitanie;31;3;05;230;Gratentour;4387;79;4466
76;Occitanie;31;1;01;231;Grazac;691;8;699
76;Occitanie;31;3;08;232;Grenade;8844;166;9010
76;Occitanie;31;1;01;233;Grépiac;997;33;1030
76;Occitanie;31;3;08;234;Le Grès;440;8;448
76;Occitanie;31;2;02;235;Guran;44;1;45
76;Occitanie;31;2;02;236;Herran;73;1;74
76;Occitanie;31;2;02;237;His;232;30;262
76;Occitanie;31;2;02;238;Huos;482;11;493
76;Occitanie;31;2;06;239;L'Isle-en-Dodon;1634;28;1662
76;Occitanie;31;3;07;240;Issus;601;10;611
76;Occitanie;31;2;02;241;Izaut-de-l'Hôtel;295;5;300
76;Occitanie;31;2;02;242;Jurvielle;18;2;20
76;Occitanie;31;3;13;243;Juzes;69;4;73
76;Occitanie;31;2;02;244;Juzet-de-Luchon;381;17;398
76;Occitanie;31;2;02;245;Juzet-d'Izaut;188;5;193
76;Occitanie;31;2;14;246;Labarthe-Inard;866;15;881
76;Occitanie;31;2;14;247;Labarthe-Rivière;1303;28;1331
76;Occitanie;31;1;12;248;Labarthe-sur-Lèze;6271;105;6376
76;Occitanie;31;3;07;249;Labastide-Beauvoir;1259;26;1285
76;Occitanie;31;1;06;250;Labastide-Clermont;675;17;692
76;Occitanie;31;2;06;251;Labastide-Paumès;145;1;146
76;Occitanie;31;3;10;252;Labastide-Saint-Sernin;1955;25;1980
76;Occitanie;31;1;09;253;Labastidette;2938;37;2975
76;Occitanie;31;3;04;254;Labège;4008;142;4150
76;Occitanie;31;2;02;255;Labroquère;319;10;329
76;Occitanie;31;1;01;256;Labruyère-Dorsa;290;6;296
76;Occitanie;31;1;01;258;Lacaugne;241;6;247
76;Occitanie;31;3;04;259;Lacroix-Falgarde;2081;49;2130
76;Occitanie;31;2;02;260;Laffite-Toupière;96;1;97
76;Occitanie;31;1;01;261;Lafitte-Vigordane;1224;19;1243
76;Occitanie;31;3;13;262;Lagarde;421;11;432
76;Occitanie;31;1;12;263;Lagardelle-sur-Lèze;3169;57;3226
76;Occitanie;31;1;01;264;Lagrâce-Dieu;557;7;564
76;Occitanie;31;3;08;265;Lagraulet-Saint-Nicolas;242;4;246
76;Occitanie;31;1;06;266;Lahage;199;1;200
76;Occitanie;31;1;01;267;Lahitère;66;0;66
76;Occitanie;31;2;14;268;Lalouret-Laffiteau;135;3;138
76;Occitanie;31;1;09;269;Lamasquère;1510;15;1525
76;Occitanie;31;2;14;270;Landorthe;1013;35;1048
76;Occitanie;31;3;13;271;Lanta;2155;42;2197
76;Occitanie;31;1;01;272;Lapeyrère;65;3;68
76;Occitanie;31;3;10;273;Lapeyrouse-Fossat;2886;69;2955
76;Occitanie;31;2;14;274;Larcan;182;5;187
76;Occitanie;31;3;08;275;Laréole;160;5;165
76;Occitanie;31;2;14;276;Larroque;287;5;292
76;Occitanie;31;3;08;277;Lasserre-Pradère;1543;42;1585
76;Occitanie;31;2;06;278;Latoue;317;5;322
76;Occitanie;31;1;01;279;Latour;77;1;78
76;Occitanie;31;1;01;280;Latrape;372;13;385
76;Occitanie;31;3;08;281;Launac;1336;32;1368
76;Occitanie;31;3;22;282;Launaguet;9050;112;9162
76;Occitanie;31;1;06;283;Lautignac;267;1;268
76;Occitanie;31;3;07;284;Lauzerville;1654;55;1709
76;Occitanie;31;3;10;285;Lavalette;759;13;772
76;Occitanie;31;1;01;286;Lavelanet-de-Comminges;614;8;622
76;Occitanie;31;1;09;287;Lavernose-Lacasse;3255;83;3338
76;Occitanie;31;3;27;288;Layrac-sur-Tarn;311;9;320
76;Occitanie;31;2;14;289;Lécussan;280;3;283
76;Occitanie;31;2;02;290;Lège;36;1;37
76;Occitanie;31;3;08;291;Léguevin;9359;253;9612
76;Occitanie;31;1;06;292;Lescuns;73;1;74
76;Occitanie;31;3;05;293;Lespinasse;2828;23;2851
76;Occitanie;31;2;14;294;Lespiteau;91;1;92
76;Occitanie;31;2;14;295;Lespugue;83;0;83
76;Occitanie;31;2;02;296;Lestelle-de-Saint-Martory;437;11;448
76;Occitanie;31;3;08;297;Lévignac;2139;42;2181
76;Occitanie;31;1;06;299;Lherm;3777;82;3859
76;Occitanie;31;2;14;300;Lieoux;127;3;130
76;Occitanie;31;2;06;301;Lilhac;131;1;132
76;Occitanie;31;2;14;302;Lodes;291;7;298
76;Occitanie;31;1;01;303;Longages;3160;34;3194
76;Occitanie;31;3;13;304;Loubens-Lauragais;451;10;461
76;Occitanie;31;2;14;305;Loudet;197;6;203
76;Occitanie;31;2;02;306;Lourde;92;0;92
76;Occitanie;31;2;02;308;Luscan;48;0;48
76;Occitanie;31;1;06;309;Lussan-Adeilhac;229;2;231
76;Occitanie;31;3;13;310;Lux;339;5;344
76;Occitanie;31;3;27;311;La Magdelaine-sur-Tarn;1181;21;1202
76;Occitanie;31;1;01;312;Mailholas;35;1;36
76;Occitanie;31;2;02;313;Malvezie;110;2;112
76;Occitanie;31;2;02;314;Mancioux;384;5;389
76;Occitanie;31;2;02;315;Mane;956;46;1002
76;Occitanie;31;2;02;316;Marignac;490;8;498
76;Occitanie;31;1;06;317;Marignac-Lasclares;469;9;478
76;Occitanie;31;1;06;318;Marignac-Laspeyres;206;5;211
76;Occitanie;31;1;01;319;Marliac;138;1;139
76;Occitanie;31;1;01;320;Marquefave;956;41;997
76;Occitanie;31;2;02;321;Marsoulas;125;8;133
76;Occitanie;31;2;06;322;Martisserre;66;2;68
76;Occitanie;31;2;02;323;Martres-de-Rivière;351;13;364
76;Occitanie;31;1;06;324;Martres-Tolosane;2414;44;2458
76;Occitanie;31;3;13;325;Mascarville;187;12;199
76;Occitanie;31;1;01;326;Massabrac;93;0;93
76;Occitanie;31;1;06;327;Mauran;214;1;215
76;Occitanie;31;3;13;328;Mauremont;317;10;327
76;Occitanie;31;3;13;329;Maurens;208;2;210
76;Occitanie;31;1;01;330;Mauressac;506;11;517
76;Occitanie;31;3;13;331;Maureville;307;12;319
76;Occitanie;31;3;07;332;Mauvaisin;217;4;221
76;Occitanie;31;2;06;333;Mauvezin;89;3;92
76;Occitanie;31;1;01;334;Mauzac;1301;23;1324
76;Occitanie;31;2;02;335;Mayrègne;25;2;27
76;Occitanie;31;2;02;336;Mazères-sur-Salat;628;12;640
76;Occitanie;31;2;02;337;Melles;92;1;93
76;Occitanie;31;3;08;338;Menville;781;23;804
76;Occitanie;31;3;08;339;Mérenvielle;490;6;496
76;Occitanie;31;3;04;340;Mervilla;291;9;300
76;Occitanie;31;3;08;341;Merville;6054;103;6157
76;Occitanie;31;2;02;342;Milhas;173;0;173
76;Occitanie;31;2;06;343;Mirambeau;61;0;61
76;Occitanie;31;2;14;344;Miramont-de-Comminges;766;12;778
76;Occitanie;31;1;01;345;Miremont;2623;36;2659
76;Occitanie;31;3;27;346;Mirepoix-sur-Tarn;1104;14;1118
76;Occitanie;31;2;06;347;Molas;167;4;171
76;Occitanie;31;2;02;348;Moncaup;37;0;37
76;Occitanie;31;1;06;349;Mondavezan;905;18;923
76;Occitanie;31;2;14;350;Mondilhan;81;1;82
76;Occitanie;31;3;03;351;Mondonville;5166;93;5259
76;Occitanie;31;3;24;352;Mondouzil;224;11;235
76;Occitanie;31;1;06;353;Monès;88;0;88
76;Occitanie;31;3;07;354;Monestrol;54;0;54
76;Occitanie;31;3;24;355;Mons;1758;53;1811
76;Occitanie;31;3;08;356;Montaigut-sur-Save;1839;46;1885
76;Occitanie;31;2;02;357;Montastruc-de-Salies;305;2;307
76;Occitanie;31;3;10;358;Montastruc-la-Conseillère;3576;101;3677
76;Occitanie;31;1;06;359;Montastruc-Savès;70;2;72
76;Occitanie;31;2;02;360;Montauban-de-Luchon;503;7;510
76;Occitanie;31;1;01;361;Montaut;516;5;521
76;Occitanie;31;1;06;362;Montberaud;203;5;208
76;Occitanie;31;2;06;363;Montbernard;217;5;222
76;Occitanie;31;3;10;364;Montberon;3088;66;3154
76;Occitanie;31;1;01;365;Montbrun-Bocage;470;11;481
76;Occitanie;31;3;07;366;Montbrun-Lauragais;654;21;675
76;Occitanie;31;1;06;367;Montclar-de-Comminges;76;5;81
76;Occitanie;31;3;13;368;Montclar-Lauragais;242;13;255
76;Occitanie;31;2;02;369;Mont-de-Galié;42;2;44
76;Occitanie;31;1;06;370;Montégut-Bourjac;143;1;144
76;Occitanie;31;3;13;371;Montégut-Lauragais;423;15;438
76;Occitanie;31;2;02;372;Montespan;459;7;466
76;Occitanie;31;2;06;373;Montesquieu-Guittaut;179;2;181
76;Occitanie;31;3;13;374;Montesquieu-Lauragais;1009;13;1022
76;Occitanie;31;1;01;375;Montesquieu-Volvestre;3111;68;3179
76;Occitanie;31;2;02;376;Montgaillard-de-Salies;104;3;107
76;Occitanie;31;3;13;377;Montgaillard-Lauragais;711;9;720
76;Occitanie;31;2;14;378;Montgaillard-sur-Save;82;2;84
76;Occitanie;31;1;01;379;Montgazin;178;2;180
76;Occitanie;31;3;07;380;Montgeard;507;8;515
76;Occitanie;31;3;07;381;Montgiscard;2530;59;2589
76;Occitanie;31;1;06;382;Montgras;112;1;113
76;Occitanie;31;3;10;383;Montjoire;1304;26;1330
76;Occitanie;31;3;07;384;Montlaur;1769;36;1805
76;Occitanie;31;2;14;385;Montmaurin;201;4;205
76;Occitanie;31;2;06;386;Montoulieu-Saint-Bernard;214;6;220
76;Occitanie;31;1;06;387;Montoussin;129;0;129
76;Occitanie;31;3;10;388;Montpitol;387;12;399
76;Occitanie;31;3;24;389;Montrabé;4111;78;4189
76;Occitanie;31;2;14;390;Montréjeau;2751;33;2784
76;Occitanie;31;2;02;391;Montsaunès;453;31;484
76;Occitanie;31;3;13;392;Mourvilles-Basses;78;4;82
76;Occitanie;31;3;13;393;Mourvilles-Hautes;167;5;172
76;Occitanie;31;2;02;394;Moustajon;129;3;132
76;Occitanie;31;1;09;395;Muret;24797;564;25361
76;Occitanie;31;3;07;396;Nailloux;3928;64;3992
76;Occitanie;31;2;14;397;Nénigan;56;1;57
76;Occitanie;31;2;14;398;Nizan-Gesse;96;1;97
76;Occitanie;31;1;01;399;Noé;2912;64;2976
76;Occitanie;31;3;13;400;Nogaret;90;0;90
76;Occitanie;31;3;07;401;Noueilles;393;6;399
76;Occitanie;31;3;07;402;Odars;906;32;938
76;Occitanie;31;3;08;403;Ondes;767;133;900
76;Occitanie;31;2;02;404;Oô;101;4;105
76;Occitanie;31;2;02;405;Ore;114;3;117
76;Occitanie;31;1;06;406;Palaminy;814;11;825
76;Occitanie;31;3;10;407;Paulhac;1239;29;1268
76;Occitanie;31;2;02;408;Payssous;88;3;91
76;Occitanie;31;3;04;409;Péchabou;2352;54;2406
76;Occitanie;31;3;10;410;Pechbonnieu;4544;89;4633
76;Occitanie;31;3;04;411;Pechbusque;947;22;969
76;Occitanie;31;2;14;412;Péguilhan;267;8;275
76;Occitanie;31;3;08;413;Pelleport;509;12;521
76;Occitanie;31;2;06;414;Peyrissas;80;2;82
76;Occitanie;31;2;06;415;Peyrouzet;82;2;84
76;Occitanie;31;1;01;416;Peyssies;585;7;592
76;Occitanie;31;3;21;417;Pibrac;8578;255;8833
76;Occitanie;31;3;24;418;Pin-Balma;938;33;971
76;Occitanie;31;1;06;419;Le Pin-Murelet;173;4;177
76;Occitanie;31;1;12;420;Pinsaguel;2840;37;2877
76;Occitanie;31;1;12;421;Pins-Justaret;4318;69;4387
76;Occitanie;31;1;06;422;Plagne;93;0;93
76;Occitanie;31;1;06;423;Plagnole;306;3;309
76;Occitanie;31;3;11;424;Plaisance-du-Touch;19402;411;19813
76;Occitanie;31;1;06;425;Le Plan;442;7;449
76;Occitanie;31;2;02;426;Pointis-de-Rivière;854;11;865
76;Occitanie;31;2;14;427;Pointis-Inard;941;15;956
76;Occitanie;31;1;06;428;Polastron;53;2;55
76;Occitanie;31;3;07;429;Pompertuzat;2307;38;2345
76;Occitanie;31;2;14;430;Ponlat-Taillebourg;596;14;610
76;Occitanie;31;2;02;431;Portet-d'Aspet;61;1;62
76;Occitanie;31;2;02;432;Portet-de-Luchon;38;4;42
76;Occitanie;31;1;12;433;Portet-sur-Garonne;9812;124;9936
76;Occitanie;31;2;02;434;Poubeau;80;4;84
76;Occitanie;31;1;06;435;Poucharramet;935;14;949
76;Occitanie;31;1;06;436;Pouy-de-Touges;412;10;422
76;Occitanie;31;3;07;437;Pouze;85;4;89
76;Occitanie;31;3;07;439;Préserville;720;15;735
76;Occitanie;31;2;02;440;Proupiary;71;1;72
76;Occitanie;31;3;13;441;Prunet;148;2;150
76;Occitanie;31;1;01;442;Puydaniel;552;9;561
76;Occitanie;31;2;06;443;Puymaurin;291;5;296
76;Occitanie;31;3;08;444;Puysségur;139;4;143
76;Occitanie;31;3;24;445;Quint-Fonsegrives;5896;118;6014
76;Occitanie;31;3;25;446;Ramonville-Saint-Agne;14600;317;14917
76;Occitanie;31;2;02;447;Razecueillé;35;1;36
76;Occitanie;31;3;04;448;Rebigue;472;25;497
76;Occitanie;31;2;14;449;Régades;139;4;143
76;Occitanie;31;3;13;450;Renneville;545;13;558
76;Occitanie;31;3;13;451;Revel;9637;297;9934
76;Occitanie;31;2;14;452;Rieucazé;56;0;56
76;Occitanie;31;3;13;453;Rieumajou;137;2;139
76;Occitanie;31;1;06;454;Rieumes;3578;86;3664
76;Occitanie;31;1;01;455;Rieux-Volvestre;2611;56;2667
76;Occitanie;31;2;06;456;Riolas;51;1;52
76;Occitanie;31;2;02;457;Roquefort-sur-Garonne;794;13;807
76;Occitanie;31;1;12;458;Roques;4757;54;4811
76;Occitanie;31;3;10;459;Roquesérière;756;19;775
76;Occitanie;31;1;12;460;Roquettes;4212;68;4280
76;Occitanie;31;2;02;461;Rouède;289;3;292
76;Occitanie;31;3;10;462;Rouffiac-Tolosan;1931;41;1972
76;Occitanie;31;3;13;463;Roumens;247;4;251
76;Occitanie;31;1;11;464;Sabonnères;323;9;332
76;Occitanie;31;2;02;465;Saccourvielle;19;0;19
76;Occitanie;31;1;11;466;Saiguède;809;22;831
76;Occitanie;31;3;05;467;Saint-Alban;6217;50;6267
76;Occitanie;31;2;06;468;Saint-André;233;8;241
76;Occitanie;31;1;06;469;Saint-Araille;137;3;140
76;Occitanie;31;2;02;470;Saint-Aventin;64;3;67
76;Occitanie;31;2;02;471;Saint-Béat-Lez;383;8;391
76;Occitanie;31;2;02;472;Saint-Bertrand-de-Comminges;240;6;246
76;Occitanie;31;3;08;473;Saint-Cézert;434;1;435
76;Occitanie;31;1;01;474;Saint-Christaud;239;4;243
76;Occitanie;31;1;09;475;Saint-Clar-de-Rivière;1410;27;1437
76;Occitanie;31;1;06;476;Saint-Élix-le-Château;919;21;940
76;Occitanie;31;2;06;477;Saint-Élix-Séglan;42;0;42
76;Occitanie;31;3;13;478;Saint-Félix-Lauragais;1266;34;1300
76;Occitanie;31;2;14;479;Saint-Ferréol-de-Comminges;60;1;61
76;Occitanie;31;3;07;480;Sainte-Foy-d'Aigrefeuille;2174;66;2240
76;Occitanie;31;1;06;481;Sainte-Foy-de-Peyrolières;2093;46;2139
76;Occitanie;31;2;06;482;Saint-Frajou;213;4;217
76;Occitanie;31;2;14;483;Saint-Gaudens;11773;564;12337
76;Occitanie;31;3;10;484;Saint-Geniès-Bellevue;2522;65;2587
76;Occitanie;31;3;13;485;Saint-Germier;116;2;118
76;Occitanie;31;1;09;486;Saint-Hilaire;1373;22;1395
76;Occitanie;31;2;14;487;Saint-Ignan;228;5;233
76;Occitanie;31;3;23;488;Saint-Jean;11017;138;11155
76;Occitanie;31;3;10;489;Saint-Jean-Lherm;395;12;407
76;Occitanie;31;3;05;490;Saint-Jory;6383;68;6451
76;Occitanie;31;3;13;491;Saint-Julia;413;11;424
76;Occitanie;31;1;01;492;Saint-Julien-sur-Garonne;552;5;557
76;Occitanie;31;2;14;493;Saint-Lary-Boujean;132;6;138
76;Occitanie;31;2;06;494;Saint-Laurent;178;1;179
76;Occitanie;31;3;07;495;Saint-Léon;1293;13;1306
76;Occitanie;31;3;08;496;Sainte-Livrade;258;13;271
76;Occitanie;31;3;10;497;Saint-Loup-Cammas;2221;46;2267
76;Occitanie;31;2;14;498;Saint-Loup-en-Comminges;37;0;37
76;Occitanie;31;1;11;499;Saint-Lys;9521;183;9704
76;Occitanie;31;2;02;500;Saint-Mamet;555;19;574
76;Occitanie;31;3;10;501;Saint-Marcel-Paulel;436;7;443
76;Occitanie;31;2;14;502;Saint-Marcet;361;9;370
76;Occitanie;31;2;02;503;Saint-Martory;997;11;1008
76;Occitanie;31;2;02;504;Saint-Médard;223;16;239
76;Occitanie;31;1;06;505;Saint-Michel;318;6;324
76;Occitanie;31;3;04;506;Saint-Orens-de-Gameville;12696;229;12925
76;Occitanie;31;3;08;507;Saint-Paul-sur-Save;1622;25;1647
76;Occitanie;31;2;02;508;Saint-Paul-d'Oueil;34;0;34
76;Occitanie;31;2;02;509;Saint-Pé-d'Ardet;155;1;156
76;Occitanie;31;2;14;510;Saint-Pé-Delbosc;141;0;141
76;Occitanie;31;3;10;511;Saint-Pierre;234;8;242
76;Occitanie;31;3;13;512;Saint-Pierre-de-Lages;892;27;919
76;Occitanie;31;2;14;513;Saint-Plancard;392;6;398
76;Occitanie;31;3;13;514;Saint-Rome;59;2;61
76;Occitanie;31;3;27;515;Saint-Rustice;436;9;445
76;Occitanie;31;3;27;516;Saint-Sauveur;1791;16;1807
76;Occitanie;31;1;01;517;Saint-Sulpice-sur-Lèze;2325;61;2386
76;Occitanie;31;1;11;518;Saint-Thomas;576;15;591
76;Occitanie;31;3;13;519;Saint-Vincent;200;8;208
76;Occitanie;31;1;06;520;Sajas;122;3;125
76;Occitanie;31;2;02;521;Saleich;339;8;347
76;Occitanie;31;2;06;522;Salerm;59;2;61
76;Occitanie;31;2;02;523;Salies-du-Salat;1763;106;1869
76;Occitanie;31;2;02;524;Salles-et-Pratviel;129;2;131
76;Occitanie;31;1;01;525;Salles-sur-Garonne;588;14;602
76;Occitanie;31;3;08;526;La Salvetat-Saint-Gilles;8474;194;8668
76;Occitanie;31;3;13;527;La Salvetat-Lauragais;150;3;153
76;Occitanie;31;2;14;528;Saman;123;4;127
76;Occitanie;31;2;06;529;Samouillan;112;2;114
76;Occitanie;31;1;06;530;Sana;249;5;254
76;Occitanie;31;2;14;531;Sarrecave;78;0;78
76;Occitanie;31;2;14;532;Sarremezan;93;0;93
76;Occitanie;31;1;12;533;Saubens;2297;51;2348
76;Occitanie;31;3;13;534;Saussens;208;0;208
76;Occitanie;31;2;02;535;Sauveterre-de-Comminges;682;17;699
76;Occitanie;31;2;14;536;Saux-et-Pomarède;252;8;260
76;Occitanie;31;2;14;537;Savarthès;180;5;185
76;Occitanie;31;1;06;538;Savères;220;4;224
76;Occitanie;31;2;14;539;Sédeilhac;62;3;65
76;Occitanie;31;3;13;540;Ségreville;320;8;328
76;Occitanie;31;3;03;541;Seilh;3284;73;3357
76;Occitanie;31;2;02;542;Seilhan;210;3;213
76;Occitanie;31;1;06;543;Sénarens;113;2;115
76;Occitanie;31;2;02;544;Sengouagnet;215;2;217
76;Occitanie;31;2;02;545;Sepx;210;4;214
76;Occitanie;31;3;07;546;Seyre;130;2;132
76;Occitanie;31;1;09;547;Seysses;9481;124;9605
76;Occitanie;31;2;02;548;Signac;51;0;51
76;Occitanie;31;2;02;549;Sode;19;0;19
76;Occitanie;31;2;02;550;Soueich;523;15;538
76;Occitanie;31;3;13;551;Tarabel;539;17;556
76;Occitanie;31;2;06;552;Terrebasse;138;4;142
76;Occitanie;31;3;08;553;Thil;1146;25;1171
76;Occitanie;31;2;02;554;Touille;238;1;239
76;Occitanie;31;3;99;555;Toulouse;493465;5131;498596
76;Occitanie;31;2;14;556;Les Tourreilles;377;9;386
76;Occitanie;31;3;26;557;Tournefeuille;28117;615;28732
76;Occitanie;31;3;13;558;Toutens;388;5;393
76;Occitanie;31;2;02;559;Trébons-de-Luchon;7;0;7
76;Occitanie;31;3;13;560;Trébons-sur-la-Grasse;475;8;483
76;Occitanie;31;3;23;561;L'Union;11798;164;11962
76;Occitanie;31;2;02;562;Urau;120;1;121
76;Occitanie;31;3;27;563;Vacquiers;1339;37;1376
76;Occitanie;31;2;02;564;Valcabrère;142;1;143
76;Occitanie;31;2;14;565;Valentine;878;15;893
76;Occitanie;31;3;13;566;Vallègue;519;4;523
76;Occitanie;31;3;13;567;Vallesvilles;435;6;441
76;Occitanie;31;3;07;568;Varennes;272;5;277
76;Occitanie;31;3;13;569;Vaudreuille;384;10;394
76;Occitanie;31;3;13;570;Vaux;305;5;310
76;Occitanie;31;3;13;571;Vendine;285;4;289
76;Occitanie;31;1;12;572;Venerque;2702;86;2788
76;Occitanie;31;3;10;573;Verfeil;3658;71;3729
76;Occitanie;31;1;12;574;Vernet;3059;35;3094
76;Occitanie;31;3;04;575;Vieille-Toulouse;1168;37;1205
76;Occitanie;31;3;13;576;Vieillevigne;354;7;361
76;Occitanie;31;3;08;577;Vignaux;144;0;144
76;Occitanie;31;3;04;578;Vigoulet-Auzil;931;31;962
76;Occitanie;31;3;10;579;Villariès;790;13;803
76;Occitanie;31;1;12;580;Villate;1007;21;1028
76;Occitanie;31;3;27;581;Villaudric;1578;32;1610
76;Occitanie;31;3;13;582;Villefranche-de-Lauragais;4806;65;4871
76;Occitanie;31;3;27;583;Villematier;1083;25;1108
76;Occitanie;31;3;27;584;Villemur-sur-Tarn;6034;88;6122
76;Occitanie;31;2;14;585;Villeneuve-de-Rivière;1790;42;1832
76;Occitanie;31;2;14;586;Villeneuve-Lécussan;561;3;564
76;Occitanie;31;3;27;587;Villeneuve-lès-Bouloc;1627;12;1639
76;Occitanie;31;3;26;588;Villeneuve-Tolosane;10050;126;10176
76;Occitanie;31;3;13;589;Villenouvelle;1431;19;1450
76;Occitanie;31;2;02;590;Binos;45;0;45
76;Occitanie;31;2;02;591;Escoulis;79;1;80
76;Occitanie;31;3;08;592;Larra;2046;32;2078
76;Occitanie;31;2;06;593;Cazac;86;0;86
76;Occitanie;32;3;01;001;Aignan;726;54;780
76;Occitanie;32;1;05;002;Ansan;79;5;84
76;Occitanie;32;1;10;003;Antras;46;2;48
76;Occitanie;32;3;01;004;Arblade-le-Bas;136;2;138
76;Occitanie;32;2;12;005;Arblade-le-Haut;322;5;327
76;Occitanie;32;2;11;007;Ardizas;223;5;228
76;Occitanie;32;3;16;008;Armentieux;74;0;74
76;Occitanie;32;3;16;009;Armous-et-Cau;90;1;91
76;Occitanie;32;3;03;010;Arrouède;96;0;96
76;Occitanie;32;1;05;012;Aubiet;1107;29;1136
76;Occitanie;32;1;99;013;Auch;22173;1103;23276
76;Occitanie;32;1;10;014;Augnax;115;5;120
76;Occitanie;32;3;03;015;Aujan-Mournède;89;1;90
76;Occitanie;32;1;13;016;Auradé;672;16;688
76;Occitanie;32;3;01;017;Aurensan;133;5;138
76;Occitanie;32;1;03;018;Aurimont;213;3;216
76;Occitanie;32;1;06;019;Auterive;516;17;533
76;Occitanie;32;3;15;020;Aux-Aussat;275;9;284
76;Occitanie;32;2;11;021;Avensac;74;1;75
76;Occitanie;32;3;01;022;Avéron-Bergelle;165;6;171
76;Occitanie;32;2;09;023;Avezan;112;3;115
76;Occitanie;32;1;07;024;Ayguetinte;162;3;165
76;Occitanie;32;2;12;025;Ayzieu;160;2;162
76;Occitanie;32;2;11;026;Bajonnette;111;0;111
76;Occitanie;32;3;01;027;Barcelonne-du-Gers;1368;38;1406
76;Occitanie;32;3;15;028;Barcugnan;105;3;108
76;Occitanie;32;3;04;029;Barran;664;20;684
76;Occitanie;32;3;16;030;Bars;123;3;126
76;Occitanie;32;2;08;031;Bascous;169;2;171
76;Occitanie;32;3;16;032;Bassoues;319;4;323
76;Occitanie;32;1;08;033;Bazian;107;0;107
76;Occitanie;32;3;15;034;Bazugues;53;3;56
76;Occitanie;32;2;07;035;Beaucaire;241;4;245
76;Occitanie;32;3;16;036;Beaumarchés;661;40;701
76;Occitanie;32;2;02;037;Beaumont;129;7;136
76;Occitanie;32;1;11;038;Beaupuy;206;8;214
76;Occitanie;32;3;15;039;Beccas;119;4;123
76;Occitanie;32;1;03;040;Bédéchan;136;1;137
76;Occitanie;32;3;03;041;Bellegarde;173;4;177
76;Occitanie;32;3;15;042;Belloc-Saint-Clamens;130;4;134
76;Occitanie;32;1;08;043;Belmont;150;4;154
76;Occitanie;32;2;07;044;Béraut;311;9;320
76;Occitanie;32;3;15;045;Berdoues;418;19;437
76;Occitanie;32;3;01;046;Bernède;205;1;206
76;Occitanie;32;2;14;047;Berrac;111;1;112
76;Occitanie;32;1;17;048;Betcave-Aguin;88;0;88
76;Occitanie;32;2;12;049;Bétous;76;3;79
76;Occitanie;32;3;15;050;Betplan;97;4;101
76;Occitanie;32;1;17;051;Bézéril;129;2;131
76;Occitanie;32;1;08;052;Bezolles;137;4;141
76;Occitanie;32;3;03;053;Bézues-Bajon;193;3;196
76;Occitanie;32;1;10;054;Biran;384;9;393
76;Occitanie;32;2;09;055;Bivès;134;2;136
76;Occitanie;32;1;05;056;Blanquefort;49;3;52
76;Occitanie;32;2;07;057;Blaziert;131;3;134
76;Occitanie;32;3;16;058;Blousson-Sérian;41;2;43
76;Occitanie;32;1;10;059;Bonas;135;2;137
76;Occitanie;32;3;06;060;Boucagnères;221;4;225
76;Occitanie;32;1;03;061;Boulaur;186;3;189
76;Occitanie;32;2;12;062;Bourrouillan;162;2;164
76;Occitanie;32;3;01;063;Bouzon-Gellenave;174;8;182
76;Occitanie;32;2;02;064;Bretagne-d'Armagnac;403;12;415
76;Occitanie;32;3;04;065;Le Brouilh-Monbert;249;3;252
76;Occitanie;32;2;09;066;Brugnens;253;12;265
76;Occitanie;32;3;03;067;Cabas-Loumassès;51;4;55
76;Occitanie;32;2;09;068;Cadeilhan;138;3;141
76;Occitanie;32;1;17;069;Cadeillan;66;3;69
76;Occitanie;32;3;01;070;Cahuzac-sur-Adour;211;3;214
76;Occitanie;32;1;08;071;Caillavet;185;9;194
76;Occitanie;32;1;08;072;Callian;49;1;50
76;Occitanie;32;2;12;073;Campagne-d'Armagnac;215;3;218
76;Occitanie;32;2;02;075;Cassaigne;228;4;232
76;Occitanie;32;1;03;076;Castelnau-Barbarens;546;10;556
76;Occitanie;32;3;16;077;Castelnau-d'Anglès;87;2;89
76;Occitanie;32;2;09;078;Castelnau-d'Arbieu;231;9;240
76;Occitanie;32;2;02;079;Castelnau d'Auzan Labarrère;1215;22;1237
76;Occitanie;32;2;07;080;Castelnau-sur-l'Auvignon;143;6;149
76;Occitanie;32;3;01;081;Castelnavet;131;2;133
76;Occitanie;32;2;14;082;Castéra-Lectourois;353;6;359
76;Occitanie;32;1;07;083;Castéra-Verduzan;1006;24;1030
76;Occitanie;32;2;09;084;Castéron;52;2;54
76;Occitanie;32;2;14;085;Castet-Arrouy;173;7;180
76;Occitanie;32;3;15;086;Castex;78;2;80
76;Occitanie;32;2;12;087;Castex-d'Armagnac;121;4;125
76;Occitanie;32;1;08;088;Castillon-Debats;324;0;324
76;Occitanie;32;1;10;089;Castillon-Massas;247;6;253
76;Occitanie;32;1;17;090;Castillon-Savès;341;8;349
76;Occitanie;32;1;10;091;Castin;358;17;375
76;Occitanie;32;2;11;092;Catonvielle;92;4;96
76;Occitanie;32;3;01;093;Caumont;103;7;110
76;Occitanie;32;2;12;094;Caupenne-d'Armagnac;429;16;445
76;Occitanie;32;2;07;095;Caussens;601;12;613
76;Occitanie;32;2;12;096;Cazaubon;1654;36;1690
76;Occitanie;32;1;08;097;Cazaux-d'Anglès;116;2;118
76;Occitanie;32;1;17;098;Cazaux-Savès;323;5;328
76;Occitanie;32;3;16;099;Cazaux-Villecomtal;72;2;74
76;Occitanie;32;2;02;100;Cazeneuve;163;4;167
76;Occitanie;32;2;09;101;Céran;227;3;230
76;Occitanie;32;2;09;102;Cézan;228;2;230
76;Occitanie;32;3;03;103;Chélan;166;8;174
76;Occitanie;32;3;15;104;Clermont-Pouyguillès;162;3;165
76;Occitanie;32;1;13;105;Clermont-Savès;397;11;408
76;Occitanie;32;2;11;106;Cologne;927;70;997
76;Occitanie;32;2;07;107;Condom;6493;206;6699
76;Occitanie;32;3;01;108;Corneillan;153;10;163
76;Occitanie;32;3;16;109;Couloumé-Mondebat;194;5;199
76;Occitanie;32;2;08;110;Courrensan;399;5;404
76;Occitanie;32;3;16;111;Courties;51;0;51
76;Occitanie;32;1;10;112;Crastes;252;12;264
76;Occitanie;32;2;12;113;Cravencères;90;1;91
76;Occitanie;32;3;03;114;Cuélas;123;5;128
76;Occitanie;32;2;08;115;Dému;328;3;331
76;Occitanie;32;3;15;116;Duffort;149;4;153
76;Occitanie;32;1;10;117;Duran;853;28;881
76;Occitanie;32;3;06;118;Durban;138;5;143
76;Occitanie;32;2;02;119;Eauze;3975;71;4046
76;Occitanie;32;2;11;120;Encausse;425;9;434
76;Occitanie;32;1;13;121;Endoufielle;506;16;522
76;Occitanie;32;3;03;122;Esclassan-Labastide;345;10;355
76;Occitanie;32;1;11;123;Escornebœuf;566;13;579
76;Occitanie;32;1;17;124;Espaon;187;0;187
76;Occitanie;32;2;12;125;Espas;125;1;126
76;Occitanie;32;3;15;126;Estampes;161;1;162
76;Occitanie;32;2;12;127;Estang;656;15;671
76;Occitanie;32;3;16;128;Estipouy;204;12;216
76;Occitanie;32;2;09;129;Estramiac;149;0;149
76;Occitanie;32;3;03;130;Faget-Abbatial;217;1;218
76;Occitanie;32;2;14;131;Flamarens;157;2;159
76;Occitanie;32;2;09;132;Fleurance;5924;111;6035
76;Occitanie;32;2;02;133;Fourcès;261;2;263
76;Occitanie;32;1;13;134;Frégouville;344;6;350
76;Occitanie;32;3;01;135;Fustérouau;134;5;139
76;Occitanie;32;3;16;136;Galiax;174;5;179
76;Occitanie;32;1;17;138;Garravet;154;4;158
76;Occitanie;32;2;09;139;Gaudonville;112;1;113
76;Occitanie;32;1;17;140;Gaujac;70;0;70
76;Occitanie;32;1;17;141;Gaujan;115;0;115
76;Occitanie;32;2;09;142;Gavarret-sur-Aulouste;139;2;141
76;Occitanie;32;2;14;143;Gazaupouy;273;11;284
76;Occitanie;32;1;08;144;Gazax-et-Baccarisse;73;0;73
76;Occitanie;32;3;01;145;Gée-Rivière;47;2;49
76;Occitanie;32;2;14;146;Gimbrède;272;4;276
76;Occitanie;32;1;11;147;Gimont;3016;69;3085
76;Occitanie;32;1;11;148;Giscaro;103;0;103
76;Occitanie;32;2;02;149;Gondrin;1201;35;1236
76;Occitanie;32;2;09;150;Goutz;213;6;219
76;Occitanie;32;3;01;151;Goux;63;0;63
76;Occitanie;32;3;15;152;Haget;335;11;346
76;Occitanie;32;3;06;153;Haulies;168;1;169
76;Occitanie;32;2;11;154;Homps;111;1;112
76;Occitanie;32;2;12;155;Le Houga;1161;51;1212
76;Occitanie;32;3;15;156;Idrac-Respaillès;216;4;220
76;Occitanie;32;1;05;157;L'Isle-Arné;190;3;193
76;Occitanie;32;2;14;158;L'Isle-Bouzon;241;10;251
76;Occitanie;32;3;16;159;L'Isle-de-Noé;550;14;564
76;Occitanie;32;1;13;160;L'Isle-Jourdain;9072;222;9294
76;Occitanie;32;3;16;161;Izotges;91;4;95
76;Occitanie;32;1;10;162;Jegun;1147;50;1197
76;Occitanie;32;3;16;163;Jû-Belloc;295;9;304
76;Occitanie;32;3;16;164;Juillac;115;2;117
76;Occitanie;32;1;05;165;Juilles;219;6;225
76;Occitanie;32;1;08;166;Justian;121;1;122
76;Occitanie;32;3;15;167;Laas;308;5;313
76;Occitanie;32;3;03;169;Labarthe;147;4;151
76;Occitanie;32;3;01;170;Labarthète;141;3;144
76;Occitanie;32;1;17;171;Labastide-Savès;179;1;180
76;Occitanie;32;3;15;172;Labéjan;295;15;310
76;Occitanie;32;2;11;173;Labrihe;213;8;221
76;Occitanie;32;3;16;174;Ladevèze-Rivière;222;4;226
76;Occitanie;32;3;16;175;Ladevèze-Ville;220;7;227
76;Occitanie;32;2;14;176;Lagarde;122;5;127
76;Occitanie;32;3;15;177;Lagarde-Hachan;168;5;173
76;Occitanie;32;2;07;178;Lagardère;77;3;80
76;Occitanie;32;2;02;180;Lagraulet-du-Gers;562;9;571
76;Occitanie;32;3;15;181;Laguian-Mazous;245;2;247
76;Occitanie;32;1;17;182;Lahas;180;6;186
76;Occitanie;32;1;05;183;Lahitte;232;11;243
76;Occitanie;32;2;09;184;Lalanne;131;3;134
76;Occitanie;32;3;03;185;Lalanne-Arqué;153;4;157
76;Occitanie;32;3;03;186;Lamaguère;80;0;80
76;Occitanie;32;3;15;187;Lamazère;119;7;126
76;Occitanie;32;2;09;188;Lamothe-Goas;78;3;81
76;Occitanie;32;2;12;189;Lannemaignan;106;3;109
76;Occitanie;32;2;08;190;Lannepax;507;6;513
76;Occitanie;32;2;12;191;Lanne-Soubiran;145;1;146
76;Occitanie;32;3;01;192;Lannux;234;7;241
76;Occitanie;32;2;12;193;Larée;233;3;236
76;Occitanie;32;2;02;194;Larressingle;208;7;215
76;Occitanie;32;2;14;195;Larroque-Engalin;45;2;47
76;Occitanie;32;2;07;196;Larroque-Saint-Sernin;165;0;165
76;Occitanie;32;2;02;197;Larroque-sur-l'Osse;223;6;229
76;Occitanie;32;1;03;198;Lartigue;193;4;197
76;Occitanie;32;3;16;199;Lasserrade;190;9;199
76;Occitanie;32;3;04;200;Lasséran;372;11;383
76;Occitanie;32;3;06;201;Lasseube-Propre;339;7;346
76;Occitanie;32;2;12;202;Laujuzan;280;15;295
76;Occitanie;32;2;02;203;Lauraët;253;3;256
76;Occitanie;32;1;10;204;Lavardens;369;11;380
76;Occitanie;32;3;16;205;Laveraët;107;1;108
76;Occitanie;32;1;17;206;Laymont;213;3;216
76;Occitanie;32;1;05;207;Leboulin;342;17;359
76;Occitanie;32;2;14;208;Lectoure;3672;355;4027
76;Occitanie;32;3;01;209;Lelin-Lapujolle;283;3;286
76;Occitanie;32;1;13;210;Lias;736;15;751
76;Occitanie;32;2;12;211;Lias-d'Armagnac;195;7;202
76;Occitanie;32;2;14;212;Ligardes;215;4;219
76;Occitanie;32;1;17;213;Lombez;2156;36;2192
76;Occitanie;32;2;12;214;Loubédat;101;3;104
76;Occitanie;32;3;15;215;Loubersan;146;10;156
76;Occitanie;32;3;03;216;Lourties-Monbrun;166;1;167
76;Occitanie;32;3;16;217;Louslitges;61;2;63
76;Occitanie;32;3;01;218;Loussous-Débat;63;0;63
76;Occitanie;32;1;08;219;Lupiac;307;11;318
76;Occitanie;32;2;12;220;Luppé-Violles;142;3;145
76;Occitanie;32;1;05;221;Lussan;236;3;239
76;Occitanie;32;2;12;222;Magnan;234;3;237
76;Occitanie;32;2;09;223;Magnas;60;31;91
76;Occitanie;32;2;07;224;Maignaut-Tauzia;234;2;236
76;Occitanie;32;3;15;225;Malabat;104;5;109
76;Occitanie;32;3;15;226;Manas-Bastanous;82;5;87
76;Occitanie;32;2;12;227;Manciet;804;27;831
76;Occitanie;32;3;03;228;Manent-Montané;92;1;93
76;Occitanie;32;2;11;229;Mansempuy;71;8;79
76;Occitanie;32;2;02;230;Mansencôme;46;4;50
76;Occitanie;32;1;08;231;Marambat;437;14;451
76;Occitanie;32;2;11;232;Maravat;41;0;41
76;Occitanie;32;3;16;233;Marciac;1208;85;1293
76;Occitanie;32;1;13;234;Marestaing;330;7;337
76;Occitanie;32;3;01;235;Margouët-Meymes;161;8;169
76;Occitanie;32;2;12;236;Marguestau;65;3;68
76;Occitanie;32;1;05;237;Marsan;483;11;494
76;Occitanie;32;3;15;238;Marseillan;86;3;89
76;Occitanie;32;2;14;239;Marsolan;448;11;459
76;Occitanie;32;3;16;240;Mascaras;63;4;67
76;Occitanie;32;2;14;241;Mas-d'Auvignon;170;6;176
76;Occitanie;32;3;03;242;Masseube;1498;397;1895
76;Occitanie;32;2;12;243;Mauléon-d'Armagnac;269;3;272
76;Occitanie;32;3;01;244;Maulichères;164;4;168
76;Occitanie;32;3;01;245;Maumusson-Laguian;147;7;154
76;Occitanie;32;2;12;246;Maupas;201;3;204
76;Occitanie;32;1;11;247;Maurens;309;7;316
76;Occitanie;32;2;09;248;Mauroux;144;4;148
76;Occitanie;32;2;11;249;Mauvezin;2218;50;2268
76;Occitanie;32;3;03;250;Meilhan;77;1;78
76;Occitanie;32;1;10;251;Mérens;69;0;69
76;Occitanie;32;3;15;252;Miélan;1111;20;1131
76;Occitanie;32;2;14;253;Miradoux;525;12;537
76;Occitanie;32;3;15;254;Miramont-d'Astarac;345;14;359
76;Occitanie;32;2;09;255;Miramont-Latour;155;5;160
76;Occitanie;32;3;15;256;Mirande;3450;301;3751
76;Occitanie;32;1;08;257;Mirannes;61;4;65
76;Occitanie;32;1;10;258;Mirepoix;230;5;235
76;Occitanie;32;3;03;260;Monbardon;76;4;80
76;Occitanie;32;1;17;261;Monblanc;370;7;377
76;Occitanie;32;2;11;262;Monbrun;394;14;408
76;Occitanie;32;3;15;263;Moncassin;127;3;130
76;Occitanie;32;2;12;264;Monclar;211;3;214
76;Occitanie;32;3;16;265;Monclar-sur-Losse;108;2;110
76;Occitanie;32;3;03;266;Moncorneil-Grazan;145;1;146
76;Occitanie;32;3;03;267;Monferran-Plavès;113;2;115
76;Occitanie;32;1;13;268;Monferran-Savès;811;29;840
76;Occitanie;32;2;11;269;Monfort;496;4;500
76;Occitanie;32;1;17;270;Mongausy;84;1;85
76;Occitanie;32;2;12;271;Monguilhem;298;8;306
76;Occitanie;32;3;03;272;Monlaur-Bernet;167;3;170
76;Occitanie;32;3;16;273;Monlezun;179;11;190
76;Occitanie;32;2;12;274;Monlezun-d'Armagnac;205;3;208
76;Occitanie;32;3;16;275;Monpardiac;45;1;46
76;Occitanie;32;1;17;276;Montadet;71;1;72
76;Occitanie;32;1;17;277;Montamat;121;3;124
76;Occitanie;32;3;15;278;Montaut;118;7;125
76;Occitanie;32;1;10;279;Montaut-les-Créneaux;710;19;729
76;Occitanie;32;3;03;280;Mont-d'Astarac;94;2;96
76;Occitanie;32;3;15;281;Mont-de-Marrast;107;5;112
76;Occitanie;32;1;05;282;Montégut;677;12;689
76;Occitanie;32;3;15;283;Montégut-Arros;284;7;291
76;Occitanie;32;1;17;284;Montégut-Savès;63;1;64
76;Occitanie;32;3;16;285;Montesquiou;572;18;590
76;Occitanie;32;2;09;286;Montestruc-sur-Gers;701;11;712
76;Occitanie;32;3;03;287;Monties;79;1;80
76;Occitanie;32;1;05;288;Montiron;145;3;148
76;Occitanie;32;1;17;289;Montpézat;239;4;243
76;Occitanie;32;2;02;290;Montréal;1171;34;1205
76;Occitanie;32;2;12;291;Mormès;120;2;122
76;Occitanie;32;2;02;292;Mouchan;397;13;410
76;Occitanie;32;3;16;293;Mouchès;74;2;76
76;Occitanie;32;1;08;294;Mourède;75;3;78
76;Occitanie;32;1;17;295;Nizas;138;8;146
76;Occitanie;32;2;12;296;Nogaro;2027;165;2192
76;Occitanie;32;1;17;297;Noilhan;378;11;389
76;Occitanie;32;1;05;298;Nougaroulet;372;12;384
76;Occitanie;32;2;08;299;Noulens;101;0;101
76;Occitanie;32;3;06;300;Orbessan;294;3;297
76;Occitanie;32;1;10;301;Ordan-Larroque;895;24;919
76;Occitanie;32;3;06;302;Ornézan;226;11;237
76;Occitanie;32;3;16;303;Pallanne;62;2;64
76;Occitanie;32;3;03;304;Panassac;290;9;299
76;Occitanie;32;2;12;305;Panjas;412;8;420
76;Occitanie;32;2;09;306;Pauilhac;615;48;663
76;Occitanie;32;1;04;307;Pavie;2501;119;2620
76;Occitanie;32;1;17;308;Pébées;108;2;110
76;Occitanie;32;1;17;309;Pellefigue;114;5;119
76;Occitanie;32;2;12;310;Perchède;123;1;124
76;Occitanie;32;2;14;311;Pergain-Taillac;325;6;331
76;Occitanie;32;1;06;312;Pessan;672;14;686
76;Occitanie;32;2;09;313;Pessoulens;139;4;143
76;Occitanie;32;2;14;314;Peyrecave;75;5;80
76;Occitanie;32;1;08;315;Peyrusse-Grande;156;2;158
76;Occitanie;32;1;10;316;Peyrusse-Massas;106;3;109
76;Occitanie;32;1;08;317;Peyrusse-Vieille;67;1;68
76;Occitanie;32;2;09;318;Pis;111;2;113
76;Occitanie;32;3;16;319;Plaisance;1429;26;1455
76;Occitanie;32;2;14;320;Plieux;150;7;157
76;Occitanie;32;1;17;321;Polastron;273;5;278
76;Occitanie;32;1;17;322;Pompiac;203;3;206
76;Occitanie;32;3;15;323;Ponsampère;108;5;113
76;Occitanie;32;3;03;324;Ponsan-Soubiran;80;3;83
76;Occitanie;32;3;01;325;Pouydraguin;130;3;133
76;Occitanie;32;3;16;326;Pouylebon;145;4;149
76;Occitanie;32;3;03;327;Pouy-Loubrin;85;1;86
76;Occitanie;32;2;14;328;Pouy-Roquelaure;120;6;126
76;Occitanie;32;2;09;329;Préchac;163;3;166
76;Occitanie;32;3;16;330;Préchac-sur-Adour;195;5;200
76;Occitanie;32;1;10;331;Preignan;1250;35;1285
76;Occitanie;32;1;08;332;Préneron;126;1;127
76;Occitanie;32;3;01;333;Projan;182;0;182
76;Occitanie;32;1;13;334;Pujaudran;1578;39;1617
76;Occitanie;32;1;10;335;Puycasquier;447;9;456
76;Occitanie;32;1;17;336;Puylausic;160;9;169
76;Occitanie;32;2;09;337;Puységur;74;3;77
76;Occitanie;32;2;08;338;Ramouzens;168;5;173
76;Occitanie;32;1;11;339;Razengues;245;9;254
76;Occitanie;32;2;12;340;Réans;286;3;289
76;Occitanie;32;2;09;341;Réjaumont;245;4;249
76;Occitanie;32;3;16;342;Ricourt;57;2;59
76;Occitanie;32;1;08;343;Riguepeu;175;7;182
76;Occitanie;32;3;01;344;Riscle;1829;100;1929
76;Occitanie;32;2;14;345;La Romieu;568;15;583
76;Occitanie;32;1;08;346;Roquebrune;212;5;217
76;Occitanie;32;1;10;347;Roquefort;283;7;290
76;Occitanie;32;1;10;348;Roquelaure;562;23;585
76;Occitanie;32;2;11;349;Roquelaure-Saint-Aubin;103;4;107
76;Occitanie;32;2;07;350;Roquepine;33;2;35
76;Occitanie;32;1;08;351;Roques;108;1;109
76;Occitanie;32;1;08;352;Rozès;115;4;119
76;Occitanie;32;1;17;353;Sabaillan;146;7;153
76;Occitanie;32;3;01;354;Sabazan;138;1;139
76;Occitanie;32;3;15;355;Sadeillan;86;2;88
76;Occitanie;32;1;17;356;Saint-André;127;1;128
76;Occitanie;32;2;11;357;Sainte-Anne;128;1;129
76;Occitanie;32;2;14;358;Saint-Antoine;190;4;194
76;Occitanie;32;2;11;359;Saint-Antonin;154;5;159
76;Occitanie;32;1;08;360;Saint-Arailles;139;3;142
76;Occitanie;32;3;03;361;Saint-Arroman;136;8;144
76;Occitanie;32;3;16;362;Saint-Aunix-Lengros;143;3;146
76;Occitanie;32;3;15;363;Sainte-Aurence-Cazaux;95;4;99
76;Occitanie;32;2;14;364;Saint-Avit-Frandat;95;3;98
76;Occitanie;32;3;03;365;Saint-Blancard;335;6;341
76;Occitanie;32;2;11;366;Saint-Brès;74;1;75
76;Occitanie;32;3;16;367;Saint-Christaud;64;2;66
76;Occitanie;32;1;10;368;Sainte-Christie;544;11;555
76;Occitanie;32;2;12;369;Sainte-Christie-d'Armagnac;376;12;388
76;Occitanie;32;2;09;370;Saint-Clar;1046;66;1112
76;Occitanie;32;2;09;371;Saint-Créac;80;1;81
76;Occitanie;32;2;11;372;Saint-Cricq;288;4;292
76;Occitanie;32;3;15;373;Sainte-Dode;204;10;214
76;Occitanie;32;1;17;374;Saint-Élix-d'Astarac;181;6;187
76;Occitanie;32;3;15;375;Saint-Élix-Theux;95;4;99
76;Occitanie;32;2;11;376;Sainte-Gemme;114;3;117
76;Occitanie;32;2;11;377;Saint-Georges;179;1;180
76;Occitanie;32;3;01;378;Saint-Germé;499;6;505
76;Occitanie;32;2;11;379;Saint-Germier;208;7;215
76;Occitanie;32;2;12;380;Saint-Griède;138;10;148
76;Occitanie;32;3;04;381;Saint-Jean-le-Comtal;411;20;431
76;Occitanie;32;1;08;382;Saint-Jean-Poutge;309;14;323
76;Occitanie;32;3;16;383;Saint-Justin;127;6;133
76;Occitanie;32;1;10;384;Saint-Lary;278;6;284
76;Occitanie;32;2;09;385;Saint-Léonard;184;1;185
76;Occitanie;32;1;17;386;Saint-Lizier-du-Planté;143;1;144
76;Occitanie;32;1;17;387;Saint-Loube;101;2;103
76;Occitanie;32;1;11;388;Sainte-Marie;439;7;446
76;Occitanie;32;3;15;389;Saint-Martin;457;20;477
76;Occitanie;32;2;12;390;Saint-Martin-d'Armagnac;240;5;245
76;Occitanie;32;2;14;391;Saint-Martin-de-Goyne;122;7;129
76;Occitanie;32;1;03;392;Saint-Martin-Gimois;88;1;89
76;Occitanie;32;3;15;393;Saint-Maur;137;5;142
76;Occitanie;32;3;15;394;Saint-Médard;338;5;343
76;Occitanie;32;2;14;395;Sainte-Mère;209;4;213
76;Occitanie;32;2;14;396;Saint-Mézard;234;3;237
76;Occitanie;32;3;15;397;Saint-Michel;244;14;258
76;Occitanie;32;3;01;398;Saint-Mont;315;10;325
76;Occitanie;32;2;11;399;Saint-Orens;81;3;84
76;Occitanie;32;2;07;400;Saint-Orens-Pouy-Petit;208;9;217
76;Occitanie;32;3;15;401;Saint-Ost;89;1;90
76;Occitanie;32;1;08;402;Saint-Paul-de-Baïse;106;3;109
76;Occitanie;32;1;08;403;Saint-Pierre-d'Aubézies;61;1;62
76;Occitanie;32;2;07;404;Saint-Puy;589;15;604
76;Occitanie;32;2;09;405;Sainte-Radegonde;178;6;184
76;Occitanie;32;1;11;406;Saint-Sauvy;355;10;365
76;Occitanie;32;1;17;407;Saint-Soulan;160;4;164
76;Occitanie;32;2;12;408;Salles-d'Armagnac;134;4;138
76;Occitanie;32;3;03;409;Samaran;91;0;91
76;Occitanie;32;1;17;410;Samatan;2328;102;2430
76;Occitanie;32;3;06;411;Sansan;100;3;103
76;Occitanie;32;1;03;412;Saramon;842;14;856
76;Occitanie;32;3;03;413;Sarcos;82;2;84
76;Occitanie;32;3;01;414;Sarragachies;231;6;237
76;Occitanie;32;3;15;415;Sarraguzan;90;1;91
76;Occitanie;32;2;11;416;Sarrant;361;15;376
76;Occitanie;32;2;09;417;La Sauvetat;403;13;416
76;Occitanie;32;1;17;418;Sauveterre;279;64;343
76;Occitanie;32;3;15;419;Sauviac;106;3;109
76;Occitanie;32;1;17;420;Sauvimont;66;2;68
76;Occitanie;32;1;17;421;Savignac-Mona;139;1;140
76;Occitanie;32;3;16;422;Scieurac-et-Flourès;43;1;44
76;Occitanie;32;2;08;423;Séailles;57;3;60
76;Occitanie;32;3;01;424;Ségos;225;8;233
76;Occitanie;32;1;13;425;Ségoufielle;1168;28;1196
76;Occitanie;32;3;03;426;Seissan;1096;10;1106
76;Occitanie;32;3;16;427;Sembouès;60;1;61
76;Occitanie;32;1;03;428;Sémézies-Cachan;66;4;70
76;Occitanie;32;2;14;429;Sempesserre;296;5;301
76;Occitanie;32;3;03;430;Sère;80;0;80
76;Occitanie;32;2;11;431;Sérempuy;39;4;43
76;Occitanie;32;1;17;432;Seysses-Savès;242;2;244
76;Occitanie;32;1;17;433;Simorre;711;17;728
76;Occitanie;32;2;12;434;Sion;97;3;100
76;Occitanie;32;2;11;435;Sirac;167;9;176
76;Occitanie;32;2;11;436;Solomiac;482;6;488
76;Occitanie;32;2;12;437;Sorbets;227;6;233
76;Occitanie;32;3;03;438;Tachoires;101;0;101
76;Occitanie;32;3;01;439;Tarsac;169;2;171
76;Occitanie;32;3;16;440;Tasque;250;6;256
76;Occitanie;32;2;09;441;Taybosc;61;0;61
76;Occitanie;32;2;14;442;Terraube;381;4;385
76;Occitanie;32;3;01;443;Termes-d'Armagnac;186;3;189
76;Occitanie;32;2;11;444;Thoux;260;7;267
76;Occitanie;32;3;16;445;Tieste-Uragnoux;156;5;161
76;Occitanie;32;3;16;446;Tillac;285;6;291
76;Occitanie;32;1;03;447;Tirent-Pontéjac;91;1;92
76;Occitanie;32;2;11;448;Touget;507;16;523
76;Occitanie;32;2;12;449;Toujouse;272;2;274
76;Occitanie;32;3;16;450;Tourdun;128;4;132
76;Occitanie;32;1;17;451;Tournan;182;2;184
76;Occitanie;32;2;09;452;Tournecoupe;260;8;268
76;Occitanie;32;1;10;453;Tourrenquets;111;6;117
76;Occitanie;32;3;03;454;Traversères;69;3;72
76;Occitanie;32;3;16;455;Troncens;183;5;188
76;Occitanie;32;1;08;456;Tudelle;53;0;53
76;Occitanie;32;2;09;457;Urdens;282;13;295
76;Occitanie;32;2;12;458;Urgosse;233;3;236
76;Occitanie;32;2;07;459;Valence-sur-Baïse;1122;20;1142
76;Occitanie;32;3;01;460;Vergoignan;306;8;314
76;Occitanie;32;3;01;461;Verlus;114;3;117
76;Occitanie;32;1;08;462;Vic-Fezensac;3546;61;3607
76;Occitanie;32;3;01;463;Viella;511;11;522
76;Occitanie;32;3;15;464;Villecomtal-sur-Arros;840;20;860
76;Occitanie;32;1;17;465;Villefranche;123;5;128
76;Occitanie;32;3;15;466;Viozan;114;2;116
76;Occitanie;32;1;05;467;Saint-Caprais;142;4;146
76;Occitanie;32;3;03;468;Aussos;84;0;84
75;Nouvelle-Aquitaine;33;5;21;001;Abzac;1982;26;2008
75;Nouvelle-Aquitaine;33;3;27;002;Aillas;834;14;848
75;Nouvelle-Aquitaine;33;2;26;003;Ambarès-et-Lagrave;16636;156;16792
75;Nouvelle-Aquitaine;33;2;26;004;Ambès;3053;19;3072
75;Nouvelle-Aquitaine;33;6;01;005;Andernos-les-Bains;12242;275;12517
75;Nouvelle-Aquitaine;33;1;13;006;Anglade;931;12;943
75;Nouvelle-Aquitaine;33;3;15;007;Arbanats;1335;7;1342
75;Nouvelle-Aquitaine;33;3;12;008;Porte-de-Benauge;489;8;497
75;Nouvelle-Aquitaine;33;6;32;009;Arcachon;11630;268;11898
75;Nouvelle-Aquitaine;33;4;30;010;Arcins;529;7;536
75;Nouvelle-Aquitaine;33;6;01;011;Arès;6381;122;6503
75;Nouvelle-Aquitaine;33;4;30;012;Arsac;3747;48;3795
75;Nouvelle-Aquitaine;33;2;17;013;Artigues-près-Bordeaux;8656;79;8735
75;Nouvelle-Aquitaine;33;5;21;014;Les Artigues-de-Lussac;1110;21;1131
75;Nouvelle-Aquitaine;33;5;16;015;Arveyres;1992;41;2033
75;Nouvelle-Aquitaine;33;5;16;016;Asques;443;9;452
75;Nouvelle-Aquitaine;33;3;29;017;Aubiac;276;11;287
75;Nouvelle-Aquitaine;33;1;20;018;Val de Virvée;3621;42;3663
75;Nouvelle-Aquitaine;33;6;01;019;Audenge;8680;121;8801
75;Nouvelle-Aquitaine;33;3;27;020;Auriolles;143;0;143
75;Nouvelle-Aquitaine;33;3;27;021;Auros;1049;14;1063
75;Nouvelle-Aquitaine;33;4;30;022;Avensan;3018;41;3059
75;Nouvelle-Aquitaine;33;2;08;023;Ayguemorte-les-Graves;1332;16;1348
75;Nouvelle-Aquitaine;33;3;27;024;Bagas;301;9;310
75;Nouvelle-Aquitaine;33;3;12;025;Baigneaux;450;4;454
75;Nouvelle-Aquitaine;33;3;15;026;Balizac;497;5;502
75;Nouvelle-Aquitaine;33;3;27;027;Barie;289;9;298
75;Nouvelle-Aquitaine;33;5;10;028;Baron;1170;16;1186
75;Nouvelle-Aquitaine;33;6;15;029;Le Barp;5605;81;5686
75;Nouvelle-Aquitaine;33;3;15;030;Barsac;2074;22;2096
75;Nouvelle-Aquitaine;33;3;27;031;Bassanne;131;5;136
75;Nouvelle-Aquitaine;33;2;17;032;Bassens;7472;61;7533
75;Nouvelle-Aquitaine;33;2;11;033;Baurech;919;7;926
75;Nouvelle-Aquitaine;33;5;21;034;Bayas;460;4;464
75;Nouvelle-Aquitaine;33;1;13;035;Bayon-sur-Gironde;721;2;723
75;Nouvelle-Aquitaine;33;3;29;036;Bazas;4801;256;5057
75;Nouvelle-Aquitaine;33;2;08;037;Beautiran;2330;39;2369
75;Nouvelle-Aquitaine;33;4;22;038;Bégadan;915;8;923
75;Nouvelle-Aquitaine;33;2;96;039;Bègles;30642;349;30991
75;Nouvelle-Aquitaine;33;3;12;040;Béguey;1202;13;1215
75;Nouvelle-Aquitaine;33;6;15;042;Belin-Béliet;5732;93;5825
75;Nouvelle-Aquitaine;33;3;12;043;Bellebat;278;1;279
75;Nouvelle-Aquitaine;33;3;12;044;Bellefond;220;6;226
75;Nouvelle-Aquitaine;33;5;10;045;Belvès-de-Castillon;335;8;343
75;Nouvelle-Aquitaine;33;3;29;046;Bernos-Beaulac;1125;30;1155
75;Nouvelle-Aquitaine;33;1;13;047;Berson;1812;31;1843
75;Nouvelle-Aquitaine;33;3;27;048;Berthez;266;7;273
75;Nouvelle-Aquitaine;33;2;26;049;Beychac-et-Caillau;2489;27;2516
75;Nouvelle-Aquitaine;33;3;29;050;Bieujac;639;8;647
75;Nouvelle-Aquitaine;33;6;01;051;Biganos;10990;123;11113
75;Nouvelle-Aquitaine;33;5;16;052;Les Billaux;1148;35;1183
75;Nouvelle-Aquitaine;33;3;29;053;Birac;229;1;230
75;Nouvelle-Aquitaine;33;3;27;054;Blaignac;286;5;291
75;Nouvelle-Aquitaine;33;4;22;055;Blaignan-Prignac;464;4;468
75;Nouvelle-Aquitaine;33;2;25;056;Blanquefort;15419;605;16024
75;Nouvelle-Aquitaine;33;3;27;057;Blasimon;909;20;929
75;Nouvelle-Aquitaine;33;1;13;058;Blaye;4838;112;4950
75;Nouvelle-Aquitaine;33;2;12;059;Blésignac;306;6;312
75;Nouvelle-Aquitaine;33;3;29;060;Bommes;454;67;521
75;Nouvelle-Aquitaine;33;2;11;061;Bonnetan;990;19;1009
75;Nouvelle-Aquitaine;33;5;21;062;Bonzac;742;12;754
75;Nouvelle-Aquitaine;33;2;97;063;Bordeaux;260958;3299;264257
75;Nouvelle-Aquitaine;33;5;10;064;Bossugan;38;0;38
75;Nouvelle-Aquitaine;33;2;09;065;Bouliac;3706;72;3778
75;Nouvelle-Aquitaine;33;3;27;066;Bourdelles;90;1;91
75;Nouvelle-Aquitaine;33;1;13;067;Bourg;2278;38;2316
75;Nouvelle-Aquitaine;33;3;29;068;Bourideys;93;3;96
75;Nouvelle-Aquitaine;33;2;07;069;Le Bouscat;23890;277;24167
75;Nouvelle-Aquitaine;33;4;30;070;Brach;786;2;788
75;Nouvelle-Aquitaine;33;5;10;071;Branne;1307;17;1324
75;Nouvelle-Aquitaine;33;3;27;072;Brannens;241;4;245
75;Nouvelle-Aquitaine;33;1;13;073;Braud-et-Saint-Louis;1535;29;1564
75;Nouvelle-Aquitaine;33;3;27;074;Brouqueyran;202;8;210
75;Nouvelle-Aquitaine;33;2;07;075;Bruges;19403;187;19590
75;Nouvelle-Aquitaine;33;3;15;076;Budos;808;14;822
75;Nouvelle-Aquitaine;33;2;08;077;Cabanac-et-Villagrains;2413;26;2439
75;Nouvelle-Aquitaine;33;5;10;078;Cabara;507;12;519
75;Nouvelle-Aquitaine;33;5;16;079;Cadarsac;356;7;363
75;Nouvelle-Aquitaine;33;2;08;080;Cadaujac;6464;70;6534
75;Nouvelle-Aquitaine;33;3;12;081;Cadillac;2836;28;2864
75;Nouvelle-Aquitaine;33;5;16;082;Cadillac-en-Fronsadais;1331;16;1347
75;Nouvelle-Aquitaine;33;2;11;083;Camarsac;1019;13;1032
75;Nouvelle-Aquitaine;33;2;11;084;Cambes;1732;17;1749
75;Nouvelle-Aquitaine;33;2;11;085;Camblanes-et-Meynac;2984;142;3126
75;Nouvelle-Aquitaine;33;5;10;086;Camiac-et-Saint-Denis;360;5;365
75;Nouvelle-Aquitaine;33;3;27;087;Camiran;414;5;419
75;Nouvelle-Aquitaine;33;5;21;088;Camps-sur-l'Isle;598;10;608
75;Nouvelle-Aquitaine;33;1;13;089;Campugnan;503;6;509
75;Nouvelle-Aquitaine;33;2;23;090;Canéjan;6061;73;6134
75;Nouvelle-Aquitaine;33;3;12;093;Capian;775;17;792
75;Nouvelle-Aquitaine;33;5;27;094;Caplong;217;7;224
75;Nouvelle-Aquitaine;33;3;29;095;Captieux;1358;21;1379
75;Nouvelle-Aquitaine;33;2;26;096;Carbon-Blanc;8254;82;8336
75;Nouvelle-Aquitaine;33;4;30;097;Carcans;2418;36;2454
75;Nouvelle-Aquitaine;33;3;12;098;Cardan;509;5;514
75;Nouvelle-Aquitaine;33;2;11;099;Carignan-de-Bordeaux;4141;43;4184
75;Nouvelle-Aquitaine;33;1;13;100;Cars;1201;21;1222
75;Nouvelle-Aquitaine;33;1;13;101;Cartelègue;1233;21;1254
75;Nouvelle-Aquitaine;33;3;27;102;Casseuil;383;4;387
75;Nouvelle-Aquitaine;33;3;27;103;Castelmoron-d'Albret;53;0;53
75;Nouvelle-Aquitaine;33;4;30;104;Castelnau-de-Médoc;4804;65;4869
75;Nouvelle-Aquitaine;33;3;27;105;Castelviel;222;12;234
75;Nouvelle-Aquitaine;33;3;29;106;Castets et Castillon;1454;19;1473
75;Nouvelle-Aquitaine;33;5;10;108;Castillon-la-Bataille;3194;35;3229
75;Nouvelle-Aquitaine;33;2;08;109;Castres-Gironde;2391;19;2410
75;Nouvelle-Aquitaine;33;3;12;111;Caudrot;1117;15;1132
75;Nouvelle-Aquitaine;33;3;27;112;Caumont;142;2;144
75;Nouvelle-Aquitaine;33;3;29;113;Cauvignac;154;3;157
75;Nouvelle-Aquitaine;33;1;20;114;Cavignac;2198;15;2213
75;Nouvelle-Aquitaine;33;3;29;115;Cazalis;236;1;237
75;Nouvelle-Aquitaine;33;3;29;116;Cazats;409;5;414
75;Nouvelle-Aquitaine;33;3;27;117;Cazaugitat;225;3;228
75;Nouvelle-Aquitaine;33;2;11;118;Cénac;2082;34;2116
75;Nouvelle-Aquitaine;33;2;09;119;Cenon;25496;227;25723
75;Nouvelle-Aquitaine;33;3;15;120;Cérons;2138;20;2158
75;Nouvelle-Aquitaine;33;3;12;121;Cessac;190;2;192
75;Nouvelle-Aquitaine;33;2;23;122;Cestas;17053;276;17329
75;Nouvelle-Aquitaine;33;1;20;123;Cézac;2654;33;2687
75;Nouvelle-Aquitaine;33;5;21;124;Chamadelle;727;15;742
75;Nouvelle-Aquitaine;33;4;22;125;Cissac-Médoc;2191;27;2218
75;Nouvelle-Aquitaine;33;1;20;126;Civrac-de-Blaye;860;22;882
75;Nouvelle-Aquitaine;33;5;10;127;Civrac-sur-Dordogne;222;5;227
75;Nouvelle-Aquitaine;33;4;22;128;Civrac-en-Médoc;659;14;673
75;Nouvelle-Aquitaine;33;3;27;129;Cleyrac;155;0;155
75;Nouvelle-Aquitaine;33;3;27;130;Coimères;1035;27;1062
75;Nouvelle-Aquitaine;33;3;12;131;Coirac;209;2;211
75;Nouvelle-Aquitaine;33;1;13;132;Comps;550;8;558
75;Nouvelle-Aquitaine;33;5;10;133;Coubeyrac;72;1;73
75;Nouvelle-Aquitaine;33;4;22;134;Couquèques;271;7;278
75;Nouvelle-Aquitaine;33;3;12;135;Courpiac;128;2;130
75;Nouvelle-Aquitaine;33;3;27;136;Cours-de-Monségur;283;4;287
75;Nouvelle-Aquitaine;33;3;29;137;Cours-les-Bains;221;4;225
75;Nouvelle-Aquitaine;33;5;21;138;Coutras;8602;130;8732
75;Nouvelle-Aquitaine;33;3;27;139;Coutures;98;3;101
75;Nouvelle-Aquitaine;33;2;11;140;Créon;4832;100;4932
75;Nouvelle-Aquitaine;33;2;11;141;Croignon;691;9;700
75;Nouvelle-Aquitaine;33;1;20;142;Cubnezais;1650;16;1666
75;Nouvelle-Aquitaine;33;1;20;143;Cubzac-les-Ponts;2501;26;2527
75;Nouvelle-Aquitaine;33;3;29;144;Cudos;792;130;922
75;Nouvelle-Aquitaine;33;2;11;145;Cursan;659;18;677
75;Nouvelle-Aquitaine;33;4;30;146;Cussac-Fort-Médoc;2330;28;2358
75;Nouvelle-Aquitaine;33;5;10;147;Daignac;470;6;476
75;Nouvelle-Aquitaine;33;5;10;148;Dardenac;88;5;93
75;Nouvelle-Aquitaine;33;3;27;149;Daubèze;154;1;155
75;Nouvelle-Aquitaine;33;3;27;150;Dieulivol;340;2;342
75;Nouvelle-Aquitaine;33;1;20;151;Donnezac;915;18;933
75;Nouvelle-Aquitaine;33;3;12;152;Donzac;119;5;124
75;Nouvelle-Aquitaine;33;5;10;153;Doulezon;266;4;270
75;Nouvelle-Aquitaine;33;5;21;154;Les Églisottes-et-Chalaures;2142;101;2243
75;Nouvelle-Aquitaine;33;3;29;155;Escaudes;158;4;162
75;Nouvelle-Aquitaine;33;3;12;156;Escoussans;288;8;296
75;Nouvelle-Aquitaine;33;5;10;157;Espiet;792;15;807
75;Nouvelle-Aquitaine;33;3;27;158;Les Esseintes;240;8;248
75;Nouvelle-Aquitaine;33;1;13;159;Étauliers;1481;14;1495
75;Nouvelle-Aquitaine;33;5;27;160;Eynesse;587;17;604
75;Nouvelle-Aquitaine;33;1;13;161;Eyrans;764;6;770
75;Nouvelle-Aquitaine;33;2;25;162;Eysines;24488;264;24752
75;Nouvelle-Aquitaine;33;3;12;163;Faleyras;433;6;439
75;Nouvelle-Aquitaine;33;3;29;164;Fargues;1651;34;1685
75;Nouvelle-Aquitaine;33;2;11;165;Fargues-Saint-Hilaire;3203;34;3237
75;Nouvelle-Aquitaine;33;5;21;166;Le Fieu;510;4;514
75;Nouvelle-Aquitaine;33;2;09;167;Floirac;18181;97;18278
75;Nouvelle-Aquitaine;33;5;10;168;Flaujagues;587;9;596
75;Nouvelle-Aquitaine;33;3;27;169;Floudès;109;4;113
75;Nouvelle-Aquitaine;33;3;27;170;Fontet;789;16;805
75;Nouvelle-Aquitaine;33;3;27;171;Fossès-et-Baleyssac;231;3;234
75;Nouvelle-Aquitaine;33;1;13;172;Fours;287;13;300
75;Nouvelle-Aquitaine;33;5;21;173;Francs;188;7;195
75;Nouvelle-Aquitaine;33;5;16;174;Fronsac;1142;34;1176
75;Nouvelle-Aquitaine;33;3;12;175;Frontenac;739;10;749
75;Nouvelle-Aquitaine;33;3;12;176;Gabarnac;352;7;359
75;Nouvelle-Aquitaine;33;4;22;177;Gaillan-en-Médoc;2344;42;2386
75;Nouvelle-Aquitaine;33;3;29;178;Gajac;373;3;376
75;Nouvelle-Aquitaine;33;5;16;179;Galgon;3022;55;3077
75;Nouvelle-Aquitaine;33;3;29;180;Gans;190;8;198
75;Nouvelle-Aquitaine;33;5;10;181;Gardegan-et-Tourtirac;280;4;284
75;Nouvelle-Aquitaine;33;1;13;182;Gauriac;730;16;746
75;Nouvelle-Aquitaine;33;1;20;183;Gauriaguet;1382;15;1397
75;Nouvelle-Aquitaine;33;1;20;184;Générac;541;11;552
75;Nouvelle-Aquitaine;33;5;10;185;Génissac;1987;36;2023
75;Nouvelle-Aquitaine;33;5;10;186;Gensac;710;10;720
75;Nouvelle-Aquitaine;33;3;27;187;Gironde-sur-Dropt;1316;24;1340
75;Nouvelle-Aquitaine;33;3;29;188;Giscos;183;3;186
75;Nouvelle-Aquitaine;33;3;12;189;Gornac;430;10;440
75;Nouvelle-Aquitaine;33;3;29;190;Goualade;88;1;89
75;Nouvelle-Aquitaine;33;5;21;191;Gours;586;4;590
75;Nouvelle-Aquitaine;33;2;24;192;Gradignan;25694;334;26028
75;Nouvelle-Aquitaine;33;4;22;193;Grayan-et-l'Hôpital;1486;23;1509
75;Nouvelle-Aquitaine;33;5;10;194;Grézillac;698;15;713
75;Nouvelle-Aquitaine;33;3;29;195;Grignols;1197;8;1205
75;Nouvelle-Aquitaine;33;5;10;196;Guillac;160;4;164
75;Nouvelle-Aquitaine;33;3;15;197;Guillos;451;6;457
75;Nouvelle-Aquitaine;33;5;21;198;Guîtres;1591;35;1626
75;Nouvelle-Aquitaine;33;6;14;199;Gujan-Mestras;21887;447;22334
75;Nouvelle-Aquitaine;33;2;18;200;Le Haillan;11539;189;11728
75;Nouvelle-Aquitaine;33;2;12;201;Haux;833;18;851
75;Nouvelle-Aquitaine;33;3;15;202;Hostens;1433;18;1451
75;Nouvelle-Aquitaine;33;4;30;203;Hourtin;3813;67;3880
75;Nouvelle-Aquitaine;33;3;27;204;Hure;542;7;549
75;Nouvelle-Aquitaine;33;3;15;205;Illats;1377;21;1398
75;Nouvelle-Aquitaine;33;2;08;206;Isle-Saint-Georges;523;3;526
75;Nouvelle-Aquitaine;33;5;16;207;Izon;6167;68;6235
75;Nouvelle-Aquitaine;33;4;22;208;Jau-Dignac-et-Loirac;957;10;967
75;Nouvelle-Aquitaine;33;5;10;209;Jugazan;283;7;290
75;Nouvelle-Aquitaine;33;5;10;210;Juillac;229;4;233
75;Nouvelle-Aquitaine;33;4;30;211;Labarde;599;2;601
75;Nouvelle-Aquitaine;33;3;29;212;Labescau;124;1;125
75;Nouvelle-Aquitaine;33;2;08;213;La Brède;4420;491;4911
75;Nouvelle-Aquitaine;33;4;30;214;Lacanau;5070;72;5142
75;Nouvelle-Aquitaine;33;3;12;215;Ladaux;194;6;200
75;Nouvelle-Aquitaine;33;3;27;216;Lados;171;5;176
75;Nouvelle-Aquitaine;33;5;21;218;Lagorce;1667;16;1683
75;Nouvelle-Aquitaine;33;5;16;219;La Lande-de-Fronsac;2540;25;2565
75;Nouvelle-Aquitaine;33;4;30;220;Lamarque;1323;12;1335
75;Nouvelle-Aquitaine;33;3;27;221;Lamothe-Landerron;1166;23;1189
75;Nouvelle-Aquitaine;33;5;16;222;Lalande-de-Pomerol;659;15;674
75;Nouvelle-Aquitaine;33;3;27;223;Landerrouat;218;3;221
75;Nouvelle-Aquitaine;33;3;27;224;Landerrouet-sur-Ségur;100;0;100
75;Nouvelle-Aquitaine;33;3;15;225;Landiras;2195;37;2232
75;Nouvelle-Aquitaine;33;3;12;226;Langoiran;2154;31;2185
75;Nouvelle-Aquitaine;33;3;29;227;Langon;7357;146;7503
75;Nouvelle-Aquitaine;33;1;13;228;Lansac;701;10;711
75;Nouvelle-Aquitaine;33;6;01;229;Lanton;7285;139;7424
75;Nouvelle-Aquitaine;33;5;21;230;Lapouyade;507;10;517
75;Nouvelle-Aquitaine;33;3;12;231;Laroque;287;4;291
75;Nouvelle-Aquitaine;33;3;29;232;Lartigue;39;0;39
75;Nouvelle-Aquitaine;33;1;20;233;Laruscade;2844;21;2865
75;Nouvelle-Aquitaine;33;2;11;234;Latresne;3523;146;3669
75;Nouvelle-Aquitaine;33;3;29;235;Lavazan;230;2;232
75;Nouvelle-Aquitaine;33;6;01;236;Lège-Cap-Ferret;8352;170;8522
75;Nouvelle-Aquitaine;33;3;29;237;Léogeats;820;20;840
75;Nouvelle-Aquitaine;33;2;08;238;Léognan;10571;173;10744
75;Nouvelle-Aquitaine;33;3;29;239;Lerm-et-Musset;478;5;483
75;Nouvelle-Aquitaine;33;4;22;240;Lesparre-Médoc;5808;99;5907
75;Nouvelle-Aquitaine;33;3;12;241;Lestiac-sur-Garonne;571;8;579
75;Nouvelle-Aquitaine;33;5;27;242;Les Lèves-et-Thoumeyragues;555;10;565
75;Nouvelle-Aquitaine;33;5;16;243;Libourne;24257;544;24801
75;Nouvelle-Aquitaine;33;3;29;244;Lignan-de-Bazas;439;8;447
75;Nouvelle-Aquitaine;33;2;11;245;Lignan-de-Bordeaux;811;15;826
75;Nouvelle-Aquitaine;33;5;27;246;Ligueux;150;6;156
75;Nouvelle-Aquitaine;33;3;27;247;Listrac-de-Durèze;176;3;179
75;Nouvelle-Aquitaine;33;4;30;248;Listrac-Médoc;2788;39;2827
75;Nouvelle-Aquitaine;33;2;17;249;Lormont;23181;317;23498
75;Nouvelle-Aquitaine;33;3;27;250;Loubens;313;8;321
75;Nouvelle-Aquitaine;33;3;15;251;Louchats;730;9;739
75;Nouvelle-Aquitaine;33;2;11;252;Loupes;834;12;846
75;Nouvelle-Aquitaine;33;3;12;253;Loupiac;1118;10;1128
75;Nouvelle-Aquitaine;33;3;27;254;Loupiac-de-la-Réole;510;8;518
75;Nouvelle-Aquitaine;33;3;29;255;Lucmau;244;3;247
75;Nouvelle-Aquitaine;33;2;25;256;Ludon-Médoc;5131;45;5176
75;Nouvelle-Aquitaine;33;5;10;257;Lugaignac;496;6;502
75;Nouvelle-Aquitaine;33;3;12;258;Lugasson;304;7;311
75;Nouvelle-Aquitaine;33;5;16;259;Lugon-et-l'Île-du-Carnay;1346;24;1370
75;Nouvelle-Aquitaine;33;6;15;260;Lugos;974;21;995
75;Nouvelle-Aquitaine;33;5;21;261;Lussac;1240;38;1278
75;Nouvelle-Aquitaine;33;2;30;262;Macau;4410;25;4435
75;Nouvelle-Aquitaine;33;2;11;263;Madirac;277;4;281
75;Nouvelle-Aquitaine;33;5;21;264;Maransin;1001;12;1013
75;Nouvelle-Aquitaine;33;1;20;266;Marcenais;813;19;832
75;Nouvelle-Aquitaine;33;4;30;268;Margaux-Cantenac;2876;31;2907
75;Nouvelle-Aquitaine;33;5;27;269;Margueron;393;4;397
75;Nouvelle-Aquitaine;33;3;29;270;Marimbault;183;8;191
75;Nouvelle-Aquitaine;33;3;29;271;Marions;218;2;220
75;Nouvelle-Aquitaine;33;1;20;272;Marsas;1213;22;1235
75;Nouvelle-Aquitaine;33;2;19;273;Martignas-sur-Jalle;7624;131;7755
75;Nouvelle-Aquitaine;33;2;08;274;Martillac;3279;40;3319
75;Nouvelle-Aquitaine;33;3;12;275;Martres;106;1;107
75;Nouvelle-Aquitaine;33;3;29;276;Masseilles;142;5;147
75;Nouvelle-Aquitaine;33;3;27;277;Massugas;225;6;231
75;Nouvelle-Aquitaine;33;3;27;278;Mauriac;236;6;242
75;Nouvelle-Aquitaine;33;3;29;279;Mazères;775;10;785
75;Nouvelle-Aquitaine;33;1;13;280;Mazion;542;4;546
75;Nouvelle-Aquitaine;33;2;98;281;Mérignac;72197;723;72920
75;Nouvelle-Aquitaine;33;3;27;282;Mérignas;350;4;354
75;Nouvelle-Aquitaine;33;3;27;283;Mesterrieux;230;3;233
75;Nouvelle-Aquitaine;33;6;14;284;Mios;10781;128;10909
75;Nouvelle-Aquitaine;33;1;13;285;Mombrier;429;8;437
75;Nouvelle-Aquitaine;33;3;27;287;Mongauzy;601;5;606
75;Nouvelle-Aquitaine;33;3;12;288;Monprimblanc;287;4;291
75;Nouvelle-Aquitaine;33;3;27;289;Monségur;1604;71;1675
75;Nouvelle-Aquitaine;33;5;21;290;Montagne;1521;132;1653
75;Nouvelle-Aquitaine;33;3;27;291;Montagoudin;178;3;181
75;Nouvelle-Aquitaine;33;3;12;292;Montignac;137;7;144
75;Nouvelle-Aquitaine;33;2;17;293;Montussan;3364;50;3414
75;Nouvelle-Aquitaine;33;3;27;294;Morizès;549;8;557
75;Nouvelle-Aquitaine;33;5;16;295;Mouillac;86;9;95
75;Nouvelle-Aquitaine;33;5;10;296;Mouliets-et-Villemartin;1032;15;1047
75;Nouvelle-Aquitaine;33;4;30;297;Moulis-en-Médoc;1877;34;1911
75;Nouvelle-Aquitaine;33;5;10;298;Moulon;1006;19;1025
75;Nouvelle-Aquitaine;33;3;12;299;Mourens;385;8;393
75;Nouvelle-Aquitaine;33;4;22;300;Naujac-sur-Mer;1083;23;1106
75;Nouvelle-Aquitaine;33;5;10;301;Naujan-et-Postiac;605;6;611
75;Nouvelle-Aquitaine;33;5;21;302;Néac;345;11;356
75;Nouvelle-Aquitaine;33;5;10;303;Nérigean;841;8;849
75;Nouvelle-Aquitaine;33;3;27;304;Neuffons;145;4;149
75;Nouvelle-Aquitaine;33;3;29;305;Le Nizan;509;5;514
75;Nouvelle-Aquitaine;33;3;27;306;Noaillac;501;6;507
75;Nouvelle-Aquitaine;33;3;29;307;Noaillan;1676;36;1712
75;Nouvelle-Aquitaine;33;3;12;308;Omet;306;2;308
75;Nouvelle-Aquitaine;33;4;22;309;Ordonnac;496;6;502
75;Nouvelle-Aquitaine;33;3;15;310;Origne;184;2;186
75;Nouvelle-Aquitaine;33;3;12;311;Paillet;1204;24;1228
75;Nouvelle-Aquitaine;33;2;25;312;Parempuyre;9136;84;9220
75;Nouvelle-Aquitaine;33;4;22;314;Pauillac;4997;82;5079
75;Nouvelle-Aquitaine;33;5;21;315;Les Peintures;1622;21;1643
75;Nouvelle-Aquitaine;33;3;27;316;Pellegrue;968;13;981
75;Nouvelle-Aquitaine;33;5;20;317;Périssac;1194;16;1210
75;Nouvelle-Aquitaine;33;2;99;318;Pessac;65245;762;66007
75;Nouvelle-Aquitaine;33;5;10;319;Pessac-sur-Dordogne;446;9;455
75;Nouvelle-Aquitaine;33;5;21;320;Petit-Palais-et-Cornemps;720;11;731
75;Nouvelle-Aquitaine;33;1;20;321;Peujard;2148;28;2176
75;Nouvelle-Aquitaine;33;2;25;322;Le Pian-Médoc;6890;141;7031
75;Nouvelle-Aquitaine;33;3;12;323;Le Pian-sur-Garonne;910;18;928
75;Nouvelle-Aquitaine;33;5;27;324;Pineuilh;4438;111;4549
75;Nouvelle-Aquitaine;33;1;13;325;Plassac;935;21;956
75;Nouvelle-Aquitaine;33;1;13;326;Pleine-Selve;219;5;224
75;Nouvelle-Aquitaine;33;3;15;327;Podensac;3160;49;3209
75;Nouvelle-Aquitaine;33;5;16;328;Pomerol;579;11;590
75;Nouvelle-Aquitaine;33;3;29;329;Pompéjac;267;3;270
75;Nouvelle-Aquitaine;33;2;11;330;Pompignac;3170;54;3224
75;Nouvelle-Aquitaine;33;3;27;331;Pondaurat;463;14;477
75;Nouvelle-Aquitaine;33;5;21;332;Porchères;867;11;878
75;Nouvelle-Aquitaine;33;4;30;333;Le Porge;3294;46;3340
75;Nouvelle-Aquitaine;33;3;15;334;Portets;2757;34;2791
75;Nouvelle-Aquitaine;33;2;11;335;Le Pout;622;8;630
75;Nouvelle-Aquitaine;33;3;29;336;Préchac;1003;13;1016
75;Nouvelle-Aquitaine;33;3;15;337;Preignac;2154;33;2187
75;Nouvelle-Aquitaine;33;1;13;339;Prignac-et-Marcamps;1374;29;1403
75;Nouvelle-Aquitaine;33;1;13;341;Pugnac;2325;33;2358
75;Nouvelle-Aquitaine;33;5;21;342;Puisseguin;823;21;844
75;Nouvelle-Aquitaine;33;3;15;343;Pujols-sur-Ciron;830;16;846
75;Nouvelle-Aquitaine;33;5;10;344;Pujols;528;6;534
75;Nouvelle-Aquitaine;33;3;27;345;Le Puy;407;4;411
75;Nouvelle-Aquitaine;33;3;27;346;Puybarban;418;11;429
75;Nouvelle-Aquitaine;33;5;21;347;Puynormand;307;9;316
75;Nouvelle-Aquitaine;33;4;22;348;Queyrac;1367;15;1382
75;Nouvelle-Aquitaine;33;2;11;349;Quinsac;2195;22;2217
75;Nouvelle-Aquitaine;33;5;10;350;Rauzan;1236;25;1261
75;Nouvelle-Aquitaine;33;1;13;351;Reignac;1602;26;1628
75;Nouvelle-Aquitaine;33;3;27;352;La Réole;4355;82;4437
75;Nouvelle-Aquitaine;33;3;27;353;Rimons;198;4;202
75;Nouvelle-Aquitaine;33;5;27;354;Riocaud;192;5;197
75;Nouvelle-Aquitaine;33;3;12;355;Rions;1525;36;1561
75;Nouvelle-Aquitaine;33;5;16;356;La Rivière;431;1;432
75;Nouvelle-Aquitaine;33;3;29;357;Roaillan;1742;27;1769
75;Nouvelle-Aquitaine;33;3;12;358;Romagne;467;8;475
75;Nouvelle-Aquitaine;33;3;27;359;Roquebrune;284;3;287
75;Nouvelle-Aquitaine;33;5;27;360;La Roquille;308;3;311
75;Nouvelle-Aquitaine;33;3;27;361;Ruch;598;10;608
75;Nouvelle-Aquitaine;33;5;21;362;Sablons;1300;15;1315
75;Nouvelle-Aquitaine;33;2;11;363;Sadirac;4499;70;4569
75;Nouvelle-Aquitaine;33;5;16;364;Saillans;385;7;392
75;Nouvelle-Aquitaine;33;5;16;365;Saint-Aignan;201;9;210
75;Nouvelle-Aquitaine;33;1;20;366;Saint-André-de-Cubzac;12372;181;12553
75;Nouvelle-Aquitaine;33;3;12;367;Saint-André-du-Bois;432;4;436
75;Nouvelle-Aquitaine;33;5;27;369;Saint-André-et-Appelles;675;12;687
75;Nouvelle-Aquitaine;33;1;13;370;Saint-Androny;542;8;550
75;Nouvelle-Aquitaine;33;3;27;372;Saint-Antoine-du-Queyret;56;2;58
75;Nouvelle-Aquitaine;33;5;21;373;Saint-Antoine-sur-l'Isle;582;10;592
75;Nouvelle-Aquitaine;33;1;13;374;Saint-Aubin-de-Blaye;866;19;885
75;Nouvelle-Aquitaine;33;5;10;375;Saint-Aubin-de-Branne;368;8;376
75;Nouvelle-Aquitaine;33;2;28;376;Saint-Aubin-de-Médoc;7495;214;7709
75;Nouvelle-Aquitaine;33;5;27;377;Saint-Avit-de-Soulège;78;3;81
75;Nouvelle-Aquitaine;33;5;27;378;Saint-Avit-Saint-Nazaire;1478;22;1500
75;Nouvelle-Aquitaine;33;3;27;379;Saint-Brice;315;2;317
75;Nouvelle-Aquitaine;33;1;13;380;Val-de-Livenne;1779;23;1802
75;Nouvelle-Aquitaine;33;2;11;381;Saint-Caprais-de-Bordeaux;3399;34;3433
75;Nouvelle-Aquitaine;33;1;20;382;Saint-Christoly-de-Blaye;1904;30;1934
75;Nouvelle-Aquitaine;33;4;22;383;Saint-Christoly-Médoc;277;3;280
75;Nouvelle-Aquitaine;33;5;21;384;Saint-Christophe-des-Bardes;418;7;425
75;Nouvelle-Aquitaine;33;5;21;385;Saint-Christophe-de-Double;653;5;658
75;Nouvelle-Aquitaine;33;5;21;386;Saint-Cibard;191;6;197
75;Nouvelle-Aquitaine;33;5;21;387;Saint-Ciers-d'Abzac;1481;24;1505
75;Nouvelle-Aquitaine;33;1;13;388;Saint-Ciers-de-Canesse;781;16;797
75;Nouvelle-Aquitaine;33;1;13;389;Saint-Ciers-sur-Gironde;3021;42;3063
75;Nouvelle-Aquitaine;33;5;10;390;Sainte-Colombe;422;9;431
75;Nouvelle-Aquitaine;33;3;29;391;Saint-Côme;321;4;325
75;Nouvelle-Aquitaine;33;3;12;392;Sainte-Croix-du-Mont;866;16;882
75;Nouvelle-Aquitaine;33;5;21;393;Saint-Denis-de-Pile;5688;68;5756
75;Nouvelle-Aquitaine;33;5;10;394;Saint-Émilion;1859;47;1906
75;Nouvelle-Aquitaine;33;4;22;395;Saint-Estèphe;1592;50;1642
75;Nouvelle-Aquitaine;33;5;10;396;Saint-Étienne-de-Lisse;195;4;199
75;Nouvelle-Aquitaine;33;2;26;397;Sainte-Eulalie;4832;82;4914
75;Nouvelle-Aquitaine;33;3;27;398;Saint-Exupéry;168;2;170
75;Nouvelle-Aquitaine;33;3;27;399;Saint-Félix-de-Foncaude;289;7;296
75;Nouvelle-Aquitaine;33;3;27;400;Saint-Ferme;340;5;345
75;Nouvelle-Aquitaine;33;5;10;401;Sainte-Florence;148;2;150
75;Nouvelle-Aquitaine;33;5;27;402;Sainte-Foy-la-Grande;2627;31;2658
75;Nouvelle-Aquitaine;33;3;12;403;Sainte-Foy-la-Longue;131;2;133
75;Nouvelle-Aquitaine;33;3;27;404;Sainte-Gemme;190;4;194
75;Nouvelle-Aquitaine;33;1;13;405;Saint-Genès-de-Blaye;494;12;506
75;Nouvelle-Aquitaine;33;5;10;406;Saint-Genès-de-Castillon;380;7;387
75;Nouvelle-Aquitaine;33;5;20;407;Saint-Genès-de-Fronsac;856;17;873
75;Nouvelle-Aquitaine;33;2;11;408;Saint-Genès-de-Lombaud;383;17;400
75;Nouvelle-Aquitaine;33;3;12;409;Saint-Genis-du-Bois;86;1;87
75;Nouvelle-Aquitaine;33;3;12;411;Saint-Germain-de-Grave;156;3;159
75;Nouvelle-Aquitaine;33;4;22;412;Saint-Germain-d'Esteuil;1256;20;1276
75;Nouvelle-Aquitaine;33;5;10;413;Saint-Germain-du-Puch;2231;36;2267
75;Nouvelle-Aquitaine;33;5;16;414;Saint-Germain-de-la-Rivière;390;4;394
75;Nouvelle-Aquitaine;33;1;20;415;Saint-Gervais;1905;20;1925
75;Nouvelle-Aquitaine;33;1;20;416;Saint-Girons-d'Aiguevives;927;19;946
75;Nouvelle-Aquitaine;33;4;30;417;Sainte-Hélène;2838;44;2882
75;Nouvelle-Aquitaine;33;3;27;418;Saint-Hilaire-de-la-Noaille;375;7;382
75;Nouvelle-Aquitaine;33;3;27;419;Saint-Hilaire-du-Bois;79;0;79
75;Nouvelle-Aquitaine;33;5;10;420;Saint-Hippolyte;130;1;131
75;Nouvelle-Aquitaine;33;5;10;421;Saint-Jean-de-Blaignac;463;7;470
75;Nouvelle-Aquitaine;33;2;19;422;Saint-Jean-d'Illac;8980;163;9143
75;Nouvelle-Aquitaine;33;4;22;423;Saint-Julien-Beychevelle;611;0;611
75;Nouvelle-Aquitaine;33;4;30;424;Saint-Laurent-Médoc;4860;88;4948
75;Nouvelle-Aquitaine;33;1;20;425;Saint-Laurent-d'Arce;1484;28;1512
75;Nouvelle-Aquitaine;33;5;10;426;Saint-Laurent-des-Combes;252;1;253
75;Nouvelle-Aquitaine;33;3;12;427;Saint-Laurent-du-Bois;247;5;252
75;Nouvelle-Aquitaine;33;3;12;428;Saint-Laurent-du-Plan;84;0;84
75;Nouvelle-Aquitaine;33;3;15;429;Saint-Léger-de-Balson;326;5;331
75;Nouvelle-Aquitaine;33;2;12;431;Saint-Léon;341;4;345
75;Nouvelle-Aquitaine;33;3;29;432;Saint-Loubert;236;2;238
75;Nouvelle-Aquitaine;33;2;26;433;Saint-Loubès;9909;108;10017
75;Nouvelle-Aquitaine;33;2;26;434;Saint-Louis-de-Montferrand;2161;15;2176
75;Nouvelle-Aquitaine;33;3;12;435;Saint-Macaire;2078;95;2173
75;Nouvelle-Aquitaine;33;6;15;436;Saint-Magne;1042;21;1063
75;Nouvelle-Aquitaine;33;5;10;437;Saint-Magne-de-Castillon;2029;11;2040
75;Nouvelle-Aquitaine;33;3;12;438;Saint-Maixant;1994;49;2043
75;Nouvelle-Aquitaine;33;1;20;439;Saint-Mariens;1624;19;1643
75;Nouvelle-Aquitaine;33;3;12;440;Saint-Martial;239;5;244
75;Nouvelle-Aquitaine;33;1;13;441;Saint-Martin-Lacaussade;1158;98;1256
75;Nouvelle-Aquitaine;33;5;21;442;Saint-Martin-de-Laye;550;5;555
75;Nouvelle-Aquitaine;33;3;27;443;Saint-Martin-de-Lerm;154;3;157
75;Nouvelle-Aquitaine;33;3;12;444;Saint-Martin-de-Sescas;576;10;586
75;Nouvelle-Aquitaine;33;5;21;445;Saint-Martin-du-Bois;844;17;861
75;Nouvelle-Aquitaine;33;3;27;446;Saint-Martin-du-Puy;168;1;169
75;Nouvelle-Aquitaine;33;5;21;447;Saint-Médard-de-Guizières;2391;22;2413
75;Nouvelle-Aquitaine;33;2;08;448;Saint-Médard-d'Eyrans;3098;40;3138
75;Nouvelle-Aquitaine;33;2;28;449;Saint-Médard-en-Jalles;31808;520;32328
75;Nouvelle-Aquitaine;33;3;29;450;Saint-Michel-de-Castelnau;245;3;248
75;Nouvelle-Aquitaine;33;5;16;451;Saint-Michel-de-Fronsac;527;4;531
75;Nouvelle-Aquitaine;33;3;15;452;Saint-Michel-de-Rieufret;836;13;849
75;Nouvelle-Aquitaine;33;3;27;453;Saint-Michel-de-Lapujade;222;4;226
75;Nouvelle-Aquitaine;33;2;08;454;Saint-Morillon;1724;21;1745
75;Nouvelle-Aquitaine;33;1;13;456;Saint-Palais;497;8;505
75;Nouvelle-Aquitaine;33;3;29;457;Saint-Pardon-de-Conques;600;10;610
75;Nouvelle-Aquitaine;33;1;13;458;Saint-Paul;977;17;994
75;Nouvelle-Aquitaine;33;5;10;459;Saint-Pey-d'Armens;187;3;190
75;Nouvelle-Aquitaine;33;5;10;460;Saint-Pey-de-Castets;609;12;621
75;Nouvelle-Aquitaine;33;5;10;461;Saint-Philippe-d'Aiguille;375;5;380
75;Nouvelle-Aquitaine;33;5;27;462;Saint-Philippe-du-Seignal;493;10;503
75;Nouvelle-Aquitaine;33;3;12;463;Saint-Pierre-d'Aurillac;1311;20;1331
75;Nouvelle-Aquitaine;33;3;12;464;Saint-Pierre-de-Bat;289;6;295
75;Nouvelle-Aquitaine;33;3;29;465;Saint-Pierre-de-Mons;1227;21;1248
75;Nouvelle-Aquitaine;33;5;10;466;Saint-Quentin-de-Baron;2559;32;2591
75;Nouvelle-Aquitaine;33;5;27;467;Saint-Quentin-de-Caplong;238;4;242
75;Nouvelle-Aquitaine;33;5;10;468;Sainte-Radegonde;435;9;444
75;Nouvelle-Aquitaine;33;5;16;470;Saint-Romain-la-Virvée;871;24;895
75;Nouvelle-Aquitaine;33;4;22;471;Saint-Sauveur;1280;23;1303
75;Nouvelle-Aquitaine;33;5;21;472;Saint-Sauveur-de-Puynormand;360;6;366
75;Nouvelle-Aquitaine;33;1;20;473;Saint-Savin;3250;37;3287
75;Nouvelle-Aquitaine;33;2;08;474;Saint-Selve;3423;41;3464
75;Nouvelle-Aquitaine;33;1;13;475;Saint-Seurin-de-Bourg;408;6;414
75;Nouvelle-Aquitaine;33;4;22;476;Saint-Seurin-de-Cadourne;704;12;716
75;Nouvelle-Aquitaine;33;1;13;477;Saint-Seurin-de-Cursac;763;17;780
75;Nouvelle-Aquitaine;33;5;21;478;Saint-Seurin-sur-l'Isle;3141;21;3162
75;Nouvelle-Aquitaine;33;3;27;479;Saint-Sève;251;2;253
75;Nouvelle-Aquitaine;33;5;10;480;Saint-Sulpice-de-Faleyrens;1316;29;1345
75;Nouvelle-Aquitaine;33;3;27;481;Saint-Sulpice-de-Guilleragues;230;3;233
75;Nouvelle-Aquitaine;33;3;27;482;Saint-Sulpice-de-Pommiers;250;3;253
75;Nouvelle-Aquitaine;33;2;26;483;Saint-Sulpice-et-Cameyrac;4762;67;4829
75;Nouvelle-Aquitaine;33;3;15;484;Saint-Symphorien;1831;31;1862
75;Nouvelle-Aquitaine;33;5;10;485;Sainte-Terre;1910;32;1942
75;Nouvelle-Aquitaine;33;1;13;486;Saint-Trojan;355;9;364
75;Nouvelle-Aquitaine;33;2;26;487;Saint-Vincent-de-Paul;1000;8;1008
75;Nouvelle-Aquitaine;33;5;10;488;Saint-Vincent-de-Pertignas;357;13;370
75;Nouvelle-Aquitaine;33;1;20;489;Saint-Vivien-de-Blaye;354;5;359
75;Nouvelle-Aquitaine;33;4;22;490;Saint-Vivien-de-Médoc;1791;24;1815
75;Nouvelle-Aquitaine;33;3;27;491;Saint-Vivien-de-Monségur;383;5;388
75;Nouvelle-Aquitaine;33;1;20;492;Saint-Yzan-de-Soudiac;2427;24;2451
75;Nouvelle-Aquitaine;33;4;22;493;Saint-Yzans-de-Médoc;348;24;372
75;Nouvelle-Aquitaine;33;4;30;494;Salaunes;1171;11;1182
75;Nouvelle-Aquitaine;33;2;11;496;Sallebœuf;2630;40;2670
75;Nouvelle-Aquitaine;33;6;15;498;Salles;7411;139;7550
75;Nouvelle-Aquitaine;33;5;10;499;Les Salles-de-Castillon;333;9;342
75;Nouvelle-Aquitaine;33;1;13;500;Samonac;429;9;438
75;Nouvelle-Aquitaine;33;2;08;501;Saucats;3255;57;3312
75;Nouvelle-Aquitaine;33;1;20;502;Saugon;485;5;490
75;Nouvelle-Aquitaine;33;4;30;503;Saumos;532;9;541
75;Nouvelle-Aquitaine;33;3;29;504;Sauternes;814;9;823
75;Nouvelle-Aquitaine;33;2;12;505;La Sauve;1546;55;1601
75;Nouvelle-Aquitaine;33;3;27;506;Sauveterre-de-Guyenne;1853;22;1875
75;Nouvelle-Aquitaine;33;3;29;507;Sauviac;324;11;335
75;Nouvelle-Aquitaine;33;3;27;508;Savignac;626;13;639
75;Nouvelle-Aquitaine;33;5;21;509;Savignac-de-l'Isle;501;9;510
75;Nouvelle-Aquitaine;33;3;12;510;Semens;218;1;219
75;Nouvelle-Aquitaine;33;3;29;511;Sendets;339;4;343
75;Nouvelle-Aquitaine;33;3;27;512;Sigalens;362;8;370
75;Nouvelle-Aquitaine;33;3;29;513;Sillas;122;2;124
75;Nouvelle-Aquitaine;33;4;22;514;Soulac-sur-Mer;2825;25;2850
75;Nouvelle-Aquitaine;33;3;12;515;Soulignac;422;8;430
75;Nouvelle-Aquitaine;33;3;27;516;Soussac;199;5;204
75;Nouvelle-Aquitaine;33;4;30;517;Soussans;1655;17;1672
75;Nouvelle-Aquitaine;33;2;12;518;Tabanac;1084;23;1107
75;Nouvelle-Aquitaine;33;2;28;519;Le Taillan-Médoc;10141;145;10286
75;Nouvelle-Aquitaine;33;3;27;520;Taillecavat;283;3;286
75;Nouvelle-Aquitaine;33;4;22;521;Talais;764;7;771
75;Nouvelle-Aquitaine;33;2;31;522;Talence;43820;979;44799
75;Nouvelle-Aquitaine;33;3;12;523;Targon;2054;24;2078
75;Nouvelle-Aquitaine;33;5;16;524;Tarnès;337;7;344
75;Nouvelle-Aquitaine;33;1;13;525;Tauriac;1297;21;1318
75;Nouvelle-Aquitaine;33;5;21;526;Tayac;133;3;136
75;Nouvelle-Aquitaine;33;6;14;527;Le Teich;8500;179;8679
75;Nouvelle-Aquitaine;33;4;30;528;Le Temple;633;7;640
75;Nouvelle-Aquitaine;33;6;32;529;La Teste-de-Buch;26168;378;26546
75;Nouvelle-Aquitaine;33;1;13;530;Teuillac;880;9;889
75;Nouvelle-Aquitaine;33;5;10;531;Tizac-de-Curton;346;5;351
75;Nouvelle-Aquitaine;33;5;21;532;Tizac-de-Lapouyade;472;9;481
75;Nouvelle-Aquitaine;33;3;29;533;Toulenne;2752;28;2780
75;Nouvelle-Aquitaine;33;2;12;534;Le Tourne;802;11;813
75;Nouvelle-Aquitaine;33;2;11;535;Tresses;4895;52;4947
75;Nouvelle-Aquitaine;33;3;15;536;Le Tuzan;257;5;262
75;Nouvelle-Aquitaine;33;3;29;537;Uzeste;459;10;469
75;Nouvelle-Aquitaine;33;4;22;538;Valeyrac;539;10;549
75;Nouvelle-Aquitaine;33;5;16;539;Vayres;4123;53;4176
75;Nouvelle-Aquitaine;33;4;22;540;Vendays-Montalivet;2410;37;2447
75;Nouvelle-Aquitaine;33;4;22;541;Vensac;1017;17;1034
75;Nouvelle-Aquitaine;33;5;16;542;Vérac;946;14;960
75;Nouvelle-Aquitaine;33;3;12;543;Verdelais;1020;9;1029
75;Nouvelle-Aquitaine;33;4;22;544;Le Verdon-sur-Mer;1326;11;1337
75;Nouvelle-Aquitaine;33;4;22;545;Vertheuil;1314;22;1336
75;Nouvelle-Aquitaine;33;5;10;546;Vignonet;503;12;515
75;Nouvelle-Aquitaine;33;3;29;547;Villandraut;1120;26;1146
75;Nouvelle-Aquitaine;33;5;16;548;Villegouge;1250;24;1274
75;Nouvelle-Aquitaine;33;3;12;549;Villenave-de-Rions;348;6;354
75;Nouvelle-Aquitaine;33;2;33;550;Villenave-d'Ornon;36754;205;36959
75;Nouvelle-Aquitaine;33;1;13;551;Villeneuve;397;6;403
75;Nouvelle-Aquitaine;33;3;15;552;Virelade;1092;13;1105
75;Nouvelle-Aquitaine;33;1;20;553;Virsac;1171;5;1176
75;Nouvelle-Aquitaine;33;2;17;554;Yvrac;2838;23;2861
75;Nouvelle-Aquitaine;33;6;14;555;Marcheprime;4992;81;5073
76;Occitanie;34;1;21;001;Abeilhan;1795;24;1819
76;Occitanie;34;1;14;002;Adissan;1259;25;1284
76;Occitanie;34;1;01;003;Agde;29600;400;30000
76;Occitanie;34;1;24;004;Agel;245;4;249
76;Occitanie;34;2;11;005;Agonès;285;9;294
76;Occitanie;34;1;24;006;Aigne;271;7;278
76;Occitanie;34;1;24;007;Aigues-Vives;470;5;475
76;Occitanie;34;1;06;008;Les Aires;605;11;616
76;Occitanie;34;1;21;009;Alignan-du-Vent;1753;28;1781
76;Occitanie;34;2;09;010;Aniane;2918;39;2957
76;Occitanie;34;2;09;011;Arboras;111;4;115
76;Occitanie;34;2;09;012;Argelliers;973;25;998
76;Occitanie;34;2;06;013;Aspiran;1662;29;1691
76;Occitanie;34;2;23;014;Assas;1488;42;1530
76;Occitanie;34;1;24;015;Assignan;164;3;167
76;Occitanie;34;2;09;016;Aumelas;531;17;548
76;Occitanie;34;1;14;017;Aumes;494;16;510
76;Occitanie;34;1;05;018;Autignac;923;15;938
76;Occitanie;34;1;06;019;Avène;276;8;284
76;Occitanie;34;1;24;020;Azillanet;360;12;372
76;Occitanie;34;1;24;021;Babeau-Bouldoux;297;6;303
76;Occitanie;34;3;07;022;Baillargues;7654;101;7755
76;Occitanie;34;3;08;023;Balaruc-les-Bains;6991;91;7082
76;Occitanie;34;3;08;024;Balaruc-le-Vieux;2648;42;2690
76;Occitanie;34;1;04;025;Bassan;2155;35;2190
76;Occitanie;34;1;24;026;Beaufort;221;4;225
76;Occitanie;34;3;07;027;Beaulieu;2144;49;2193
76;Occitanie;34;1;06;028;Bédarieux;5743;231;5974
76;Occitanie;34;2;09;029;Bélarga;681;10;691
76;Occitanie;34;1;24;030;Berlou;211;0;211
76;Occitanie;34;1;01;031;Bessan;5162;76;5238
76;Occitanie;34;1;98;032;Béziers;78308;1242;79550
76;Occitanie;34;3;12;033;Boisseron;2072;41;2113
76;Occitanie;34;1;24;034;Boisset;39;1;40
76;Occitanie;34;2;09;035;La Boissière;1028;19;1047
76;Occitanie;34;2;11;036;Le Bosc;1362;24;1386
76;Occitanie;34;1;04;037;Boujan-sur-Libron;3367;56;3423
76;Occitanie;34;1;06;038;Le Bousquet-d'Orb;1584;24;1608
76;Occitanie;34;3;14;039;Bouzigues;1643;24;1667
76;Occitanie;34;1;06;040;Brenas;54;0;54
76;Occitanie;34;2;06;041;Brignac;940;17;957
76;Occitanie;34;2;11;042;Brissac;605;14;619
76;Occitanie;34;2;23;043;Buzignargues;361;5;366
76;Occitanie;34;1;05;044;Cabrerolles;341;10;351
76;Occitanie;34;2;14;045;Cabrières;524;16;540
76;Occitanie;34;1;24;046;Cambon-et-Salvergues;49;0;49
76;Occitanie;34;2;09;047;Campagnan;699;10;709
76;Occitanie;34;3;12;048;Campagne;310;5;315
76;Occitanie;34;1;06;049;Camplong;229;4;233
76;Occitanie;34;3;13;050;Candillargues;1950;26;1976
76;Occitanie;34;2;06;051;Canet;3506;46;3552
76;Occitanie;34;1;24;052;Capestang;3281;59;3340
76;Occitanie;34;1;06;053;Carlencas-et-Levas;128;0;128
76;Occitanie;34;1;24;054;Cassagnoles;106;1;107
76;Occitanie;34;1;24;055;Castanet-le-Haut;216;3;219
76;Occitanie;34;1;21;056;Castelnau-de-Guers;1253;24;1277
76;Occitanie;34;3;20;057;Castelnau-le-Lez;22534;382;22916
76;Occitanie;34;3;07;058;Castries;6294;103;6397
76;Occitanie;34;1;24;059;La Caunette;315;6;321
76;Occitanie;34;2;11;060;Causse-de-la-Selle;402;5;407
76;Occitanie;34;1;05;061;Causses-et-Veyran;619;10;629
76;Occitanie;34;1;05;062;Caussiniojouls;152;1;153
76;Occitanie;34;1;21;063;Caux;2538;47;2585
76;Occitanie;34;2;11;064;Le Caylar;458;14;472
76;Occitanie;34;1;24;065;Cazedarnes;608;11;619
76;Occitanie;34;2;23;066;Cazevieille;215;3;218
76;Occitanie;34;2;11;067;Cazilhac;1536;40;1576
76;Occitanie;34;1;14;068;Cazouls-d'Hérault;412;9;421
76;Occitanie;34;1;05;069;Cazouls-lès-Béziers;5060;94;5154
76;Occitanie;34;1;24;070;Cébazan;627;12;639
76;Occitanie;34;1;06;071;Ceilhes-et-Rocozels;329;5;334
76;Occitanie;34;2;11;072;Celles;27;1;28
76;Occitanie;34;1;04;073;Cers;2560;50;2610
76;Occitanie;34;1;24;074;Cessenon-sur-Orb;2336;49;2385
76;Occitanie;34;1;24;075;Cesseras;413;8;421
76;Occitanie;34;2;06;076;Ceyras;1368;26;1394
76;Occitanie;34;3;20;077;Clapiers;5411;101;5512
76;Occitanie;34;2;11;078;Claret;1671;37;1708
76;Occitanie;34;2;06;079;Clermont-l'Hérault;9029;161;9190
76;Occitanie;34;1;24;080;Colombières-sur-Orb;482;14;496
76;Occitanie;34;1;05;081;Colombiers;2684;44;2728
76;Occitanie;34;2;23;082;Combaillaux;1742;41;1783
76;Occitanie;34;1;06;083;Combes;326;3;329
76;Occitanie;34;1;03;084;Corneilhan;1724;31;1755
76;Occitanie;34;1;21;085;Coulobres;353;4;357
76;Occitanie;34;1;24;086;Courniou;616;13;629
76;Occitanie;34;3;22;087;Cournonsec;3454;31;3485
76;Occitanie;34;3;22;088;Cournonterral;6423;78;6501
76;Occitanie;34;1;24;089;Creissan;1313;26;1339
76;Occitanie;34;3;07;090;Le Crès;9310;133;9443
76;Occitanie;34;2;11;091;Le Cros;56;0;56
76;Occitanie;34;1;24;092;Cruzy;967;17;984
76;Occitanie;34;1;06;093;Dio-et-Valquières;146;5;151
76;Occitanie;34;1;04;094;Espondeilhan;1109;23;1132
76;Occitanie;34;3;22;095;Fabrègues;7293;127;7420
76;Occitanie;34;1;05;096;Faugères;546;9;555
76;Occitanie;34;1;24;097;Félines-Minervois;473;6;479
76;Occitanie;34;1;24;098;Ferrals-les-Montagnes;153;4;157
76;Occitanie;34;2;11;099;Ferrières-les-Verreries;48;1;49
76;Occitanie;34;1;24;100;Ferrières-Poussarou;55;4;59
76;Occitanie;34;1;21;101;Florensac;5057;79;5136
76;Occitanie;34;2;11;102;Fontanès;349;9;358
76;Occitanie;34;2;14;103;Fontès;1045;19;1064
76;Occitanie;34;1;05;104;Fos;126;0;126
76;Occitanie;34;1;05;105;Fouzilhon;254;3;257
76;Occitanie;34;2;11;106;Fozières;180;9;189
76;Occitanie;34;1;24;107;Fraisse-sur-Agout;343;3;346
76;Occitanie;34;3;08;108;Frontignan;23028;227;23255
76;Occitanie;34;1;05;109;Gabian;844;19;863
76;Occitanie;34;3;12;110;Galargues;733;26;759
76;Occitanie;34;2;11;111;Ganges;4098;102;4200
76;Occitanie;34;3;12;112;Garrigues;207;4;211
76;Occitanie;34;3;08;113;Gigean;6507;79;6586
76;Occitanie;34;2;09;114;Gignac;6480;114;6594
76;Occitanie;34;2;11;115;Gorniès;118;1;119
76;Occitanie;34;3;15;116;Grabels;8798;99;8897
76;Occitanie;34;1;06;117;Graissessac;608;9;617
76;Occitanie;34;2;23;118;Guzargues;502;12;514
76;Occitanie;34;1;06;119;Hérépian;1515;26;1541
76;Occitanie;34;3;20;120;Jacou;6808;102;6910
76;Occitanie;34;1;06;121;Joncels;285;13;298
76;Occitanie;34;2;09;122;Jonquières;528;7;535
76;Occitanie;34;3;10;123;Juvignac;11344;103;11447
76;Occitanie;34;2;06;124;Lacoste;308;10;318
76;Occitanie;34;2;09;125;Lagamas;111;4;115
76;Occitanie;34;1;06;126;Lamalou-les-Bains;2500;17;2517
76;Occitanie;34;3;13;127;Lansargues;3099;43;3142
76;Occitanie;34;2;11;128;Laroque;1625;31;1656
76;Occitanie;34;3;10;129;Lattes;17453;227;17680
76;Occitanie;34;1;05;130;Laurens;1770;29;1799
76;Occitanie;34;2;11;131;Lauret;638;20;658
76;Occitanie;34;2;11;132;Lauroux;205;2;207
76;Occitanie;34;2;11;133;Lavalette;57;0;57
76;Occitanie;34;3;10;134;Lavérune;3328;54;3382
76;Occitanie;34;1;02;135;Lespignan;3299;54;3353
76;Occitanie;34;1;14;136;Lézignan-la-Cèbe;1567;29;1596
76;Occitanie;34;2;06;137;Liausson;148;7;155
76;Occitanie;34;2;14;138;Lieuran-Cabrières;333;13;346
76;Occitanie;34;1;04;139;Lieuran-lès-Béziers;1385;40;1425
76;Occitanie;34;1;03;140;Lignan-sur-Orb;3218;85;3303
76;Occitanie;34;1;24;141;La Livinière;521;8;529
76;Occitanie;34;2;11;142;Lodève;7477;237;7714
76;Occitanie;34;3;14;143;Loupian;2191;39;2230
76;Occitanie;34;1;06;144;Lunas;661;13;674
76;Occitanie;34;3;12;145;Lunel;26385;242;26627
76;Occitanie;34;3;12;146;Lunel-Viel;4367;45;4412
76;Occitanie;34;1;05;147;Magalas;3371;52;3423
76;Occitanie;34;1;05;148;Maraussan;4628;85;4713
76;Occitanie;34;1;05;149;Margon;717;2;719
76;Occitanie;34;3;01;150;Marseillan;7734;104;7838
76;Occitanie;34;3;12;151;Marsillargues;6407;78;6485
76;Occitanie;34;2;11;152;Mas-de-Londres;672;10;682
76;Occitanie;34;2;23;153;Les Matelles;2005;41;2046
76;Occitanie;34;3;13;154;Mauguio;16705;194;16899
76;Occitanie;34;1;05;155;Maureilhan;2260;48;2308
76;Occitanie;34;2;06;156;Mérifons;44;3;47
76;Occitanie;34;3;14;157;Mèze;12307;166;12473
76;Occitanie;34;1;24;158;Minerve;103;1;104
76;Occitanie;34;3;08;159;Mireval;3310;50;3360
76;Occitanie;34;1;24;160;Mons;627;15;642
76;Occitanie;34;1;05;161;Montady;3960;75;4035
76;Occitanie;34;1;14;162;Montagnac;4324;59;4383
76;Occitanie;34;2;09;163;Montarnaud;4052;47;4099
76;Occitanie;34;3;07;164;Montaud;1028;11;1039
76;Occitanie;34;3;14;165;Montbazin;2934;60;2994
76;Occitanie;34;1;21;166;Montblanc;2865;51;2916
76;Occitanie;34;1;24;167;Montels;254;4;258
76;Occitanie;34;1;05;168;Montesquieu;74;0;74
76;Occitanie;34;3;20;169;Montferrier-sur-Lez;3960;162;4122
76;Occitanie;34;1;24;170;Montouliers;213;5;218
76;Occitanie;34;2;11;171;Montoulieu;163;4;167
76;Occitanie;34;3;99;172;Montpellier;295542;3391;298933
76;Occitanie;34;2;09;173;Montpeyroux;1360;24;1384
76;Occitanie;34;2;11;174;Moulès-et-Baucels;866;26;892
76;Occitanie;34;2;06;175;Mourèze;205;5;210
76;Occitanie;34;3;13;176;Mudaison;2753;29;2782
76;Occitanie;34;2;23;177;Murles;324;10;334
76;Occitanie;34;1;05;178;Murviel-lès-Béziers;3105;54;3159
76;Occitanie;34;3;22;179;Murviel-lès-Montpellier;1863;30;1893
76;Occitanie;34;2;06;180;Nébian;1437;23;1460
76;Occitanie;34;1;05;181;Neffiès;1039;25;1064
76;Occitanie;34;1;21;182;Nézignan-l'Évêque;1827;29;1856
76;Occitanie;34;1;02;183;Nissan-lez-Enserune;3996;61;4057
76;Occitanie;34;1;14;184;Nizas;677;15;692
76;Occitanie;34;2;11;185;Notre-Dame-de-Londres;507;11;518
76;Occitanie;34;2;06;186;Octon;522;12;534
76;Occitanie;34;1;24;187;Olargues;662;14;676
76;Occitanie;34;2;11;188;Olmet-et-Villecun;188;4;192
76;Occitanie;34;1;24;189;Olonzac;1687;19;1706
76;Occitanie;34;1;24;190;Oupia;237;7;244
76;Occitanie;34;1;05;191;Pailhès;571;12;583
76;Occitanie;34;3;13;192;Palavas-les-Flots;5844;41;5885
76;Occitanie;34;1;24;193;Pardailhan;177;6;183
76;Occitanie;34;2;06;194;Paulhan;4016;53;4069
76;Occitanie;34;2;11;195;Pégairolles-de-Buèges;55;1;56
76;Occitanie;34;2;11;196;Pégairolles-de-l'Escalette;159;5;164
76;Occitanie;34;2;14;197;Péret;1040;17;1057
76;Occitanie;34;3;10;198;Pérols;9016;122;9138
76;Occitanie;34;1;21;199;Pézenas;8002;271;8273
76;Occitanie;34;1;06;200;Pézènes-les-Mines;236;10;246
76;Occitanie;34;1;24;201;Pierrerue;293;7;300
76;Occitanie;34;3;22;202;Pignan;7959;109;8068
76;Occitanie;34;1;21;203;Pinet;1906;22;1928
76;Occitanie;34;2;09;204;Plaissan;1373;17;1390
76;Occitanie;34;2;11;205;Les Plans;283;10;293
76;Occitanie;34;1;24;206;Poilhes;538;11;549
76;Occitanie;34;1;21;207;Pomérols;2196;44;2240
76;Occitanie;34;2;09;208;Popian;358;15;373
76;Occitanie;34;1;01;209;Portiragnes;3104;64;3168
76;Occitanie;34;2;09;210;Le Pouget;2082;46;2128
76;Occitanie;34;1;06;211;Le Poujol-sur-Orb;1008;30;1038
76;Occitanie;34;2;11;212;Poujols;175;6;181
76;Occitanie;34;3;14;213;Poussan;5993;78;6071
76;Occitanie;34;1;05;214;Pouzolles;1172;18;1190
76;Occitanie;34;2;09;215;Pouzols;959;22;981
76;Occitanie;34;1;06;216;Le Pradal;334;9;343
76;Occitanie;34;3;23;217;Prades-le-Lez;5908;111;6019
76;Occitanie;34;1;24;218;Prades-sur-Vernazobre;310;8;318
76;Occitanie;34;1;24;219;Prémian;505;9;514
76;Occitanie;34;2;11;220;Le Puech;251;5;256
76;Occitanie;34;2;09;221;Puéchabon;499;11;510
76;Occitanie;34;2;09;222;Puilacher;616;13;629
76;Occitanie;34;1;05;223;Puimisson;1152;23;1175
76;Occitanie;34;1;21;224;Puissalicon;1348;23;1371
76;Occitanie;34;1;24;225;Puisserguier;3037;50;3087
76;Occitanie;34;1;24;226;Quarante;1796;26;1822
76;Occitanie;34;3;07;227;Restinclières;2109;29;2138
76;Occitanie;34;1;24;228;Rieussec;77;5;82
76;Occitanie;34;1;24;229;Riols;739;26;765
76;Occitanie;34;2;11;230;Les Rives;147;4;151
76;Occitanie;34;2;11;231;Romiguières;21;2;23
76;Occitanie;34;1;24;232;Roquebrun;604;11;615
76;Occitanie;34;2;11;233;Roqueredonde;210;3;213
76;Occitanie;34;1;05;234;Roquessels;97;1;98
76;Occitanie;34;1;24;235;Rosis;275;5;280
76;Occitanie;34;2;11;236;Rouet;68;0;68
76;Occitanie;34;1;05;237;Roujan;2187;29;2216
76;Occitanie;34;2;11;238;Saint-André-de-Buèges;36;1;37
76;Occitanie;34;2;09;239;Saint-André-de-Sangonis;6198;106;6304
76;Occitanie;34;3;13;240;Saint-Aunès;3786;33;3819
76;Occitanie;34;2;09;241;Saint-Bauzille-de-la-Sylve;873;14;887
76;Occitanie;34;2;23;242;Saint-Bauzille-de-Montmel;1074;24;1098
76;Occitanie;34;2;11;243;Saint-Bauzille-de-Putois;2001;31;2032
76;Occitanie;34;3;07;244;Saint-Brès;3209;43;3252
76;Occitanie;34;1;24;245;Saint-Chinian;1697;34;1731
76;Occitanie;34;3;12;246;Entre-Vignes;2107;44;2151
76;Occitanie;34;2;23;247;Saint-Clément-de-Rivière;5016;244;5260
76;Occitanie;34;2;23;248;Sainte-Croix-de-Quintillargues;943;17;960
76;Occitanie;34;3;07;249;Saint-Drézéry;2735;58;2793
76;Occitanie;34;1;24;250;Saint-Étienne-d'Albagnan;302;7;309
76;Occitanie;34;2;11;251;Saint-Étienne-de-Gourgas;519;17;536
76;Occitanie;34;1;06;252;Saint-Étienne-Estréchoux;253;5;258
76;Occitanie;34;2;11;253;Saint-Félix-de-l'Héras;34;1;35
76;Occitanie;34;2;06;254;Saint-Félix-de-Lodez;1163;32;1195
76;Occitanie;34;2;23;255;Saint-Gély-du-Fesc;10197;265;10462
76;Occitanie;34;3;07;256;Saint-Geniès-des-Mourgues;2017;33;2050
76;Occitanie;34;1;06;257;Saint-Geniès-de-Varensal;216;2;218
76;Occitanie;34;1;05;258;Saint-Geniès-de-Fontedit;1669;30;1699
76;Occitanie;34;3;22;259;Saint-Georges-d'Orques;5552;66;5618
76;Occitanie;34;1;06;260;Saint-Gervais-sur-Mare;855;15;870
76;Occitanie;34;2;09;261;Saint-Guilhem-le-Désert;245;8;253
76;Occitanie;34;2;09;262;Saint-Guiraud;250;0;250
76;Occitanie;34;2;23;263;Saint-Hilaire-de-Beauvoir;433;3;436
76;Occitanie;34;2;11;264;Saint-Jean-de-Buèges;210;0;210
76;Occitanie;34;2;23;265;Saint-Jean-de-Cornies;750;23;773
76;Occitanie;34;2;23;266;Saint-Jean-de-Cuculles;500;7;507
76;Occitanie;34;2;09;267;Saint-Jean-de-Fos;1727;34;1761
76;Occitanie;34;2;11;268;Saint-Jean-de-la-Blaquière;634;17;651
76;Occitanie;34;1;24;269;Saint-Jean-de-Minervois;147;6;153
76;Occitanie;34;3;10;270;Saint-Jean-de-Védas;11086;204;11290
76;Occitanie;34;1;24;271;Saint-Julien;219;3;222
76;Occitanie;34;3;12;272;Saint-Just;3278;29;3307
76;Occitanie;34;1;24;273;Saint-Martin-de-l'Arçon;143;5;148
76;Occitanie;34;2;11;274;Saint-Martin-de-Londres;2766;26;2792
76;Occitanie;34;2;23;276;Saint-Mathieu-de-Tréviers;4883;96;4979
76;Occitanie;34;2;11;277;Saint-Maurice-Navacelles;186;6;192
76;Occitanie;34;2;11;278;Saint-Michel;55;1;56
76;Occitanie;34;1;05;279;Saint-Nazaire-de-Ladarez;325;3;328
76;Occitanie;34;3;12;280;Saint-Nazaire-de-Pézan;615;7;622
76;Occitanie;34;2;09;281;Saint-Pargoire;2329;37;2366
76;Occitanie;34;2;09;282;Saint-Paul-et-Valmalle;1248;19;1267
76;Occitanie;34;2;11;283;Saint-Pierre-de-la-Fage;135;1;136
76;Occitanie;34;1;24;284;Saint-Pons-de-Thomières;1794;185;1979
76;Occitanie;34;1;14;285;Saint-Pons-de-Mauchiens;638;11;649
76;Occitanie;34;2;11;286;Saint-Privat;401;12;413
76;Occitanie;34;2;09;287;Saint-Saturnin-de-Lucian;267;7;274
76;Occitanie;34;3;12;288;Saint-Sériès;976;22;998
76;Occitanie;34;1;21;289;Saint-Thibéry;2807;36;2843
76;Occitanie;34;2;23;290;Saint-Vincent-de-Barbeyrargues;719;10;729
76;Occitanie;34;1;24;291;Saint-Vincent-d'Olargues;355;23;378
76;Occitanie;34;2;06;292;Salasc;302;6;308
76;Occitanie;34;1;24;293;La Salvetat-sur-Agout;1132;20;1152
76;Occitanie;34;3;12;294;Saturargues;1011;19;1030
76;Occitanie;34;3;22;295;Saussan;1616;33;1649
76;Occitanie;34;3;12;296;Saussines;1004;21;1025
76;Occitanie;34;2;11;297;Sauteyrargues;426;8;434
76;Occitanie;34;1;04;298;Sauvian;5485;97;5582
76;Occitanie;34;1;02;299;Sérignan;7504;158;7662
76;Occitanie;34;1;04;300;Servian;5233;92;5325
76;Occitanie;34;3;25;301;Sète;43858;601;44459
76;Occitanie;34;1;24;302;Siran;744;8;752
76;Occitanie;34;2;11;303;Sorbs;38;1;39
76;Occitanie;34;2;11;304;Soubès;920;12;932
76;Occitanie;34;1;24;305;Le Soulié;127;0;127
76;Occitanie;34;2;11;306;Soumont;174;2;176
76;Occitanie;34;3;07;307;Sussargues;2802;57;2859
76;Occitanie;34;1;06;308;Taussac-la-Billière;457;13;470
76;Occitanie;34;2;23;309;Teyran;4595;107;4702
76;Occitanie;34;1;05;310;Thézan-lès-Béziers;3029;74;3103
76;Occitanie;34;1;21;311;Tourbes;1719;157;1876
76;Occitanie;34;1;06;312;La Tour-sur-Orb;1279;29;1308
76;Occitanie;34;2;09;313;Tressan;676;24;700
76;Occitanie;34;2;23;314;Le Triadou;576;13;589
76;Occitanie;34;2;14;315;Usclas-d'Hérault;430;5;435
76;Occitanie;34;2;11;316;Usclas-du-Bosc;226;2;228
76;Occitanie;34;2;11;317;La Vacquerie-et-Saint-Martin-de-Castries;186;7;193
76;Occitanie;34;2;11;318;Vacquières;721;12;733
76;Occitanie;34;1;05;319;Vailhan;151;4;155
76;Occitanie;34;2;23;320;Vailhauquès;2584;56;2640
76;Occitanie;34;3;13;321;Valergues;2057;29;2086
76;Occitanie;34;2;11;322;Valflaunès;766;24;790
76;Occitanie;34;2;06;323;Valmascle;44;0;44
76;Occitanie;34;1;02;324;Valras-Plage;4206;58;4264
76;Occitanie;34;1;21;325;Valros;1641;32;1673
76;Occitanie;34;1;24;326;Vélieux;91;0;91
76;Occitanie;34;3;07;327;Vendargues;6423;84;6507
76;Occitanie;34;2;09;328;Vendémian;1122;27;1149
76;Occitanie;34;1;02;329;Vendres;2723;81;2804
76;Occitanie;34;1;24;331;Verreries-de-Moussans;95;2;97
76;Occitanie;34;1;01;332;Vias;5717;65;5782
76;Occitanie;34;3;08;333;Vic-la-Gardiole;3373;28;3401
76;Occitanie;34;1;24;334;Vieussan;269;0;269
76;Occitanie;34;1;06;335;Villemagne-l'Argentière;419;12;431
76;Occitanie;34;1;04;336;Villeneuve-lès-Béziers;4102;53;4155
76;Occitanie;34;3;22;337;Villeneuve-lès-Maguelone;10344;121;10465
76;Occitanie;34;2;06;338;Villeneuvette;69;3;72
76;Occitanie;34;1;24;339;Villespassans;174;2;176
76;Occitanie;34;3;12;340;Villetelle;1467;43;1510
76;Occitanie;34;3;14;341;Villeveyrac;3859;68;3927
76;Occitanie;34;2;11;342;Viols-en-Laval;206;4;210
76;Occitanie;34;2;11;343;Viols-le-Fort;1228;28;1256
76;Occitanie;34;3;13;344;La Grande-Motte;8696;104;8800
53;Bretagne;35;3;13;001;Acigné;6834;164;6998
53;Bretagne;35;1;12;002;Amanlis;1759;37;1796
53;Bretagne;35;3;01;003;Andouillé-Neuville;946;9;955
53;Bretagne;35;1;01;004;Val-Couesnon;4137;88;4225
53;Bretagne;35;1;10;005;Arbrissel;313;12;325
53;Bretagne;35;1;10;006;Argentré-du-Plessis;4502;129;4631
53;Bretagne;35;3;01;007;Aubigné;485;2;487
53;Bretagne;35;1;10;008;Availles-sur-Seiche;674;18;692
53;Bretagne;35;4;07;009;Baguer-Morvan;1703;27;1730
53;Bretagne;35;4;07;010;Baguer-Pican;1738;16;1754
53;Bretagne;35;2;02;012;Bain-de-Bretagne;7314;165;7479
53;Bretagne;35;2;17;013;Bains-sur-Oust;3503;162;3665
53;Bretagne;35;1;10;014;Bais;2455;32;2487
53;Bretagne;35;1;27;015;Balazé;2218;48;2266
53;Bretagne;35;2;11;016;Baulon;2188;61;2249
53;Bretagne;35;4;06;017;La Baussaine;673;10;683
53;Bretagne;35;1;09;018;La Bazouge-du-Désert;1069;21;1090
53;Bretagne;35;1;01;019;Bazouges-la-Pérouse;1856;27;1883
53;Bretagne;35;1;09;021;Beaucé;1357;36;1393
53;Bretagne;35;3;15;022;Bécherel;688;15;703
53;Bretagne;35;3;16;023;Bédée;4417;73;4490
53;Bretagne;35;3;03;024;Betton;12265;259;12524
53;Bretagne;35;1;08;025;Billé;1054;15;1069
53;Bretagne;35;3;15;026;Bléruais;102;6;108
53;Bretagne;35;3;15;027;Boisgervilly;1707;33;1740
53;Bretagne;35;1;05;028;Boistrudan;722;14;736
53;Bretagne;35;4;06;029;Bonnemain;1539;25;1564
53;Bretagne;35;2;02;030;La Bosse-de-Bretagne;676;17;693
53;Bretagne;35;3;13;031;La Bouëxière;4526;101;4627
53;Bretagne;35;3;12;032;Bourgbarré;4515;62;4577
53;Bretagne;35;2;11;033;Bourg-des-Comptes;3295;69;3364
53;Bretagne;35;4;07;034;La Boussac;1200;24;1224
53;Bretagne;35;2;11;035;Bovel;598;11;609
53;Bretagne;35;3;24;037;Bréal-sous-Montfort;6404;81;6485
53;Bretagne;35;1;27;038;Bréal-sous-Vitré;633;21;654
53;Bretagne;35;3;13;039;Brécé;2059;43;2102
53;Bretagne;35;3;16;040;Breteil;3655;78;3733
53;Bretagne;35;1;12;041;Brie;1006;17;1023
53;Bretagne;35;1;10;042;Brielles;670;30;700
53;Bretagne;35;4;07;044;Broualan;381;10;391
53;Bretagne;35;2;17;045;Bruc-sur-Aff;866;19;885
53;Bretagne;35;2;11;046;Les Brulais;540;8;548
53;Bretagne;35;3;04;047;Bruz;18905;461;19366
53;Bretagne;35;4;25;049;Cancale;5226;91;5317
53;Bretagne;35;4;06;050;Cardroc;593;9;602
53;Bretagne;35;3;03;051;Cesson-Sévigné;17082;534;17616
53;Bretagne;35;1;27;052;Champeaux;514;15;529
53;Bretagne;35;2;02;054;Chanteloup;1815;45;1860
53;Bretagne;35;3;20;055;Chantepie;10278;191;10469
53;Bretagne;35;4;06;056;La Chapelle-aux-Filtzméens;814;20;834
53;Bretagne;35;2;11;057;La Chapelle-Bouëxic;1496;26;1522
53;Bretagne;35;3;15;058;La Chapelle-Chaussée;1295;15;1310
53;Bretagne;35;3;03;059;La Chapelle-des-Fougeretz;4682;96;4778
53;Bretagne;35;3;15;060;La Chapelle du Lou du Lac;1011;19;1030
53;Bretagne;35;1;27;061;La Chapelle-Erbrée;711;17;728
53;Bretagne;35;1;09;062;La Chapelle-Janson;1475;27;1502
53;Bretagne;35;1;08;063;La Chapelle-Saint-Aubert;452;6;458
53;Bretagne;35;2;17;064;La Chapelle-de-Brain;984;20;1004
53;Bretagne;35;3;24;065;La Chapelle-Thouarault;2219;44;2263
53;Bretagne;35;3;04;066;Chartres-de-Bretagne;8157;134;8291
53;Bretagne;35;3;13;067;Chasné-sur-Illet;1598;28;1626
53;Bretagne;35;1;05;068;Châteaubourg;7336;154;7490
53;Bretagne;35;3;05;069;Châteaugiron;10283;263;10546
53;Bretagne;35;4;07;070;Châteauneuf-d'Ille-et-Vilaine;1710;25;1735
53;Bretagne;35;1;01;071;Le Châtellier;436;6;442
53;Bretagne;35;1;27;072;Châtillon-en-Vendelais;1675;35;1710
53;Bretagne;35;1;01;075;Chauvigné;808;19;827
53;Bretagne;35;3;24;076;Chavagne;4268;82;4350
53;Bretagne;35;1;10;077;Chelun;347;11;358
53;Bretagne;35;4;07;078;Cherrueix;1092;22;1114
53;Bretagne;35;3;03;079;Chevaigné;2325;57;2382
53;Bretagne;35;3;24;080;Cintré;2410;62;2472
53;Bretagne;35;3;14;081;Clayes;908;30;938
53;Bretagne;35;1;10;082;Coësmes;1465;35;1500
53;Bretagne;35;2;11;084;Comblessac;695;11;706
53;Bretagne;35;4;06;085;Combourg;5963;142;6105
53;Bretagne;35;1;08;086;Combourtillé;611;9;620
53;Bretagne;35;1;27;087;Cornillé;964;32;996
53;Bretagne;35;3;12;088;Corps-Nuds;3434;56;3490
53;Bretagne;35;2;02;089;La Couyère;455;12;467
53;Bretagne;35;2;02;090;Crevin;2862;40;2902
53;Bretagne;35;3;15;091;Le Crouais;597;6;603
53;Bretagne;35;4;06;092;Cuguen;834;14;848
53;Bretagne;35;4;26;093;Dinard;10181;526;10707
53;Bretagne;35;4;06;094;Dingé;1638;24;1662
53;Bretagne;35;4;07;095;Dol-de-Bretagne;5738;332;6070
53;Bretagne;35;1;05;096;Domagné;2383;55;2438
53;Bretagne;35;1;10;097;Domalain;2020;51;2071
53;Bretagne;35;2;02;098;La Dominelais;1396;27;1423
53;Bretagne;35;3;05;099;Domloup;3680;65;3745
53;Bretagne;35;3;13;101;Dourdain;1195;21;1216
53;Bretagne;35;1;10;102;Drouges;510;10;520
53;Bretagne;35;1;10;103;Eancé;420;10;430
53;Bretagne;35;4;07;104;Epiniac;1417;26;1443
53;Bretagne;35;1;27;105;Erbrée;1697;53;1750
53;Bretagne;35;2;02;106;Ercé-en-Lamée;1514;14;1528
53;Bretagne;35;3;13;107;Ercé-près-Liffré;1949;35;1984
53;Bretagne;35;1;10;108;Essé;1061;23;1084
53;Bretagne;35;1;10;109;Étrelles;2585;59;2644
53;Bretagne;35;3;01;110;Feins;1014;19;1033
53;Bretagne;35;1;09;111;Le Ferré;710;6;716
53;Bretagne;35;1;09;112;Fleurigné;939;26;965
53;Bretagne;35;1;10;114;Forges-la-Forêt;261;6;267
53;Bretagne;35;1;97;115;Fougères;20595;653;21248
53;Bretagne;35;4;07;116;La Fresnais;2571;58;2629
53;Bretagne;35;3;15;117;Gaël;1619;22;1641
53;Bretagne;35;3;01;118;Gahard;1525;24;1549
53;Bretagne;35;1;10;119;Gennes-sur-Seiche;946;21;967
53;Bretagne;35;3;14;120;Gévezé;5521;109;5630
53;Bretagne;35;3;08;121;Gosné;2000;37;2037
53;Bretagne;35;4;25;122;La Gouesnière;1943;46;1989
53;Bretagne;35;2;11;123;Goven;4321;90;4411
53;Bretagne;35;2;02;124;Grand-Fougeray;2455;38;2493
53;Bretagne;35;1;10;125;La Guerche-de-Bretagne;4249;147;4396
53;Bretagne;35;2;11;126;Guichen;8674;203;8877
53;Bretagne;35;2;11;127;Guignen;3986;97;4083
53;Bretagne;35;3;14;128;Guipel;1701;39;1740
53;Bretagne;35;4;14;130;Hédé-Bazouges;2247;54;2301
53;Bretagne;35;3;24;131;L'Hermitage;4629;81;4710
53;Bretagne;35;4;07;132;Hirel;1389;34;1423
53;Bretagne;35;3;16;133;Iffendic;4553;93;4646
53;Bretagne;35;4;06;134;Les Iffs;273;12;285
53;Bretagne;35;3;15;135;Irodouër;2263;37;2300
53;Bretagne;35;1;12;136;Janzé;8470;159;8629
53;Bretagne;35;1;08;137;Javené;2105;70;2175
53;Bretagne;35;1;09;138;Laignelet;1173;28;1201
53;Bretagne;35;3;04;139;Laillé;5116;149;5265
53;Bretagne;35;2;02;140;Lalleu;561;10;571
53;Bretagne;35;1;27;141;Landavran;693;21;714
53;Bretagne;35;1;09;142;Landéan;1183;22;1205
53;Bretagne;35;3;15;143;Landujan;929;30;959
53;Bretagne;35;3;15;144;Langan;1031;19;1050
53;Bretagne;35;2;17;145;Langon;1385;25;1410
53;Bretagne;35;3;14;146;Langouet;606;2;608
53;Bretagne;35;4;06;148;Lanrigan;157;0;157
53;Bretagne;35;2;11;149;Lassy;1757;39;1796
53;Bretagne;35;1;08;150;Lécousse;3260;95;3355
53;Bretagne;35;2;17;151;Lieuron;777;15;792
53;Bretagne;35;3;13;152;Liffré;7949;137;8086
53;Bretagne;35;4;07;153;Lillemer;367;11;378
53;Bretagne;35;3;08;154;Livré-sur-Changeon;1718;41;1759
53;Bretagne;35;2;17;155;Lohéac;648;15;663
53;Bretagne;35;4;06;156;Longaulnay;612;10;622
53;Bretagne;35;1;09;157;Le Loroux;643;15;658
53;Bretagne;35;4;06;159;Lourmais;326;3;329
53;Bretagne;35;2;11;160;Loutehel;247;5;252
53;Bretagne;35;1;05;161;Louvigné-de-Bais;1912;36;1948
53;Bretagne;35;1;09;162;Louvigné-du-Désert;3340;59;3399
53;Bretagne;35;1;09;163;Luitré-Dompierre;1823;29;1852
53;Bretagne;35;1;01;164;Marcillé-Raoul;743;11;754
53;Bretagne;35;1;10;165;Marcillé-Robert;951;21;972
53;Bretagne;35;1;27;166;Marpiré;1027;15;1042
53;Bretagne;35;1;10;167;Martigné-Ferchaud;2583;65;2648
53;Bretagne;35;2;11;168;Val d'Anast;3954;81;4035
53;Bretagne;35;3;16;169;Maxent;1470;17;1487
53;Bretagne;35;1;27;170;Mecé;607;16;623
53;Bretagne;35;3;15;171;Médréac;1819;48;1867
53;Bretagne;35;4;06;172;Meillac;1918;30;1948
53;Bretagne;35;3;14;173;Melesse;6958;107;7065
53;Bretagne;35;1;09;174;Mellé;649;12;661
53;Bretagne;35;2;11;175;Mernel;1012;16;1028
53;Bretagne;35;2;17;176;Guipry-Messac;7107;142;7249
53;Bretagne;35;3;14;177;La Mézière;4971;121;5092
53;Bretagne;35;3;08;178;Mézières-sur-Couesnon;1799;19;1818
53;Bretagne;35;4;07;179;Miniac-Morvan;4148;80;4228
53;Bretagne;35;3;15;180;Miniac-sous-Bécherel;792;16;808
53;Bretagne;35;4;26;181;Le Minihic-sur-Rance;1483;35;1518
53;Bretagne;35;1;27;183;Mondevert;820;21;841
53;Bretagne;35;3;15;184;Montauban-de-Bretagne;6086;246;6332
53;Bretagne;35;1;27;185;Montautour;266;1;267
53;Bretagne;35;4;07;186;Mont-Dol;1085;31;1116
53;Bretagne;35;3;16;187;Monterfil;1332;45;1377
53;Bretagne;35;3;16;188;Montfort-sur-Meu;6726;173;6899
53;Bretagne;35;3;03;189;Montgermont;3515;62;3577
53;Bretagne;35;1;09;190;Monthault;250;8;258
53;Bretagne;35;1;01;191;Les Portes du Coglais;2319;49;2368
53;Bretagne;35;1;27;192;Montreuil-des-Landes;232;5;237
53;Bretagne;35;3;14;193;Montreuil-le-Gast;1972;44;2016
53;Bretagne;35;1;27;194;Montreuil-sous-Pérouse;1006;32;1038
53;Bretagne;35;3;01;195;Montreuil-sur-Ille;2390;35;2425
53;Bretagne;35;3;24;196;Mordelles;7338;141;7479
53;Bretagne;35;3;01;197;Mouazé;1718;19;1737
53;Bretagne;35;1;10;198;Moulins;713;25;738
53;Bretagne;35;1;10;199;Moussé;343;9;352
53;Bretagne;35;1;10;200;Moutiers;919;16;935
53;Bretagne;35;3;15;201;Muel;885;7;892
53;Bretagne;35;2;02;202;La Noë-Blanche;1022;9;1031
53;Bretagne;35;3;16;203;La Nouaye;353;5;358
53;Bretagne;35;3;12;204;Nouvoitou;3281;59;3340
53;Bretagne;35;1;01;205;Noyal-sous-Bazouges;380;8;388
53;Bretagne;35;3;04;206;Noyal-Châtillon-sur-Seiche;7003;127;7130
53;Bretagne;35;3;05;207;Noyal-sur-Vilaine;6133;150;6283
53;Bretagne;35;3;12;208;Orgères;5152;124;5276
53;Bretagne;35;3;23;210;Pacé;11860;329;12189
53;Bretagne;35;3;16;211;Paimpont;1772;40;1812
53;Bretagne;35;2;02;212;Pancé;1191;32;1223
53;Bretagne;35;1;08;214;Parcé;649;1;650
53;Bretagne;35;1;09;215;Parigné;1331;43;1374
53;Bretagne;35;3;14;216;Parthenay-de-Bretagne;1780;28;1808
53;Bretagne;35;1;10;217;Le Pertre;1380;29;1409
53;Bretagne;35;2;02;218;Le Petit-Fougeray;883;20;903
53;Bretagne;35;2;17;219;Pipriac;3813;76;3889
53;Bretagne;35;3;05;220;Piré-Chancé;3031;54;3085
53;Bretagne;35;2;02;221;Pléchâtel;2780;54;2834
53;Bretagne;35;4;07;222;Pleine-Fougères;1973;33;2006
53;Bretagne;35;3;16;223;Plélan-le-Grand;4008;87;4095
53;Bretagne;35;4;07;224;Plerguer;2796;52;2848
53;Bretagne;35;4;06;225;Plesder;781;15;796
53;Bretagne;35;4;06;226;Pleugueneuc;1927;27;1954
53;Bretagne;35;3;16;227;Pleumeleuc;3474;51;3525
53;Bretagne;35;4;26;228;Pleurtuit;6982;124;7106
53;Bretagne;35;1;27;229;Pocé-les-Bois;1319;52;1371
53;Bretagne;35;1;09;230;Poilley;374;4;378
53;Bretagne;35;2;02;231;Poligné;1195;31;1226
53;Bretagne;35;1;27;232;Princé;391;7;398
53;Bretagne;35;4;06;233;Québriac;1578;37;1615
53;Bretagne;35;3;15;234;Quédillac;1194;17;1211
53;Bretagne;35;1;10;235;Rannée;1076;47;1123
53;Bretagne;35;2;17;236;Redon;9287;745;10032
53;Bretagne;35;2;17;237;Renac;1034;22;1056
53;Bretagne;35;3;98;238;Rennes;220488;4167;224655
53;Bretagne;35;1;10;239;Retiers;4438;96;4534
53;Bretagne;35;3;24;240;Le Rheu;8932;293;9225
53;Bretagne;35;4;26;241;La Richardais;2403;85;2488
53;Bretagne;35;1;01;242;Rimou;345;4;349
53;Bretagne;35;1;08;243;Romagné;2458;55;2513
53;Bretagne;35;1;01;244;Romazy;248;3;251
53;Bretagne;35;3;15;245;Romillé;4032;73;4105
53;Bretagne;35;4;07;246;Roz-Landrieux;1361;27;1388
53;Bretagne;35;4;07;247;Roz-sur-Couesnon;998;12;1010
53;Bretagne;35;4;07;248;Sains;459;8;467
53;Bretagne;35;2;02;249;Sainte-Anne-sur-Vilaine;1029;14;1043
53;Bretagne;35;3;12;250;Saint-Armel;2206;39;2245
53;Bretagne;35;3;01;251;Saint-Aubin-d'Aubigné;3916;82;3998
53;Bretagne;35;1;27;252;Saint-Aubin-des-Landes;923;34;957
53;Bretagne;35;3;08;253;Saint-Aubin-du-Cormier;4006;162;4168
53;Bretagne;35;4;07;255;Saint-Benoît-des-Ondes;975;30;1005
53;Bretagne;35;4;26;256;Saint-Briac-sur-Mer;2193;63;2256
53;Bretagne;35;1;01;257;Maen Roch;4958;96;5054
53;Bretagne;35;4;06;258;Saint-Brieuc-des-Iffs;331;9;340
53;Bretagne;35;4;07;259;Saint-Broladre;1140;22;1162
53;Bretagne;35;1;27;260;Saint-Christophe-des-Bois;563;6;569
53;Bretagne;35;1;08;261;Saint-Christophe-de-Valains;235;2;237
53;Bretagne;35;1;10;262;Sainte-Colombe;356;6;362
53;Bretagne;35;4;25;263;Saint-Coulomb;2820;88;2908
53;Bretagne;35;1;05;264;Saint-Didier;2034;45;2079
53;Bretagne;35;4;06;265;Saint-Domineuc;2562;49;2611
53;Bretagne;35;3;12;266;Saint-Erblon;3311;73;3384
53;Bretagne;35;2;17;268;Saint-Ganton;429;8;437
53;Bretagne;35;4;07;270;Saint-Georges-de-Gréhaigne;371;4;375
53;Bretagne;35;1;09;271;Saint-Georges-de-Reintembault;1487;26;1513
53;Bretagne;35;1;10;272;Saint-Germain-du-Pinel;951;23;974
53;Bretagne;35;1;01;273;Saint-Germain-en-Coglès;2062;31;2093
53;Bretagne;35;3;14;274;Saint-Germain-sur-Ille;962;15;977
53;Bretagne;35;3;14;275;Saint-Gilles;5178;85;5263
53;Bretagne;35;3;14;276;Saint-Gondran;571;12;583
53;Bretagne;35;3;16;277;Saint-Gonlay;377;6;383
53;Bretagne;35;3;03;278;Saint-Grégoire;9890;372;10262
53;Bretagne;35;4;07;279;Saint-Guinoux;1207;28;1235
53;Bretagne;35;1;01;280;Saint-Hilaire-des-Landes;1025;20;1045
53;Bretagne;35;3;22;281;Saint-Jacques-de-la-Lande;13948;158;14106
53;Bretagne;35;1;08;282;Rives-du-Couesnon;2886;52;2938
53;Bretagne;35;1;05;283;Saint-Jean-sur-Vilaine;1334;23;1357
53;Bretagne;35;4;26;284;Saint-Jouan-des-Guérets;2683;71;2754
53;Bretagne;35;2;17;285;Saint-Just;1055;23;1078
53;Bretagne;35;4;06;286;Saint-Léger-des-Prés;284;10;294
53;Bretagne;35;4;26;287;Saint-Lunaire;2460;88;2548
53;Bretagne;35;4;99;288;Saint-Malo;46803;1338;48141
53;Bretagne;35;2;17;289;Saint-Malo-de-Phily;1076;18;1094
53;Bretagne;35;3;15;290;Saint-Malon-sur-Mel;578;11;589
53;Bretagne;35;4;07;291;Saint-Marcan;437;9;446
53;Bretagne;35;1;01;292;Saint-Marc-le-Blanc;1633;39;1672
53;Bretagne;35;2;17;294;Sainte-Marie;2265;65;2330
53;Bretagne;35;3;15;295;Saint-Maugan;538;11;549
53;Bretagne;35;3;14;296;Saint-Médard-sur-Ille;1322;23;1345
53;Bretagne;35;3;15;297;Saint-Méen-le-Grand;4599;164;4763
53;Bretagne;35;4;25;299;Saint-Méloir-des-Ondes;4327;108;4435
53;Bretagne;35;1;27;300;Saint-M'Hervé;1356;39;1395
53;Bretagne;35;3;15;302;Saint-Onen-la-Chapelle;1127;24;1151
53;Bretagne;35;1;08;304;Saint-Ouen-des-Alleux;1313;29;1342
53;Bretagne;35;3;16;305;Saint-Péran;418;8;426
53;Bretagne;35;4;07;306;Saint-Père-Marc-en-Poulet;2333;163;2496
53;Bretagne;35;3;15;307;Saint-Pern;1042;19;1061
53;Bretagne;35;4;06;308;Mesnil-Roc'h;4336;75;4411
53;Bretagne;35;1;01;309;Saint-Rémy-du-Plain;819;13;832
53;Bretagne;35;1;08;310;Saint-Sauveur-des-Landes;1531;27;1558
53;Bretagne;35;2;11;311;Saint-Séglin;584;4;588
53;Bretagne;35;2;11;312;Saint-Senoux;1829;48;1877
53;Bretagne;35;4;07;314;Saint-Suliac;943;50;993
53;Bretagne;35;3;13;315;Saint-Sulpice-la-Forêt;1382;41;1423
53;Bretagne;35;2;02;316;Saint-Sulpice-des-Landes;827;9;836
53;Bretagne;35;3;14;317;Saint-Symphorien;589;61;650
53;Bretagne;35;4;06;318;Saint-Thual;947;21;968
53;Bretagne;35;3;16;319;Saint-Thurial;2114;43;2157
53;Bretagne;35;3;15;320;Saint-Uniac;540;4;544
53;Bretagne;35;2;02;321;Saulnières;794;10;804
53;Bretagne;35;2;02;322;Le Sel-de-Bretagne;1109;27;1136
53;Bretagne;35;1;09;324;La Selle-en-Luitré;616;17;633
53;Bretagne;35;1;10;325;La Selle-Guerchaise;155;6;161
53;Bretagne;35;3;01;326;Sens-de-Bretagne;2566;41;2607
53;Bretagne;35;3;05;327;Servon-sur-Vilaine;3804;88;3892
53;Bretagne;35;2;17;328;Sixt-sur-Aff;2135;43;2178
53;Bretagne;35;4;07;329;Sougéal;547;11;558
53;Bretagne;35;1;27;330;Taillis;993;26;1019
53;Bretagne;35;3;16;331;Talensac;2489;51;2540
53;Bretagne;35;2;02;332;Teillay;1069;11;1080
53;Bretagne;35;1;10;333;Le Theil-de-Bretagne;1725;33;1758
53;Bretagne;35;3;13;334;Thorigné-Fouillard;8575;211;8786
53;Bretagne;35;1;10;335;Thourie;837;22;859
53;Bretagne;35;1;01;336;Le Tiercent;182;3;185
53;Bretagne;35;4;06;337;Tinténiac;3739;191;3930
53;Bretagne;35;1;10;338;Torcé;1223;29;1252
53;Bretagne;35;4;07;339;Trans-la-Forêt;591;4;595
53;Bretagne;35;3;16;340;Treffendel;1307;24;1331
53;Bretagne;35;4;06;342;Trémeheuc;347;12;359
53;Bretagne;35;2;02;343;Tresbœuf;1244;20;1264
53;Bretagne;35;4;06;345;Trévérien;895;23;918
53;Bretagne;35;4;06;346;Trimer;209;4;213
53;Bretagne;35;1;27;347;Val-d'Izé;2580;57;2637
53;Bretagne;35;1;10;350;Vergéal;806;24;830
53;Bretagne;35;3;24;351;Le Verger;1436;24;1460
53;Bretagne;35;3;12;352;Vern-sur-Seiche;8169;146;8315
53;Bretagne;35;3;24;353;Vezin-le-Coquet;6114;113;6227
53;Bretagne;35;4;07;354;Vieux-Viel;317;2;319
53;Bretagne;35;3;01;355;Vieux-Vy-sur-Couesnon;1245;6;1251
53;Bretagne;35;3;14;356;Vignoc;2025;25;2050
53;Bretagne;35;1;09;357;Villamée;306;5;311
53;Bretagne;35;4;07;358;La Ville-ès-Nonais;1220;32;1252
53;Bretagne;35;1;10;359;Visseiche;838;17;855
53;Bretagne;35;1;27;360;Vitré;18487;553;19040
53;Bretagne;35;4;07;361;Le Vivier-sur-Mer;1054;7;1061
53;Bretagne;35;4;07;362;Le Tronchet;1177;9;1186
53;Bretagne;35;3;04;363;Pont-Péan;4413;106;4519
24;Centre-Val de Loire;36;3;11;001;Aigurande;1420;27;1447
24;Centre-Val de Loire;36;4;10;002;Aize;118;0;118
24;Centre-Val de Loire;36;4;01;003;Ambrault;891;23;914
24;Centre-Val de Loire;36;4;13;004;Anjouin;322;8;330
24;Centre-Val de Loire;36;2;01;005;Ardentes;3850;82;3932
24;Centre-Val de Loire;36;2;02;006;Argenton-sur-Creuse;4880;213;5093
24;Centre-Val de Loire;36;2;04;007;Argy;601;9;610
24;Centre-Val de Loire;36;2;04;008;Arpheuilles;222;9;231
24;Centre-Val de Loire;36;2;01;009;Arthon;1218;43;1261
24;Centre-Val de Loire;36;1;03;010;Azay-le-Ferron;867;18;885
24;Centre-Val de Loire;36;4;13;011;Bagneux;175;2;177
24;Centre-Val de Loire;36;2;02;012;Baraize;363;0;363
24;Centre-Val de Loire;36;2;10;013;Baudres;428;5;433
24;Centre-Val de Loire;36;2;02;014;Bazaiges;199;6;205
24;Centre-Val de Loire;36;1;12;015;Beaulieu;54;1;55
24;Centre-Val de Loire;36;1;12;016;Bélâbre;945;22;967
24;Centre-Val de Loire;36;3;08;017;La Berthenoux;368;5;373
24;Centre-Val de Loire;36;1;03;018;Le Blanc;6250;222;6472
24;Centre-Val de Loire;36;4;08;019;Bommiers;312;5;317
24;Centre-Val de Loire;36;1;12;020;Bonneuil;74;1;75
24;Centre-Val de Loire;36;4;09;021;Les Bordes;891;20;911
24;Centre-Val de Loire;36;2;02;022;Bouesse;410;8;418
24;Centre-Val de Loire;36;2;10;023;Bouges-le-Château;261;5;266
24;Centre-Val de Loire;36;2;10;024;Bretagne;130;1;131
24;Centre-Val de Loire;36;3;08;025;Briantes;608;11;619
24;Centre-Val de Loire;36;2;10;026;Brion;596;8;604
24;Centre-Val de Loire;36;4;08;027;Brives;249;6;255
24;Centre-Val de Loire;36;3;11;028;La Buxerette;115;2;117
24;Centre-Val de Loire;36;4;10;029;Buxeuil;230;3;233
24;Centre-Val de Loire;36;3;11;030;Buxières-d'Aillac;244;4;248
24;Centre-Val de Loire;36;2;04;031;Buzançais;4516;74;4590
24;Centre-Val de Loire;36;2;02;032;Ceaulmont;724;22;746
24;Centre-Val de Loire;36;2;02;033;Celon;398;4;402
24;Centre-Val de Loire;36;4;13;034;Chabris;2763;38;2801
24;Centre-Val de Loire;36;1;12;035;Chaillac;1086;14;1100
24;Centre-Val de Loire;36;1;12;036;Chalais;149;1;150
24;Centre-Val de Loire;36;4;10;037;La Champenoise;283;6;289
24;Centre-Val de Loire;36;3;08;038;Champillet;137;2;139
24;Centre-Val de Loire;36;2;04;040;La Chapelle-Orthemale;102;0;102
24;Centre-Val de Loire;36;4;10;041;La Chapelle-Saint-Laurian;140;1;141
24;Centre-Val de Loire;36;2;02;042;Chasseneuil;703;11;714
24;Centre-Val de Loire;36;3;11;043;Chassignolles;574;23;597
24;Centre-Val de Loire;36;2;99;044;Châteauroux;43122;1540;44662
24;Centre-Val de Loire;36;2;04;045;Châtillon-sur-Indre;2360;34;2394
24;Centre-Val de Loire;36;3;08;046;La Châtre;4054;117;4171
24;Centre-Val de Loire;36;1;12;047;La Châtre-Langlin;504;8;512
24;Centre-Val de Loire;36;2;02;048;Chavin;271;9;280
24;Centre-Val de Loire;36;1;12;049;Chazelet;125;2;127
24;Centre-Val de Loire;36;2;04;050;Chezelles;457;7;464
24;Centre-Val de Loire;36;1;12;051;Chitray;186;5;191
24;Centre-Val de Loire;36;4;09;052;Chouday;153;2;155
24;Centre-Val de Loire;36;1;03;053;Ciron;543;13;556
24;Centre-Val de Loire;36;2;04;054;Cléré-du-Bois;233;7;240
24;Centre-Val de Loire;36;2;04;055;Clion;1004;18;1022
24;Centre-Val de Loire;36;3;11;056;Cluis;984;15;999
24;Centre-Val de Loire;36;2;10;057;Coings;881;23;904
24;Centre-Val de Loire;36;1;03;058;Concremiers;645;17;662
24;Centre-Val de Loire;36;4;08;059;Condé;233;8;241
24;Centre-Val de Loire;36;3;11;060;Crevant;703;14;717
24;Centre-Val de Loire;36;3;11;061;Crozon-sur-Vauvre;332;9;341
24;Centre-Val de Loire;36;2;02;062;Cuzion;441;6;447
24;Centre-Val de Loire;36;2;05;063;Déols;7609;149;7758
24;Centre-Val de Loire;36;2;01;064;Diors;749;16;765
24;Centre-Val de Loire;36;4;10;065;Diou;260;5;265
24;Centre-Val de Loire;36;1;03;066;Douadic;441;14;455
24;Centre-Val de Loire;36;1;12;067;Dunet;101;3;104
24;Centre-Val de Loire;36;4;13;068;Dun-le-Poëlier;422;7;429
24;Centre-Val de Loire;36;2;13;069;Écueillé;1216;23;1239
24;Centre-Val de Loire;36;2;02;070;Éguzon-Chantôme;1345;37;1382
24;Centre-Val de Loire;36;2;01;071;Étrechet;1012;20;1032
24;Centre-Val de Loire;36;3;08;073;Feusines;213;5;218
24;Centre-Val de Loire;36;2;04;074;Fléré-la-Rivière;536;9;545
24;Centre-Val de Loire;36;4;10;075;Fontenay;89;1;90
24;Centre-Val de Loire;36;1;03;076;Fontgombault;249;3;252
24;Centre-Val de Loire;36;2;13;077;Fontguenand;245;3;248
24;Centre-Val de Loire;36;3;11;078;Fougerolles;356;5;361
24;Centre-Val de Loire;36;2;10;079;Francillon;77;1;78
24;Centre-Val de Loire;36;2;13;080;Frédille;72;2;74
24;Centre-Val de Loire;36;2;02;081;Gargilesse-Dampierre;280;8;288
24;Centre-Val de Loire;36;2;13;082;Gehée;252;1;253
24;Centre-Val de Loire;36;4;10;083;Giroux;117;4;121
24;Centre-Val de Loire;36;3;11;084;Gournay;287;2;289
24;Centre-Val de Loire;36;4;10;085;Guilly;247;6;253
24;Centre-Val de Loire;36;2;13;086;Heugnes;390;8;398
24;Centre-Val de Loire;36;1;03;087;Ingrandes;312;5;317
24;Centre-Val de Loire;36;4;09;088;Issoudun;11477;290;11767
24;Centre-Val de Loire;36;2;01;089;Jeu-les-Bois;405;6;411
24;Centre-Val de Loire;36;2;13;090;Jeu-Maloches;118;2;120
24;Centre-Val de Loire;36;3;08;091;Lacs;656;18;674
24;Centre-Val de Loire;36;2;13;092;Langé;270;8;278
24;Centre-Val de Loire;36;2;10;093;Levroux;2923;37;2960
24;Centre-Val de Loire;36;1;12;094;Lignac;449;7;456
24;Centre-Val de Loire;36;3;08;095;Lignerolles;106;2;108
24;Centre-Val de Loire;36;1;03;096;Lingé;214;3;217
24;Centre-Val de Loire;36;4;10;097;Liniez;323;9;332
24;Centre-Val de Loire;36;4;10;098;Lizeray;85;3;88
24;Centre-Val de Loire;36;3;11;099;Lourdoueix-Saint-Michel;299;4;303
24;Centre-Val de Loire;36;3;08;100;Lourouer-Saint-Laurent;261;6;267
24;Centre-Val de Loire;36;2;12;101;Luant;1536;39;1575
24;Centre-Val de Loire;36;4;10;102;Luçay-le-Libre;102;2;104
24;Centre-Val de Loire;36;2;13;103;Luçay-le-Mâle;1340;16;1356
24;Centre-Val de Loire;36;1;03;104;Lurais;234;2;236
24;Centre-Val de Loire;36;1;03;105;Lureuil;257;3;260
24;Centre-Val de Loire;36;1;12;106;Luzeret;155;1;156
24;Centre-Val de Loire;36;2;13;107;Lye;728;12;740
24;Centre-Val de Loire;36;3;11;108;Lys-Saint-Georges;214;2;216
24;Centre-Val de Loire;36;3;11;109;Le Magny;1054;19;1073
24;Centre-Val de Loire;36;3;11;110;Maillet;260;6;266
24;Centre-Val de Loire;36;3;11;111;Malicornay;193;3;196
24;Centre-Val de Loire;36;2;01;112;Mâron;750;19;769
24;Centre-Val de Loire;36;1;03;113;Martizay;938;20;958
24;Centre-Val de Loire;36;1;12;114;Mauvières;296;8;304
24;Centre-Val de Loire;36;4;13;115;Menetou-sur-Nahon;128;2;130
24;Centre-Val de Loire;36;4;10;116;Ménétréols-sous-Vatan;118;1;119
24;Centre-Val de Loire;36;2;02;117;Le Menoux;429;7;436
24;Centre-Val de Loire;36;2;12;118;Méobecq;378;3;381
24;Centre-Val de Loire;36;1;03;119;Mérigny;540;13;553
24;Centre-Val de Loire;36;3;11;120;Mers-sur-Indre;669;12;681
24;Centre-Val de Loire;36;4;08;121;Meunet-Planches;172;6;178
24;Centre-Val de Loire;36;4;10;122;Meunet-sur-Vatan;197;2;199
24;Centre-Val de Loire;36;1;03;123;Mézières-en-Brenne;990;20;1010
24;Centre-Val de Loire;36;1;12;124;Migné;274;11;285
24;Centre-Val de Loire;36;4;09;125;Migny;120;5;125
24;Centre-Val de Loire;36;3;11;126;Montchevrier;446;5;451
24;Centre-Val de Loire;36;3;11;127;Montgivray;1570;36;1606
24;Centre-Val de Loire;36;2;01;128;Montierchaume;1673;167;1840
24;Centre-Val de Loire;36;3;11;129;Montipouret;557;14;571
24;Centre-Val de Loire;36;3;08;130;Montlevicq;108;2;110
24;Centre-Val de Loire;36;2;02;131;Mosnay;472;7;479
24;Centre-Val de Loire;36;3;08;132;La Motte-Feuilly;64;3;67
24;Centre-Val de Loire;36;3;11;133;Mouhers;216;6;222
24;Centre-Val de Loire;36;1;12;134;Mouhet;402;12;414
24;Centre-Val de Loire;36;2;10;135;Moulins-sur-Céphons;295;6;301
24;Centre-Val de Loire;36;2;04;136;Murs;129;3;132
24;Centre-Val de Loire;36;1;03;137;Néons-sur-Creuse;365;16;381
24;Centre-Val de Loire;36;3;08;138;Néret;187;7;194
24;Centre-Val de Loire;36;2;12;139;Neuillay-les-Bois;657;16;673
24;Centre-Val de Loire;36;4;08;140;Neuvy-Pailloux;1174;21;1195
24;Centre-Val de Loire;36;3;11;141;Neuvy-Saint-Sépulchre;1652;38;1690
24;Centre-Val de Loire;36;2;04;142;Niherne;1583;31;1614
24;Centre-Val de Loire;36;3;08;143;Nohant-Vic;449;13;462
24;Centre-Val de Loire;36;1;12;144;Nuret-le-Ferron;295;7;302
24;Centre-Val de Loire;36;1;03;145;Obterre;177;3;180
24;Centre-Val de Loire;36;3;11;146;Orsennes;728;10;738
24;Centre-Val de Loire;36;4;13;147;Orville;138;3;141
24;Centre-Val de Loire;36;1;12;148;Oulches;410;3;413
24;Centre-Val de Loire;36;2;04;149;Palluau-sur-Indre;794;12;806
24;Centre-Val de Loire;36;1;12;150;Parnac;496;9;505
24;Centre-Val de Loire;36;4;10;152;Paudy;440;3;443
24;Centre-Val de Loire;36;1;03;153;Paulnay;339;8;347
24;Centre-Val de Loire;36;2;02;154;Le Pêchereau;1859;38;1897
24;Centre-Val de Loire;36;2;13;155;Pellevoisin;791;55;846
24;Centre-Val de Loire;36;3;08;156;Pérassay;366;2;368
24;Centre-Val de Loire;36;1;12;157;La Pérouille;451;13;464
24;Centre-Val de Loire;36;2;02;158;Badecon-le-Pin;765;9;774
24;Centre-Val de Loire;36;2;01;159;Le Poinçonnet;5820;174;5994
24;Centre-Val de Loire;36;2;02;160;Pommiers;214;5;219
24;Centre-Val de Loire;36;2;02;161;Le Pont-Chrétien-Chabenet;937;10;947
24;Centre-Val de Loire;36;4;13;162;Poulaines;826;19;845
24;Centre-Val de Loire;36;3;08;163;Pouligny-Notre-Dame;669;11;680
24;Centre-Val de Loire;36;3;08;164;Pouligny-Saint-Martin;225;3;228
24;Centre-Val de Loire;36;1;03;165;Pouligny-Saint-Pierre;1036;28;1064
24;Centre-Val de Loire;36;2;13;166;Préaux;166;4;170
24;Centre-Val de Loire;36;1;03;167;Preuilly-la-Ville;157;3;160
24;Centre-Val de Loire;36;1;12;168;Prissac;586;15;601
24;Centre-Val de Loire;36;4;08;169;Pruniers;511;10;521
24;Centre-Val de Loire;36;4;10;170;Reboursin;104;0;104
24;Centre-Val de Loire;36;4;10;171;Reuilly;2010;37;2047
24;Centre-Val de Loire;36;1;12;172;Rivarennes;528;10;538
24;Centre-Val de Loire;36;1;03;173;Rosnay;519;13;532
24;Centre-Val de Loire;36;1;12;174;Roussines;361;11;372
24;Centre-Val de Loire;36;2;10;175;Rouvres-les-Bois;276;2;278
24;Centre-Val de Loire;36;1;03;176;Ruffec;586;8;594
24;Centre-Val de Loire;36;1;12;177;Sacierges-Saint-Martin;325;6;331
24;Centre-Val de Loire;36;1;03;178;Saint-Aigny;277;12;289
24;Centre-Val de Loire;36;4;10;179;Saint-Aoustrille;232;0;232
24;Centre-Val de Loire;36;3;08;180;Saint-Août;825;18;843
24;Centre-Val de Loire;36;4;08;181;Saint-Aubin;167;3;170
24;Centre-Val de Loire;36;1;12;182;Saint-Benoît-du-Sault;576;17;593
24;Centre-Val de Loire;36;3;08;184;Saint-Chartier;495;8;503
24;Centre-Val de Loire;36;4;13;185;Saint-Christophe-en-Bazelle;362;3;365
24;Centre-Val de Loire;36;3;08;186;Saint-Christophe-en-Boucherie;256;3;259
24;Centre-Val de Loire;36;1;12;187;Saint-Civran;132;2;134
24;Centre-Val de Loire;36;2;04;188;Saint-Cyran-du-Jambot;182;150;332
24;Centre-Val de Loire;36;3;11;189;Saint-Denis-de-Jouhet;967;13;980
24;Centre-Val de Loire;36;4;01;190;Sainte-Fauste;270;1;271
24;Centre-Val de Loire;36;4;10;191;Saint-Florentin;532;7;539
24;Centre-Val de Loire;36;1;12;192;Saint-Gaultier;1772;23;1795
24;Centre-Val de Loire;36;1;03;193;Sainte-Gemme;256;8;264
24;Centre-Val de Loire;36;2;04;194;Saint-Genou;950;16;966
24;Centre-Val de Loire;36;4;09;195;Saint-Georges-sur-Arnon;571;14;585
24;Centre-Val de Loire;36;1;12;196;Saint-Gilles;100;3;103
24;Centre-Val de Loire;36;1;12;197;Saint-Hilaire-sur-Benaize;292;7;299
24;Centre-Val de Loire;36;2;04;198;Saint-Lactencin;406;14;420
24;Centre-Val de Loire;36;4;10;199;Sainte-Lizaigne;1145;24;1169
24;Centre-Val de Loire;36;2;02;200;Saint-Marcel;1506;24;1530
24;Centre-Val de Loire;36;2;89;202;Saint-Maur;3685;77;3762
24;Centre-Val de Loire;36;2;04;203;Saint-Médard;52;0;52
24;Centre-Val de Loire;36;1;03;204;Saint-Michel-en-Brenne;323;7;330
24;Centre-Val de Loire;36;4;10;205;Saint-Pierre-de-Jards;109;4;113
24;Centre-Val de Loire;36;3;11;207;Saint-Plantaire;611;13;624
24;Centre-Val de Loire;36;3;08;208;Sainte-Sévère-sur-Indre;774;14;788
24;Centre-Val de Loire;36;4;10;209;Saint-Valentin;268;13;281
24;Centre-Val de Loire;36;3;11;210;Sarzay;300;11;311
24;Centre-Val de Loire;36;2;01;211;Sassierges-Saint-Germain;457;8;465
24;Centre-Val de Loire;36;1;03;212;Saulnay;155;2;157
24;Centre-Val de Loire;36;1;03;213;Sauzelles;256;4;260
24;Centre-Val de Loire;36;3;08;214;Sazeray;300;10;310
24;Centre-Val de Loire;36;4;09;215;Ségry;496;13;509
24;Centre-Val de Loire;36;2;13;216;Selles-sur-Nahon;65;1;66
24;Centre-Val de Loire;36;4;13;217;Sembleçay;98;3;101
24;Centre-Val de Loire;36;2;04;218;Sougé;144;6;150
24;Centre-Val de Loire;36;2;02;219;Tendu;648;7;655
24;Centre-Val de Loire;36;1;12;220;Thenay;896;18;914
24;Centre-Val de Loire;36;3;08;221;Thevet-Saint-Julien;382;8;390
24;Centre-Val de Loire;36;4;08;222;Thizay;234;7;241
24;Centre-Val de Loire;36;1;12;223;Tilly;139;4;143
24;Centre-Val de Loire;36;1;03;224;Tournon-Saint-Martin;1132;25;1157
24;Centre-Val de Loire;36;2;04;225;Le Tranger;181;1;182
24;Centre-Val de Loire;36;3;11;226;Tranzault;353;1;354
24;Centre-Val de Loire;36;3;08;227;Urciers;248;2;250
24;Centre-Val de Loire;36;2;13;228;Valençay;2338;107;2445
24;Centre-Val de Loire;36;4;13;229;Val-Fouzon;957;10;967
24;Centre-Val de Loire;36;4;10;230;Vatan;1945;39;1984
24;Centre-Val de Loire;36;2;02;231;Velles;964;20;984
24;Centre-Val de Loire;36;2;12;232;Vendœuvres;1052;16;1068
24;Centre-Val de Loire;36;2;13;233;La Vernelle;741;8;749
24;Centre-Val de Loire;36;3;08;234;Verneuil-sur-Igneraie;326;6;332
24;Centre-Val de Loire;36;2;13;235;Veuil;376;8;384
24;Centre-Val de Loire;36;3;08;236;Vicq-Exemplet;317;5;322
24;Centre-Val de Loire;36;2;13;237;Vicq-sur-Nahon;716;19;735
24;Centre-Val de Loire;36;3;08;238;Vigoulant;99;3;102
24;Centre-Val de Loire;36;1;12;239;Vigoux;461;6;467
24;Centre-Val de Loire;36;3;08;240;Vijon;298;4;302
24;Centre-Val de Loire;36;2;04;241;Villedieu-sur-Indre;2687;47;2734
24;Centre-Val de Loire;36;2;10;242;Villegongis;107;1;108
24;Centre-Val de Loire;36;2;13;243;Villegouin;319;4;323
24;Centre-Val de Loire;36;2;13;244;Villentrois-Faverolles-en-Berry;873;6;879
24;Centre-Val de Loire;36;1;03;246;Villiers;168;2;170
24;Centre-Val de Loire;36;2;10;247;Vineuil;1228;22;1250
24;Centre-Val de Loire;36;4;01;248;Vouillon;231;3;234
24;Centre-Val de Loire;37;3;06;001;Abilly;1149;17;1166
24;Centre-Val de Loire;37;1;08;002;Ambillou;1757;29;1786
24;Centre-Val de Loire;37;3;01;003;Amboise;12533;379;12912
24;Centre-Val de Loire;37;1;13;004;Anché;423;11;434
24;Centre-Val de Loire;37;1;13;005;Antogny-le-Tillac;508;5;513
24;Centre-Val de Loire;37;2;11;006;Artannes-sur-Indre;2649;52;2701
24;Centre-Val de Loire;37;1;13;007;Assay;166;4;170
24;Centre-Val de Loire;37;3;03;008;Athée-sur-Cher;2716;39;2755
24;Centre-Val de Loire;37;3;04;009;Autrèche;439;4;443
24;Centre-Val de Loire;37;3;04;010;Auzouer-en-Touraine;2222;70;2292
24;Centre-Val de Loire;37;1;05;011;Avoine;1868;39;1907
24;Centre-Val de Loire;37;1;13;012;Avon-les-Roches;554;3;557
24;Centre-Val de Loire;37;1;08;013;Avrillé-les-Ponceaux;468;10;478
24;Centre-Val de Loire;37;2;05;014;Azay-le-Rideau;3501;99;3600
24;Centre-Val de Loire;37;2;03;015;Azay-sur-Cher;3099;68;3167
24;Centre-Val de Loire;37;3;09;016;Azay-sur-Indre;367;14;381
24;Centre-Val de Loire;37;2;02;018;Ballan-Miré;8102;140;8242
24;Centre-Val de Loire;37;3;06;019;Barrou;455;10;465
24;Centre-Val de Loire;37;3;09;020;Beaulieu-lès-Loches;1761;33;1794
24;Centre-Val de Loire;37;1;04;021;Beaumont-Louestault;1719;19;1738
24;Centre-Val de Loire;37;1;05;022;Beaumont-en-Véron;2689;90;2779
24;Centre-Val de Loire;37;3;09;023;Beaumont-Village;242;5;247
24;Centre-Val de Loire;37;1;08;024;Benais;906;27;933
24;Centre-Val de Loire;37;2;02;025;Berthenay;692;6;698
24;Centre-Val de Loire;37;3;06;026;Betz-le-Château;536;4;540
24;Centre-Val de Loire;37;3;03;027;Bléré;5257;65;5322
24;Centre-Val de Loire;37;3;06;028;Bossay-sur-Claise;744;23;767
24;Centre-Val de Loire;37;3;06;029;Bossée;328;5;333
24;Centre-Val de Loire;37;3;04;030;Le Boulay;795;7;802
24;Centre-Val de Loire;37;1;08;031;Bourgueil;3894;77;3971
24;Centre-Val de Loire;37;3;06;032;Bournan;271;7;278
24;Centre-Val de Loire;37;3;06;033;Boussay;210;5;215
24;Centre-Val de Loire;37;1;13;034;Braslou;301;7;308
24;Centre-Val de Loire;37;1;13;035;Braye-sous-Faye;291;6;297
24;Centre-Val de Loire;37;1;08;036;Braye-sur-Maulne;189;1;190
24;Centre-Val de Loire;37;1;08;037;Brèches;215;5;220
24;Centre-Val de Loire;37;2;05;038;Bréhémont;750;8;758
24;Centre-Val de Loire;37;3;09;039;Bridoré;494;13;507
24;Centre-Val de Loire;37;1;13;040;Brizay;262;9;271
24;Centre-Val de Loire;37;1;04;041;Bueil-en-Touraine;323;5;328
24;Centre-Val de Loire;37;1;05;042;Candes-Saint-Martin;185;3;188
24;Centre-Val de Loire;37;3;01;043;Cangey;1051;24;1075
24;Centre-Val de Loire;37;3;06;044;La Celle-Guenand;369;5;374
24;Centre-Val de Loire;37;3;06;045;La Celle-Saint-Avant;1059;15;1074
24;Centre-Val de Loire;37;3;03;046;Céré-la-Ronde;437;8;445
24;Centre-Val de Loire;37;1;04;047;Cerelles;1215;26;1241
24;Centre-Val de Loire;37;3;06;048;Chambon;321;5;326
24;Centre-Val de Loire;37;3;09;049;Chambourg-sur-Indre;1250;25;1275
24;Centre-Val de Loire;37;2;10;050;Chambray-lès-Tours;11880;262;12142
24;Centre-Val de Loire;37;1;13;051;Champigny-sur-Veude;829;8;837
24;Centre-Val de Loire;37;2;19;052;Chançay;1135;18;1153
24;Centre-Val de Loire;37;3;09;053;Chanceaux-près-Loches;119;7;126
24;Centre-Val de Loire;37;2;19;054;Chanceaux-sur-Choisille;3525;47;3572
24;Centre-Val de Loire;37;1;08;055;Channay-sur-Lathan;816;16;832
24;Centre-Val de Loire;37;2;05;056;La Chapelle-aux-Naux;569;10;579
24;Centre-Val de Loire;37;3;06;057;La Chapelle-Blanche-Saint-Martin;681;14;695
24;Centre-Val de Loire;37;1;08;058;La Chapelle-sur-Loire;1446;26;1472
24;Centre-Val de Loire;37;1;04;059;Charentilly;1306;31;1337
24;Centre-Val de Loire;37;3;01;060;Chargé;1311;20;1331
24;Centre-Val de Loire;37;3;06;061;Charnizay;501;16;517
24;Centre-Val de Loire;37;1;08;062;Château-la-Vallière;1736;18;1754
24;Centre-Val de Loire;37;3;04;063;Château-Renault;4917;78;4995
24;Centre-Val de Loire;37;3;06;064;Chaumussay;226;7;233
24;Centre-Val de Loire;37;1;13;065;Chaveignes;549;5;554
24;Centre-Val de Loire;37;3;09;066;Chédigny;560;5;565
24;Centre-Val de Loire;37;2;05;067;Cheillé;1816;21;1837
24;Centre-Val de Loire;37;1;04;068;Chemillé-sur-Dême;729;10;739
24;Centre-Val de Loire;37;3;09;069;Chemillé-sur-Indrois;230;8;238
24;Centre-Val de Loire;37;3;03;070;Chenonceaux;351;5;356
24;Centre-Val de Loire;37;1;13;071;Chezelles;132;2;134
24;Centre-Val de Loire;37;1;05;072;Chinon;8104;318;8422
24;Centre-Val de Loire;37;3;03;073;Chisseaux;583;14;597
24;Centre-Val de Loire;37;1;08;074;Chouzé-sur-Loire;2085;24;2109
24;Centre-Val de Loire;37;3;03;075;Cigogné;461;5;466
24;Centre-Val de Loire;37;1;05;076;Cinais;398;10;408
24;Centre-Val de Loire;37;1;08;077;Cinq-Mars-la-Pile;3729;51;3780
24;Centre-Val de Loire;37;3;06;078;Ciran;412;8;420
24;Centre-Val de Loire;37;3;03;079;Civray-de-Touraine;1791;57;1848
24;Centre-Val de Loire;37;3;06;080;Civray-sur-Esves;203;4;207
24;Centre-Val de Loire;37;1;08;081;Cléré-les-Pins;1401;20;1421
24;Centre-Val de Loire;37;1;08;082;Continvoir;447;4;451
24;Centre-Val de Loire;37;3;03;083;Cormery;1800;26;1826
24;Centre-Val de Loire;37;1;08;084;Couesmes;538;6;544
24;Centre-Val de Loire;37;3;03;085;Courçay;801;23;824
24;Centre-Val de Loire;37;1;08;086;Courcelles-de-Touraine;498;8;506
24;Centre-Val de Loire;37;1;13;087;Courcoué;247;9;256
24;Centre-Val de Loire;37;1;05;088;Couziers;110;1;111
24;Centre-Val de Loire;37;1;13;089;Cravant-les-Côteaux;655;18;673
24;Centre-Val de Loire;37;1;13;090;Crissay-sur-Manse;109;2;111
24;Centre-Val de Loire;37;3;03;091;La Croix-en-Touraine;2379;59;2438
24;Centre-Val de Loire;37;3;04;092;Crotelles;665;14;679
24;Centre-Val de Loire;37;1;13;093;Crouzilles;535;6;541
24;Centre-Val de Loire;37;3;06;094;Cussay;561;16;577
24;Centre-Val de Loire;37;3;04;095;Dame-Marie-les-Bois;347;7;354
24;Centre-Val de Loire;37;3;03;096;Dierre;619;10;629
24;Centre-Val de Loire;37;3;09;097;Dolus-le-Sec;673;23;696
24;Centre-Val de Loire;37;3;06;098;Draché;751;19;770
24;Centre-Val de Loire;37;2;02;099;Druye;964;12;976
24;Centre-Val de Loire;37;3;03;100;Épeigné-les-Bois;406;4;410
24;Centre-Val de Loire;37;1;04;101;Épeigné-sur-Dême;155;2;157
24;Centre-Val de Loire;37;3;06;103;Esves-le-Moutier;144;2;146
24;Centre-Val de Loire;37;2;11;104;Esvres;6109;111;6220
24;Centre-Val de Loire;37;1;13;105;Faye-la-Vineuse;253;6;259
24;Centre-Val de Loire;37;3;04;106;La Ferrière;320;4;324
24;Centre-Val de Loire;37;3;06;107;Ferrière-Larçon;238;5;243
24;Centre-Val de Loire;37;3;09;108;Ferrière-sur-Beaulieu;716;14;730
24;Centre-Val de Loire;37;2;12;109;Fondettes;10301;523;10824
24;Centre-Val de Loire;37;3;03;110;Francueil;1383;35;1418
24;Centre-Val de Loire;37;3;09;111;Genillé;1505;32;1537
24;Centre-Val de Loire;37;1;08;112;Gizeux;378;7;385
24;Centre-Val de Loire;37;3;06;113;Le Grand-Pressigny;875;19;894
24;Centre-Val de Loire;37;3;06;114;La Guerche;174;1;175
24;Centre-Val de Loire;37;3;06;115;Descartes;3366;61;3427
24;Centre-Val de Loire;37;3;04;116;Les Hermites;557;16;573
24;Centre-Val de Loire;37;1;08;117;Hommes;875;10;885
24;Centre-Val de Loire;37;1;05;118;Huismes;1425;35;1460
24;Centre-Val de Loire;37;1;13;119;L'Île-Bouchard;1527;38;1565
24;Centre-Val de Loire;37;1;13;121;Jaulnay;253;4;257
24;Centre-Val de Loire;37;2;07;122;Joué-lès-Tours;38444;412;38856
24;Centre-Val de Loire;37;1;08;123;Langeais;4455;63;4518
24;Centre-Val de Loire;37;2;10;124;Larçay;2500;40;2540
24;Centre-Val de Loire;37;1;13;125;Lémeré;531;2;533
24;Centre-Val de Loire;37;1;05;126;Lerné;325;8;333
24;Centre-Val de Loire;37;3;09;127;Le Liège;339;8;347
24;Centre-Val de Loire;37;2;05;128;Lignières-de-Touraine;1296;23;1319
24;Centre-Val de Loire;37;1;13;129;Ligré;1058;21;1079
24;Centre-Val de Loire;37;3;06;130;Ligueil;2130;33;2163
24;Centre-Val de Loire;37;3;01;131;Limeray;1278;22;1300
24;Centre-Val de Loire;37;3;09;132;Loches;6199;536;6735
24;Centre-Val de Loire;37;3;09;133;Loché-sur-Indrois;474;10;484
24;Centre-Val de Loire;37;3;06;134;Louans;677;14;691
24;Centre-Val de Loire;37;3;06;136;Le Louroux;527;3;530
24;Centre-Val de Loire;37;1;08;137;Lublé;140;3;143
24;Centre-Val de Loire;37;3;01;138;Lussault-sur-Loire;842;16;858
24;Centre-Val de Loire;37;2;12;139;Luynes;5101;143;5244
24;Centre-Val de Loire;37;1;13;140;Luzé;239;5;244
24;Centre-Val de Loire;37;3;03;141;Luzillé;966;18;984
24;Centre-Val de Loire;37;1;13;142;Maillé;568;4;572
24;Centre-Val de Loire;37;3;06;143;Manthelan;1348;28;1376
24;Centre-Val de Loire;37;1;05;144;Marçay;529;6;535
24;Centre-Val de Loire;37;3;06;145;Marcé-sur-Esves;240;1;241
24;Centre-Val de Loire;37;1;08;146;Marcilly-sur-Maulne;219;3;222
24;Centre-Val de Loire;37;1;13;147;Marcilly-sur-Vienne;562;10;572
24;Centre-Val de Loire;37;1;13;148;Marigny-Marmande;603;6;609
24;Centre-Val de Loire;37;1;04;149;Marray;483;7;490
24;Centre-Val de Loire;37;1;08;150;Mazières-de-Touraine;1390;13;1403
24;Centre-Val de Loire;37;2;12;151;La Membrolle-sur-Choisille;3300;62;3362
24;Centre-Val de Loire;37;2;19;152;Mettray;2068;66;2134
24;Centre-Val de Loire;37;2;19;153;Monnaie;4643;54;4697
24;Centre-Val de Loire;37;2;11;154;Montbazon;4542;91;4633
24;Centre-Val de Loire;37;3;04;155;Monthodon;641;8;649
24;Centre-Val de Loire;37;2;10;156;Montlouis-sur-Loire;10868;149;11017
24;Centre-Val de Loire;37;3;09;157;Montrésor;322;4;326
24;Centre-Val de Loire;37;3;01;158;Montreuil-en-Touraine;776;11;787
24;Centre-Val de Loire;37;2;11;159;Monts;7876;143;8019
24;Centre-Val de Loire;37;3;04;160;Morand;343;6;349
24;Centre-Val de Loire;37;3;01;161;Mosnes;806;13;819
24;Centre-Val de Loire;37;3;06;162;Mouzay;468;17;485
24;Centre-Val de Loire;37;3;01;163;Nazelles-Négron;3508;56;3564
24;Centre-Val de Loire;37;1;13;165;Neuil;439;5;444
24;Centre-Val de Loire;37;3;01;166;Neuillé-le-Lierre;794;7;801
24;Centre-Val de Loire;37;1;04;167;Neuillé-Pont-Pierre;2098;37;2135
24;Centre-Val de Loire;37;3;06;168;Neuilly-le-Brignon;289;9;298
24;Centre-Val de Loire;37;3;04;169;Neuville-sur-Brenne;920;28;948
24;Centre-Val de Loire;37;1;04;170;Neuvy-le-Roi;1081;63;1144
24;Centre-Val de Loire;37;3;01;171;Noizay;1134;19;1153
24;Centre-Val de Loire;37;2;19;172;Notre-Dame-d'Oé;4234;83;4317
24;Centre-Val de Loire;37;3;09;173;Nouans-les-Fontaines;737;9;746
24;Centre-Val de Loire;37;1;13;174;Nouâtre;812;16;828
24;Centre-Val de Loire;37;3;04;175;Nouzilly;1244;31;1275
24;Centre-Val de Loire;37;1;13;176;Noyant-de-Touraine;1183;49;1232
24;Centre-Val de Loire;37;3;09;177;Orbigny;715;16;731
24;Centre-Val de Loire;37;1;13;178;Panzoult;611;4;615
24;Centre-Val de Loire;37;2;19;179;Parçay-Meslay;2474;32;2506
24;Centre-Val de Loire;37;1;13;180;Parçay-sur-Vienne;636;6;642
24;Centre-Val de Loire;37;3;06;181;Paulmy;234;10;244
24;Centre-Val de Loire;37;1;04;182;Pernay;1409;15;1424
24;Centre-Val de Loire;37;3;09;183;Perrusson;1464;27;1491
24;Centre-Val de Loire;37;3;06;184;Le Petit-Pressigny;338;7;345
24;Centre-Val de Loire;37;3;01;185;Pocé-sur-Cisse;1675;73;1748
24;Centre-Val de Loire;37;2;11;186;Pont-de-Ruan;1212;13;1225
24;Centre-Val de Loire;37;1;13;187;Ports-sur-Vienne;360;7;367
24;Centre-Val de Loire;37;1;13;188;Pouzay;896;6;902
24;Centre-Val de Loire;37;3;06;189;Preuilly-sur-Claise;1004;21;1025
24;Centre-Val de Loire;37;1;13;190;Pussigny;166;3;169
24;Centre-Val de Loire;37;1;13;191;Razines;231;6;237
24;Centre-Val de Loire;37;3;09;192;Reignac-sur-Indre;1278;18;1296
24;Centre-Val de Loire;37;1;08;193;Restigné;1149;26;1175
24;Centre-Val de Loire;37;2;19;194;Reugny;1751;33;1784
24;Centre-Val de Loire;37;2;02;195;La Riche;10317;80;10397
24;Centre-Val de Loire;37;1;13;196;Richelieu;1664;18;1682
24;Centre-Val de Loire;37;2;05;197;Rigny-Ussé;511;13;524
24;Centre-Val de Loire;37;1;08;198;Rillé;312;2;314
24;Centre-Val de Loire;37;1;13;199;Rilly-sur-Vienne;471;9;480
24;Centre-Val de Loire;37;2;05;200;Rivarennes;987;14;1001
24;Centre-Val de Loire;37;1;05;201;Rivière;703;20;723
24;Centre-Val de Loire;37;1;05;202;La Roche-Clermault;527;11;538
24;Centre-Val de Loire;37;2;19;203;Rochecorbon;3145;90;3235
24;Centre-Val de Loire;37;1;04;204;Rouziers-de-Touraine;1345;23;1368
24;Centre-Val de Loire;37;2;05;205;Saché;1403;16;1419
24;Centre-Val de Loire;37;1;04;206;Saint-Antoine-du-Rocher;1715;36;1751
24;Centre-Val de Loire;37;1;04;207;Saint-Aubin-le-Dépeint;338;2;340
24;Centre-Val de Loire;37;2;14;208;Saint-Avertin;14995;297;15292
24;Centre-Val de Loire;37;1;05;210;Saint-Benoît-la-Forêt;849;17;866
24;Centre-Val de Loire;37;2;11;211;Saint-Branchs;2625;32;2657
24;Centre-Val de Loire;37;2;13;212;Sainte-Catherine-de-Fierbois;774;11;785
24;Centre-Val de Loire;37;1;04;213;Saint-Christophe-sur-le-Nais;1105;24;1129
24;Centre-Val de Loire;37;2;12;214;Saint-Cyr-sur-Loire;16419;415;16834
24;Centre-Val de Loire;37;1;13;216;Saint-Épain;1575;28;1603
24;Centre-Val de Loire;37;2;12;217;Saint-Étienne-de-Chigny;1653;20;1673
24;Centre-Val de Loire;37;3;06;218;Saint-Flovier;571;12;583
24;Centre-Val de Loire;37;2;02;219;Saint-Genouph;1039;17;1056
24;Centre-Val de Loire;37;1;05;220;Saint-Germain-sur-Vienne;364;4;368
24;Centre-Val de Loire;37;3;09;221;Saint-Hippolyte;623;8;631
24;Centre-Val de Loire;37;3;09;222;Saint-Jean-Saint-Germain;761;29;790
24;Centre-Val de Loire;37;1;08;223;Saint-Laurent-de-Lin;319;2;321
24;Centre-Val de Loire;37;3;04;224;Saint-Laurent-en-Gâtines;943;15;958
24;Centre-Val de Loire;37;3;03;225;Saint-Martin-le-Beau;3181;57;3238
24;Centre-Val de Loire;37;1;13;226;Sainte-Maure-de-Touraine;4150;52;4202
24;Centre-Val de Loire;37;1;08;228;Saint-Nicolas-de-Bourgueil;1095;14;1109
24;Centre-Val de Loire;37;3;04;229;Saint-Nicolas-des-Motets;247;8;255
24;Centre-Val de Loire;37;3;01;230;Saint-Ouen-les-Vignes;993;19;1012
24;Centre-Val de Loire;37;1;04;231;Saint-Paterne-Racan;1647;25;1672
24;Centre-Val de Loire;37;1;08;232;Coteaux-sur-Loire;1900;39;1939
24;Centre-Val de Loire;37;2;14;233;Saint-Pierre-des-Corps;15967;250;16217
24;Centre-Val de Loire;37;3;09;234;Saint-Quentin-sur-Indrois;497;15;512
24;Centre-Val de Loire;37;3;01;236;Saint-Règle;608;11;619
24;Centre-Val de Loire;37;1;04;237;Saint-Roch;1254;18;1272
24;Centre-Val de Loire;37;3;09;238;Saint-Senoch;541;8;549
24;Centre-Val de Loire;37;3;04;240;Saunay;709;15;724
24;Centre-Val de Loire;37;1;08;241;Savigné-sur-Lathan;1342;22;1364
24;Centre-Val de Loire;37;1;05;242;Savigny-en-Véron;1563;32;1595
24;Centre-Val de Loire;37;2;02;243;Savonnières;3234;76;3310
24;Centre-Val de Loire;37;1;13;244;Sazilly;250;4;254
24;Centre-Val de Loire;37;1;04;245;Semblançay;2173;45;2218
24;Centre-Val de Loire;37;3;09;246;Sennevières;207;4;211
24;Centre-Val de Loire;37;3;06;247;Sepmes;617;10;627
24;Centre-Val de Loire;37;1;05;248;Seuilly;375;21;396
24;Centre-Val de Loire;37;1;04;249;Sonzay;1399;20;1419
24;Centre-Val de Loire;37;2;11;250;Sorigny;2752;76;2828
24;Centre-Val de Loire;37;1;08;251;Souvigné;874;11;885
24;Centre-Val de Loire;37;3;01;252;Souvigny-de-Touraine;393;6;399
24;Centre-Val de Loire;37;3;03;253;Sublaines;182;6;188
24;Centre-Val de Loire;37;3;09;254;Tauxigny-Saint-Bauld;1722;29;1751
24;Centre-Val de Loire;37;1;13;255;Tavant;264;1;265
24;Centre-Val de Loire;37;1;13;256;Theneuil;293;3;296
24;Centre-Val de Loire;37;2;05;257;Thilouze;1769;23;1792
24;Centre-Val de Loire;37;1;05;258;Thizay;288;3;291
24;Centre-Val de Loire;37;3;06;259;Tournon-Saint-Pierre;460;10;470
24;Centre-Val de Loire;37;1;13;260;La Tour-Saint-Gelin;520;8;528
24;Centre-Val de Loire;37;2;99;261;Tours;137087;2756;139843
24;Centre-Val de Loire;37;1;13;262;Trogues;296;4;300
24;Centre-Val de Loire;37;2;11;263;Truyes;2452;40;2492
24;Centre-Val de Loire;37;2;05;264;Vallères;1299;20;1319
24;Centre-Val de Loire;37;3;06;265;Varennes;240;5;245
24;Centre-Val de Loire;37;2;11;266;Veigné;6423;118;6541
24;Centre-Val de Loire;37;2;10;267;Véretz;4570;80;4650
24;Centre-Val de Loire;37;1;13;268;Verneuil-le-Château;128;0;128
24;Centre-Val de Loire;37;3;09;269;Verneuil-sur-Indre;474;11;485
24;Centre-Val de Loire;37;2;19;270;Vernou-sur-Brenne;2713;41;2754
24;Centre-Val de Loire;37;2;05;271;Villaines-les-Rochers;1048;9;1057
24;Centre-Val de Loire;37;2;02;272;Villandry;1133;37;1170
24;Centre-Val de Loire;37;2;10;273;La Ville-aux-Dames;5585;71;5656
24;Centre-Val de Loire;37;1;04;274;Villebourg;301;3;304
24;Centre-Val de Loire;37;3;09;275;Villedômain;119;2;121
24;Centre-Val de Loire;37;3;04;276;Villedômer;1329;31;1360
24;Centre-Val de Loire;37;3;09;277;Villeloin-Coulangé;588;3;591
24;Centre-Val de Loire;37;2;11;278;Villeperdue;1074;7;1081
24;Centre-Val de Loire;37;1;08;279;Villiers-au-Bouin;754;7;761
24;Centre-Val de Loire;37;3;06;280;Vou;225;6;231
24;Centre-Val de Loire;37;2;19;281;Vouvray;3254;70;3324
24;Centre-Val de Loire;37;3;06;282;Yzeures-sur-Creuse;1354;27;1381
84;Auvergne-Rhône-Alpes;38;2;03;001;Les Abrets en Dauphiné;6389;106;6495
84;Auvergne-Rhône-Alpes;38;1;13;002;Les Adrets;1044;29;1073
84;Auvergne-Rhône-Alpes;38;3;21;003;Agnin;1149;22;1171
84;Auvergne-Rhône-Alpes;38;1;23;004;L'Albenc;1279;25;1304
84;Auvergne-Rhône-Alpes;38;1;19;005;Allemond;946;18;964
84;Auvergne-Rhône-Alpes;38;1;13;006;Allevard;4023;106;4129
84;Auvergne-Rhône-Alpes;38;1;15;008;Ambel;27;0;27
84;Auvergne-Rhône-Alpes;38;3;21;009;Anjou;1045;24;1069
84;Auvergne-Rhône-Alpes;38;2;04;010;Annoisin-Chatelans;696;18;714
84;Auvergne-Rhône-Alpes;38;2;04;011;Anthon;1077;13;1090
84;Auvergne-Rhône-Alpes;38;2;03;012;Aoste;2882;54;2936
84;Auvergne-Rhône-Alpes;38;2;08;013;Apprieu;3380;91;3471
84;Auvergne-Rhône-Alpes;38;3;26;015;Artas;1824;38;1862
84;Auvergne-Rhône-Alpes;38;3;28;017;Assieu;1586;36;1622
84;Auvergne-Rhône-Alpes;38;1;23;018;Auberives-en-Royans;363;10;373
84;Auvergne-Rhône-Alpes;38;3;28;019;Auberives-sur-Varèze;1480;29;1509
84;Auvergne-Rhône-Alpes;38;1;19;020;Auris;183;4;187
84;Auvergne-Rhône-Alpes;38;2;17;022;Les Avenières Veyrins-Thuellin;7804;159;7963
84;Auvergne-Rhône-Alpes;38;1;15;023;Avignonet;198;5;203
84;Auvergne-Rhône-Alpes;38;2;17;026;La Balme-les-Grottes;1100;12;1112
84;Auvergne-Rhône-Alpes;38;1;13;027;Barraux;1950;57;2007
84;Auvergne-Rhône-Alpes;38;2;24;029;La Bâtie-Montgascon;1941;41;1982
84;Auvergne-Rhône-Alpes;38;1;25;030;Beaucroissant;1740;30;1770
84;Auvergne-Rhône-Alpes;38;1;15;031;Beaufin;21;0;21
84;Auvergne-Rhône-Alpes;38;3;01;032;Beaufort;561;11;572
84;Auvergne-Rhône-Alpes;38;1;23;033;Beaulieu;635;18;653
84;Auvergne-Rhône-Alpes;38;3;21;034;Beaurepaire;4977;83;5060
84;Auvergne-Rhône-Alpes;38;3;01;035;Beauvoir-de-Marc;1114;15;1129
84;Auvergne-Rhône-Alpes;38;1;23;036;Beauvoir-en-Royans;95;2;97
84;Auvergne-Rhône-Alpes;38;3;21;037;Bellegarde-Poussieu;991;14;1005
84;Auvergne-Rhône-Alpes;38;2;08;038;Belmont;599;14;613
84;Auvergne-Rhône-Alpes;38;1;18;039;Bernin;3025;104;3129
84;Auvergne-Rhône-Alpes;38;1;19;040;Besse;141;1;142
84;Auvergne-Rhône-Alpes;38;1;23;041;Bessins;107;3;110
84;Auvergne-Rhône-Alpes;38;2;08;042;Bévenais;1023;21;1044
84;Auvergne-Rhône-Alpes;38;2;08;043;Bilieu;1575;43;1618
84;Auvergne-Rhône-Alpes;38;2;08;044;Biol;1454;41;1495
84;Auvergne-Rhône-Alpes;38;1;16;045;Biviers;2331;92;2423
84;Auvergne-Rhône-Alpes;38;2;08;046;Bizonnes;991;15;1006
84;Auvergne-Rhône-Alpes;38;2;08;047;Blandin;149;3;152
84;Auvergne-Rhône-Alpes;38;2;26;048;Bonnefamille;1073;18;1091
84;Auvergne-Rhône-Alpes;38;3;01;049;Bossieu;302;7;309
84;Auvergne-Rhône-Alpes;38;2;17;050;Le Bouchage;629;9;638
84;Auvergne-Rhône-Alpes;38;3;21;051;Bougé-Chambalud;1351;21;1372
84;Auvergne-Rhône-Alpes;38;1;19;052;Le Bourg-d'Oisans;3286;103;3389
84;Auvergne-Rhône-Alpes;38;2;02;053;Bourgoin-Jallieu;28834;609;29443
84;Auvergne-Rhône-Alpes;38;2;17;054;Bouvesse-Quirieu;1542;21;1563
84;Auvergne-Rhône-Alpes;38;2;17;055;Brangues;632;8;640
84;Auvergne-Rhône-Alpes;38;3;01;056;Bressieux;93;2;95
84;Auvergne-Rhône-Alpes;38;1;05;057;Bresson;671;12;683
84;Auvergne-Rhône-Alpes;38;3;01;058;Brézins;2186;37;2223
84;Auvergne-Rhône-Alpes;38;1;20;059;Brié-et-Angonnes;2545;42;2587
84;Auvergne-Rhône-Alpes;38;3;01;060;Brion;141;5;146
84;Auvergne-Rhône-Alpes;38;1;29;061;La Buisse;3235;70;3305
84;Auvergne-Rhône-Alpes;38;1;13;062;La Buissière;732;12;744
84;Auvergne-Rhône-Alpes;38;2;08;063;Burcin;441;14;455
84;Auvergne-Rhône-Alpes;38;2;24;064;Cessieu;3113;70;3183
84;Auvergne-Rhône-Alpes;38;2;08;065;Châbons;2119;50;2169
84;Auvergne-Rhône-Alpes;38;3;21;066;Chalon;175;4;179
84;Auvergne-Rhône-Alpes;38;2;26;067;Chamagnieu;1697;38;1735
84;Auvergne-Rhône-Alpes;38;1;20;068;Champagnier;1200;30;1230
84;Auvergne-Rhône-Alpes;38;3;01;069;Champier;1436;23;1459
84;Auvergne-Rhône-Alpes;38;1;13;070;Le Champ-près-Froges;1211;14;1225
84;Auvergne-Rhône-Alpes;38;1;20;071;Champ-sur-Drac;3172;32;3204
84;Auvergne-Rhône-Alpes;38;3;21;072;Chanas;2726;42;2768
84;Auvergne-Rhône-Alpes;38;1;15;073;Chantepérier;195;3;198
84;Auvergne-Rhône-Alpes;38;1;23;074;Chantesse;360;6;366
84;Auvergne-Rhône-Alpes;38;1;13;075;Chapareillan;2986;107;3093
84;Auvergne-Rhône-Alpes;38;2;24;076;La Chapelle-de-la-Tour;1886;67;1953
84;Auvergne-Rhône-Alpes;38;3;21;077;La Chapelle-de-Surieu;757;16;773
84;Auvergne-Rhône-Alpes;38;1;13;078;La Chapelle-du-Bard;584;6;590
84;Auvergne-Rhône-Alpes;38;2;03;080;Charancieu;767;20;787
84;Auvergne-Rhône-Alpes;38;3;26;081;Charantonnay;1969;45;2014
84;Auvergne-Rhône-Alpes;38;2;08;082;Charavines;1918;46;1964
84;Auvergne-Rhône-Alpes;38;2;17;083;Charette;450;15;465
84;Auvergne-Rhône-Alpes;38;1;25;084;Charnècles;1407;26;1433
84;Auvergne-Rhône-Alpes;38;2;04;085;Charvieu-Chavagneux;10102;84;10186
84;Auvergne-Rhône-Alpes;38;1;23;086;Chasselay;402;8;410
84;Auvergne-Rhône-Alpes;38;3;27;087;Chasse-sur-Rhône;6308;57;6365
84;Auvergne-Rhône-Alpes;38;2;08;089;Chassignieu;225;5;230
84;Auvergne-Rhône-Alpes;38;1;15;090;Château-Bernard;268;5;273
84;Auvergne-Rhône-Alpes;38;2;02;091;Châteauvilain;753;13;766
84;Auvergne-Rhône-Alpes;38;1;23;092;Châtelus;91;3;94
84;Auvergne-Rhône-Alpes;38;3;01;093;Châtenay;439;7;446
84;Auvergne-Rhône-Alpes;38;3;01;094;Châtonnay;2020;42;2062
84;Auvergne-Rhône-Alpes;38;1;23;095;Chatte;2480;159;2639
84;Auvergne-Rhône-Alpes;38;2;04;097;Chavanoz;4869;64;4933
84;Auvergne-Rhône-Alpes;38;2;08;098;Chélieu;712;18;730
84;Auvergne-Rhône-Alpes;38;1;23;099;Chevrières;726;23;749
84;Auvergne-Rhône-Alpes;38;1;13;100;Le Cheylas;2528;43;2571
84;Auvergne-Rhône-Alpes;38;3;28;101;Cheyssieu;1028;16;1044
84;Auvergne-Rhône-Alpes;38;2;14;102;Chèzeneuve;626;21;647
84;Auvergne-Rhône-Alpes;38;1;15;103;Chichilianne;306;2;308
84;Auvergne-Rhône-Alpes;38;2;03;104;Chimilin;1411;32;1443
84;Auvergne-Rhône-Alpes;38;1;08;105;Chirens;2369;45;2414
84;Auvergne-Rhône-Alpes;38;1;15;106;Cholonge;346;9;355
84;Auvergne-Rhône-Alpes;38;3;28;107;Chonas-l'Amballan;1679;51;1730
84;Auvergne-Rhône-Alpes;38;1;23;108;Choranche;120;0;120
84;Auvergne-Rhône-Alpes;38;2;04;109;Chozeau;1051;27;1078
84;Auvergne-Rhône-Alpes;38;3;27;110;Chuzelles;2260;44;2304
84;Auvergne-Rhône-Alpes;38;1;06;111;Claix;7924;216;8140
84;Auvergne-Rhône-Alpes;38;1;19;112;Clavans-en-Haut-Oisans;100;1;101
84;Auvergne-Rhône-Alpes;38;1;15;113;Clelles;536;6;542
84;Auvergne-Rhône-Alpes;38;3;28;114;Clonas-sur-Varèze;1450;33;1483
84;Auvergne-Rhône-Alpes;38;1;15;115;Saint-Martin-de-la-Cluze;730;19;749
84;Auvergne-Rhône-Alpes;38;1;15;116;Cognet;40;0;40
84;Auvergne-Rhône-Alpes;38;1;23;117;Cognin-les-Gorges;630;14;644
84;Auvergne-Rhône-Alpes;38;2;08;118;Colombe;1625;44;1669
84;Auvergne-Rhône-Alpes;38;1;18;120;La Combe-de-Lancey;709;17;726
84;Auvergne-Rhône-Alpes;38;2;17;124;Corbelin;2238;47;2285
84;Auvergne-Rhône-Alpes;38;1;16;126;Corenc;4075;130;4205
84;Auvergne-Rhône-Alpes;38;1;15;127;Cornillon-en-Trièves;163;5;168
84;Auvergne-Rhône-Alpes;38;1;15;128;Corps;450;5;455
84;Auvergne-Rhône-Alpes;38;1;07;129;Corrençon-en-Vercors;360;17;377
84;Auvergne-Rhône-Alpes;38;3;01;130;La Côte-Saint-André;4829;277;5106
84;Auvergne-Rhône-Alpes;38;3;28;131;Les Côtes-d'Arey;2024;75;2099
84;Auvergne-Rhône-Alpes;38;1;15;132;Les Côtes-de-Corps;73;0;73
84;Auvergne-Rhône-Alpes;38;1;29;133;Coublevie;5216;400;5616
84;Auvergne-Rhône-Alpes;38;3;21;134;Cour-et-Buis;920;19;939
84;Auvergne-Rhône-Alpes;38;2;17;135;Courtenay;1282;21;1303
84;Auvergne-Rhône-Alpes;38;2;14;136;Crachier;530;16;546
84;Auvergne-Rhône-Alpes;38;1;23;137;Cras;432;13;445
84;Auvergne-Rhône-Alpes;38;2;04;138;Crémieu;3375;64;3439
84;Auvergne-Rhône-Alpes;38;2;17;139;Creys-Mépieu;1503;19;1522
84;Auvergne-Rhône-Alpes;38;1;18;140;Crolles;8293;256;8549
84;Auvergne-Rhône-Alpes;38;3;14;141;Culin;758;15;773
84;Auvergne-Rhône-Alpes;38;3;26;144;Diémoz;2799;37;2836
84;Auvergne-Rhône-Alpes;38;2;04;146;Dizimieu;827;26;853
84;Auvergne-Rhône-Alpes;38;2;08;147;Doissin;885;25;910
84;Auvergne-Rhône-Alpes;38;2;24;148;Dolomieu;3192;71;3263
84;Auvergne-Rhône-Alpes;38;2;02;149;Domarin;1675;36;1711
84;Auvergne-Rhône-Alpes;38;1;16;150;Domène;6677;70;6747
84;Auvergne-Rhône-Alpes;38;1;05;151;Échirolles;36932;212;37144
84;Auvergne-Rhône-Alpes;38;2;02;152;Eclose-Badinières;1441;29;1470
84;Auvergne-Rhône-Alpes;38;1;07;153;Engins;449;20;469
84;Auvergne-Rhône-Alpes;38;1;15;154;Entraigues;221;2;223
84;Auvergne-Rhône-Alpes;38;1;03;155;Entre-deux-Guiers;1871;30;1901
84;Auvergne-Rhône-Alpes;38;2;02;156;Les Éparres;972;32;1004
84;Auvergne-Rhône-Alpes;38;3;28;157;Estrablin;3535;73;3608
84;Auvergne-Rhône-Alpes;38;1;05;158;Eybens;9980;119;10099
84;Auvergne-Rhône-Alpes;38;2;08;159;Eydoche;539;13;552
84;Auvergne-Rhône-Alpes;38;3;28;160;Eyzin-Pinet;2303;115;2418
84;Auvergne-Rhône-Alpes;38;3;01;161;Faramans;1062;6;1068
84;Auvergne-Rhône-Alpes;38;2;24;162;Faverges-de-la-Tour;1464;40;1504
84;Auvergne-Rhône-Alpes;38;1;13;163;Le Haut-Bréda;387;9;396
84;Auvergne-Rhône-Alpes;38;1;13;166;La Flachère;466;10;476
84;Auvergne-Rhône-Alpes;38;2;08;167;Flachères;540;5;545
84;Auvergne-Rhône-Alpes;38;1;97;169;Fontaine;23211;234;23445
84;Auvergne-Rhône-Alpes;38;1;10;170;Fontanil-Cornillon;3172;35;3207
84;Auvergne-Rhône-Alpes;38;3;01;171;La Forteresse;328;4;332
84;Auvergne-Rhône-Alpes;38;2;14;172;Four;1625;33;1658
84;Auvergne-Rhône-Alpes;38;1;19;173;Le Freney-d'Oisans;247;7;254
84;Auvergne-Rhône-Alpes;38;3;01;174;La Frette;1092;23;1115
84;Auvergne-Rhône-Alpes;38;1;13;175;Froges;3392;59;3451
84;Auvergne-Rhône-Alpes;38;2;26;176;Frontonas;2096;55;2151
84;Auvergne-Rhône-Alpes;38;1;19;177;La Garde;103;0;103
84;Auvergne-Rhône-Alpes;38;1;22;179;Gières;7134;86;7220
84;Auvergne-Rhône-Alpes;38;3;01;180;Gillonnay;1013;38;1051
84;Auvergne-Rhône-Alpes;38;1;13;181;Goncelin;2476;36;2512
84;Auvergne-Rhône-Alpes;38;2;08;182;Le Grand-Lemps;3079;57;3136
84;Auvergne-Rhône-Alpes;38;2;03;183;Granieu;502;9;511
84;Auvergne-Rhône-Alpes;38;3;26;184;Grenay;1627;21;1648
84;Auvergne-Rhône-Alpes;38;1;98;185;Grenoble;158198;2243;160441
84;Auvergne-Rhône-Alpes;38;1;15;186;Gresse-en-Vercors;377;12;389
84;Auvergne-Rhône-Alpes;38;1;20;187;Le Gua;1796;25;1821
84;Auvergne-Rhône-Alpes;38;1;20;188;Herbeys;1362;23;1385
84;Auvergne-Rhône-Alpes;38;3;26;189;Heyrieux;4712;64;4776
84;Auvergne-Rhône-Alpes;38;2;04;190;Hières-sur-Amby;1171;28;1199
84;Auvergne-Rhône-Alpes;38;1;19;191;Huez;1306;34;1340
84;Auvergne-Rhône-Alpes;38;1;13;192;Hurtières;195;6;201
84;Auvergne-Rhône-Alpes;38;2;14;193;L'Isle-d'Abeau;16584;318;16902
84;Auvergne-Rhône-Alpes;38;1;08;194;Izeaux;2137;35;2172
84;Auvergne-Rhône-Alpes;38;1;23;195;Izeron;745;9;754
84;Auvergne-Rhône-Alpes;38;2;04;197;Janneyrias;1816;20;1836
84;Auvergne-Rhône-Alpes;38;3;21;198;Jarcieu;1059;22;1081
84;Auvergne-Rhône-Alpes;38;3;28;199;Jardin;2156;56;2212
84;Auvergne-Rhône-Alpes;38;1;20;200;Jarrie;3779;69;3848
84;Auvergne-Rhône-Alpes;38;1;15;203;Laffrey;465;8;473
84;Auvergne-Rhône-Alpes;38;1;15;204;Lalley;192;5;197
84;Auvergne-Rhône-Alpes;38;1;07;205;Lans-en-Vercors;2676;119;2795
84;Auvergne-Rhône-Alpes;38;1;18;206;Laval-en-Belledonne;983;36;1019
84;Auvergne-Rhône-Alpes;38;1;15;207;Lavaldens;151;3;154
84;Auvergne-Rhône-Alpes;38;1;15;208;Lavars;148;3;151
84;Auvergne-Rhône-Alpes;38;3;01;209;Lentiol;235;7;242
84;Auvergne-Rhône-Alpes;38;2;04;210;Leyrieu;871;14;885
84;Auvergne-Rhône-Alpes;38;3;01;211;Lieudieu;352;5;357
84;Auvergne-Rhône-Alpes;38;1;19;212;Livet-et-Gavet;1284;8;1292
84;Auvergne-Rhône-Alpes;38;3;08;213;Longechenal;584;12;596
84;Auvergne-Rhône-Alpes;38;1;18;214;Lumbin;2166;73;2239
84;Auvergne-Rhône-Alpes;38;3;27;215;Luzinay;2314;44;2358
84;Auvergne-Rhône-Alpes;38;1;23;216;Malleval-en-Vercors;54;2;56
84;Auvergne-Rhône-Alpes;38;1;15;217;Marcieu;71;2;73
84;Auvergne-Rhône-Alpes;38;3;01;218;Marcilloles;1176;21;1197
84;Auvergne-Rhône-Alpes;38;3;01;219;Marcollin;645;15;660
84;Auvergne-Rhône-Alpes;38;3;01;221;Marnans;141;3;144
84;Auvergne-Rhône-Alpes;38;2;08;222;Massieu;750;17;767
84;Auvergne-Rhône-Alpes;38;2;14;223;Maubec;1876;66;1942
84;Auvergne-Rhône-Alpes;38;1;15;224;Mayres-Savel;91;3;94
84;Auvergne-Rhône-Alpes;38;1;07;225;Autrans-Méaudre en Vercors;3039;103;3142
84;Auvergne-Rhône-Alpes;38;1;15;226;Mens;1393;75;1468
84;Auvergne-Rhône-Alpes;38;2;03;228;Merlas;479;18;497
84;Auvergne-Rhône-Alpes;38;1;16;229;Meylan;17786;391;18177
84;Auvergne-Rhône-Alpes;38;2;02;230;Meyrié;1023;43;1066
84;Auvergne-Rhône-Alpes;38;3;14;231;Meyrieu-les-Étangs;1025;30;1055
84;Auvergne-Rhône-Alpes;38;3;01;232;Meyssiez;638;12;650
84;Auvergne-Rhône-Alpes;38;1;15;235;Miribel-Lanchâtre;456;8;464
84;Auvergne-Rhône-Alpes;38;1;03;236;Miribel-les-Échelles;1733;38;1771
84;Auvergne-Rhône-Alpes;38;1;19;237;Mizoën;190;4;194
84;Auvergne-Rhône-Alpes;38;3;27;238;Moidieu-Détourbe;1941;42;1983
84;Auvergne-Rhône-Alpes;38;1;25;239;Moirans;7499;156;7655
84;Auvergne-Rhône-Alpes;38;3;21;240;Moissieu-sur-Dolon;738;15;753
84;Auvergne-Rhône-Alpes;38;1;15;241;Monestier-d'Ambel;16;0;16
84;Auvergne-Rhône-Alpes;38;1;15;242;Monestier-de-Clermont;1428;31;1459
84;Auvergne-Rhône-Alpes;38;1;15;243;Le Monestier-du-Percy;250;6;256
84;Auvergne-Rhône-Alpes;38;3;21;244;Monsteroux-Milieu;797;19;816
84;Auvergne-Rhône-Alpes;38;1;23;245;Montagne;269;4;273
84;Auvergne-Rhône-Alpes;38;2;24;246;Montagnieu;1132;17;1149
84;Auvergne-Rhône-Alpes;38;2;17;247;Montalieu-Vercieu;3467;55;3522
84;Auvergne-Rhône-Alpes;38;1;25;248;Montaud;524;21;545
84;Auvergne-Rhône-Alpes;38;1;16;249;Montbonnot-Saint-Martin;5477;562;6039
84;Auvergne-Rhône-Alpes;38;2;24;250;Montcarra;569;17;586
84;Auvergne-Rhône-Alpes;38;1;19;252;Montchaboud;337;9;346
84;Auvergne-Rhône-Alpes;38;1;19;253;Les Deux Alpes;1929;36;1965
84;Auvergne-Rhône-Alpes;38;1;15;254;Monteynard;500;13;513
84;Auvergne-Rhône-Alpes;38;3;01;255;Montfalcon;139;0;139
84;Auvergne-Rhône-Alpes;38;2;08;256;Montferrat;1833;23;1856
84;Auvergne-Rhône-Alpes;38;2;08;257;Montrevel;446;12;458
84;Auvergne-Rhône-Alpes;38;1;10;258;Mont-Saint-Martin;76;4;80
84;Auvergne-Rhône-Alpes;38;3;21;259;Montseveroux;972;16;988
84;Auvergne-Rhône-Alpes;38;2;04;260;Moras;525;18;543
84;Auvergne-Rhône-Alpes;38;2;17;261;Morestel;4526;99;4625
84;Auvergne-Rhône-Alpes;38;1;23;263;Morette;391;5;396
84;Auvergne-Rhône-Alpes;38;1;19;264;La Morte;136;0;136
84;Auvergne-Rhône-Alpes;38;1;15;265;La Motte-d'Aveillans;1692;21;1713
84;Auvergne-Rhône-Alpes;38;1;15;266;La Motte-Saint-Martin;450;9;459
84;Auvergne-Rhône-Alpes;38;3;01;267;Mottier;768;13;781
84;Auvergne-Rhône-Alpes;38;1;13;268;Le Moutaret;264;3;267
84;Auvergne-Rhône-Alpes;38;1;15;269;La Mure;4920;208;5128
84;Auvergne-Rhône-Alpes;38;1;29;270;La Murette;1858;65;1923
84;Auvergne-Rhône-Alpes;38;1;16;271;Murianette;862;11;873
84;Auvergne-Rhône-Alpes;38;1;23;272;Murinais;399;7;406
84;Auvergne-Rhône-Alpes;38;1;15;273;Nantes-en-Ratier;464;19;483
84;Auvergne-Rhône-Alpes;38;1;23;275;Serre-Nerpol;308;41;349
84;Auvergne-Rhône-Alpes;38;2;02;276;Nivolas-Vermelle;2648;69;2717
84;Auvergne-Rhône-Alpes;38;1;20;277;Notre-Dame-de-Commiers;536;6;542
84;Auvergne-Rhône-Alpes;38;1;23;278;Notre-Dame-de-l'Osier;498;9;507
84;Auvergne-Rhône-Alpes;38;1;19;279;Notre-Dame-de-Mésage;1131;12;1143
84;Auvergne-Rhône-Alpes;38;1;15;280;Notre-Dame-de-Vaulx;521;21;542
84;Auvergne-Rhône-Alpes;38;1;07;281;Noyarey;2256;77;2333
84;Auvergne-Rhône-Alpes;38;2;17;282;Optevoz;871;28;899
84;Auvergne-Rhône-Alpes;38;1;15;283;Oris-en-Rattier;109;3;112
84;Auvergne-Rhône-Alpes;38;3;01;284;Ornacieux-Balbins;849;27;876
84;Auvergne-Rhône-Alpes;38;1;19;285;Ornon;161;4;165
84;Auvergne-Rhône-Alpes;38;1;19;286;Oulles;6;0;6
84;Auvergne-Rhône-Alpes;38;2;08;287;Oyeu;1039;20;1059
84;Auvergne-Rhône-Alpes;38;3;26;288;Oytier-Saint-Oblas;1668;32;1700
84;Auvergne-Rhône-Alpes;38;1;19;289;Oz;213;4;217
84;Auvergne-Rhône-Alpes;38;3;21;290;Pact;855;15;870
84;Auvergne-Rhône-Alpes;38;3;01;291;Pajay;1153;17;1170
84;Auvergne-Rhône-Alpes;38;2;08;292;Villages du Lac de Paladru;2528;60;2588
84;Auvergne-Rhône-Alpes;38;2;04;294;Panossas;660;16;676
84;Auvergne-Rhône-Alpes;38;2;17;295;Parmilieu;723;12;735
84;Auvergne-Rhône-Alpes;38;2;24;296;Le Passage;876;37;913
84;Auvergne-Rhône-Alpes;38;2;17;297;Arandon-Passins;1851;43;1894
84;Auvergne-Rhône-Alpes;38;3;21;298;Le Péage-de-Roussillon;6516;59;6575
84;Auvergne-Rhône-Alpes;38;1;15;299;Pellafol;137;2;139
84;Auvergne-Rhône-Alpes;38;3;01;300;Penol;362;9;371
84;Auvergne-Rhône-Alpes;38;1;15;301;Percy;175;4;179
84;Auvergne-Rhône-Alpes;38;1;13;303;La Pierre;565;5;570
84;Auvergne-Rhône-Alpes;38;1;15;304;Pierre-Châtel;1493;37;1530
84;Auvergne-Rhône-Alpes;38;3;21;307;Pisieu;521;9;530
84;Auvergne-Rhône-Alpes;38;3;01;308;Plan;271;2;273
84;Auvergne-Rhône-Alpes;38;1;22;309;Poisat;2127;27;2154
84;Auvergne-Rhône-Alpes;38;1;25;310;Poliénas;1212;16;1228
84;Auvergne-Rhône-Alpes;38;3;21;311;Pommier-de-Beaurepaire;709;15;724
84;Auvergne-Rhône-Alpes;38;1;15;313;Ponsonnas;296;15;311
84;Auvergne-Rhône-Alpes;38;1;13;314;Pontcharra;7348;171;7519
84;Auvergne-Rhône-Alpes;38;2;03;315;Le Pont-de-Beauvoisin;3570;142;3712
84;Auvergne-Rhône-Alpes;38;2;04;316;Pont-de-Chéruy;5980;44;6024
84;Auvergne-Rhône-Alpes;38;1;20;317;Le Pont-de-Claix;10716;76;10792
84;Auvergne-Rhône-Alpes;38;3;27;318;Pont-Évêque;5313;50;5363
84;Auvergne-Rhône-Alpes;38;1;23;319;Pont-en-Royans;785;31;816
84;Auvergne-Rhône-Alpes;38;2;17;320;Porcieu-Amblagnieu;1786;40;1826
84;Auvergne-Rhône-Alpes;38;1;15;321;Prébois;165;8;173
84;Auvergne-Rhône-Alpes;38;1;23;322;Presles;92;2;94
84;Auvergne-Rhône-Alpes;38;2;03;323;Pressins;1161;22;1183
84;Auvergne-Rhône-Alpes;38;3;21;324;Primarette;716;18;734
84;Auvergne-Rhône-Alpes;38;1;10;325;Proveysieux;513;9;522
84;Auvergne-Rhône-Alpes;38;1;15;326;Prunières;367;12;379
84;Auvergne-Rhône-Alpes;38;1;10;328;Quaix-en-Chartreuse;897;33;930
84;Auvergne-Rhône-Alpes;38;1;15;329;Quet-en-Beaumont;68;0;68
84;Auvergne-Rhône-Alpes;38;1;23;330;Quincieu;102;1;103
84;Auvergne-Rhône-Alpes;38;1;25;331;Réaumont;998;31;1029
84;Auvergne-Rhône-Alpes;38;1;25;332;Renage;3467;51;3518
84;Auvergne-Rhône-Alpes;38;1;23;333;Rencurel;324;6;330
84;Auvergne-Rhône-Alpes;38;1;18;334;Revel;1313;43;1356
84;Auvergne-Rhône-Alpes;38;3;21;335;Revel-Tourdan;1051;26;1077
84;Auvergne-Rhône-Alpes;38;3;28;336;Reventin-Vaugris;1974;35;2009
84;Auvergne-Rhône-Alpes;38;1;25;337;Rives;6668;83;6751
84;Auvergne-Rhône-Alpes;38;1;23;338;La Rivière;740;9;749
84;Auvergne-Rhône-Alpes;38;2;26;339;Roche;2128;56;2184
84;Auvergne-Rhône-Alpes;38;3;28;340;Les Roches-de-Condrieu;1981;37;2018
84;Auvergne-Rhône-Alpes;38;2;24;341;Rochetoirin;1090;40;1130
84;Auvergne-Rhône-Alpes;38;1;15;342;Roissard;316;7;323
84;Auvergne-Rhône-Alpes;38;2;03;343;Romagnieu;1584;31;1615
84;Auvergne-Rhône-Alpes;38;3;21;344;Roussillon;8457;119;8576
84;Auvergne-Rhône-Alpes;38;1;23;345;Rovon;611;10;621
84;Auvergne-Rhône-Alpes;38;3;01;346;Royas;397;7;404
84;Auvergne-Rhône-Alpes;38;3;01;347;Roybon;1132;27;1159
84;Auvergne-Rhône-Alpes;38;2;02;348;Ruy-Montceau;4717;108;4825
84;Auvergne-Rhône-Alpes;38;3;21;349;Sablons;2285;22;2307
84;Auvergne-Rhône-Alpes;38;1;18;350;Sainte-Agnès;554;18;572
84;Auvergne-Rhône-Alpes;38;3;14;351;Saint-Agnin-sur-Bion;1089;22;1111
84;Auvergne-Rhône-Alpes;38;2;14;352;Saint-Alban-de-Roche;2130;61;2191
84;Auvergne-Rhône-Alpes;38;3;28;353;Saint-Alban-du-Rhône;840;19;859
84;Auvergne-Rhône-Alpes;38;2;03;354;Saint-Albin-de-Vaulserre;410;5;415
84;Auvergne-Rhône-Alpes;38;1;15;355;Saint-Andéol;123;6;129
84;Auvergne-Rhône-Alpes;38;1;23;356;Saint-André-en-Royans;310;18;328
84;Auvergne-Rhône-Alpes;38;2;24;357;Saint-André-le-Gaz;2760;143;2903
84;Auvergne-Rhône-Alpes;38;3;01;358;Sainte-Anne-sur-Gervonde;717;11;728
84;Auvergne-Rhône-Alpes;38;1;23;359;Saint Antoine l'Abbaye;1162;28;1190
84;Auvergne-Rhône-Alpes;38;1;23;360;Saint-Appolinard;414;8;422
84;Auvergne-Rhône-Alpes;38;1;15;361;Saint-Arey;79;3;82
84;Auvergne-Rhône-Alpes;38;1;29;362;Saint-Aupre;1157;53;1210
84;Auvergne-Rhône-Alpes;38;3;21;363;Saint-Barthélemy;932;38;970
84;Auvergne-Rhône-Alpes;38;1;19;364;Saint-Barthélemy-de-Séchilienne;430;4;434
84;Auvergne-Rhône-Alpes;38;2;04;365;Saint-Baudille-de-la-Tour;814;19;833
84;Auvergne-Rhône-Alpes;38;1;15;366;Saint-Baudille-et-Pipet;260;8;268
84;Auvergne-Rhône-Alpes;38;1;25;368;Saint-Blaise-du-Buis;1094;25;1119
84;Auvergne-Rhône-Alpes;38;2;24;369;Sainte-Blandine;985;38;1023
84;Auvergne-Rhône-Alpes;38;1;23;370;Saint-Bonnet-de-Chavagne;653;18;671
84;Auvergne-Rhône-Alpes;38;2;03;372;Saint-Bueil;724;10;734
84;Auvergne-Rhône-Alpes;38;1;29;373;Saint-Cassien;1149;42;1191
84;Auvergne-Rhône-Alpes;38;2;02;374;Saint-Chef;3689;91;3780
84;Auvergne-Rhône-Alpes;38;1;19;375;Saint-Christophe-en-Oisans;110;0;110
84;Auvergne-Rhône-Alpes;38;1;03;376;Saint-Christophe-sur-Guiers;824;9;833
84;Auvergne-Rhône-Alpes;38;2;24;377;Saint-Clair-de-la-Tour;3456;59;3515
84;Auvergne-Rhône-Alpes;38;3;28;378;Saint-Clair-du-Rhône;3705;86;3791
84;Auvergne-Rhône-Alpes;38;3;01;379;Saint-Clair-sur-Galaure;269;8;277
84;Auvergne-Rhône-Alpes;38;2;08;380;Saint-Didier-de-Bizonnes;308;5;313
84;Auvergne-Rhône-Alpes;38;2;24;381;Saint-Didier-de-la-Tour;2098;53;2151
84;Auvergne-Rhône-Alpes;38;1;10;382;Saint-Égrève;15944;220;16164
84;Auvergne-Rhône-Alpes;38;1;29;383;Saint-Étienne-de-Crossey;2595;108;2703
84;Auvergne-Rhône-Alpes;38;3;01;384;Saint-Étienne-de-Saint-Geoirs;3206;44;3250
84;Auvergne-Rhône-Alpes;38;2;03;386;Saint-Geoire-en-Valdaine;2394;41;2435
84;Auvergne-Rhône-Alpes;38;3;01;387;Saint-Geoirs;506;13;519
84;Auvergne-Rhône-Alpes;38;1;20;388;Saint-Georges-de-Commiers;2537;32;2569
84;Auvergne-Rhône-Alpes;38;3;26;389;Saint-Georges-d'Espéranche;3439;68;3507
84;Auvergne-Rhône-Alpes;38;1;23;390;Saint-Gervais;544;9;553
84;Auvergne-Rhône-Alpes;38;1;15;391;Saint-Guillaume;247;5;252
84;Auvergne-Rhône-Alpes;38;2;04;392;Saint-Hilaire-de-Brens;615;22;637
84;Auvergne-Rhône-Alpes;38;3;01;393;Saint-Hilaire-de-la-Côte;1558;33;1591
84;Auvergne-Rhône-Alpes;38;1;23;394;Saint-Hilaire-du-Rosier;1869;32;1901
84;Auvergne-Rhône-Alpes;38;1;18;395;Plateau-des-Petites-Roches;2380;73;2453
84;Auvergne-Rhône-Alpes;38;1;15;396;Saint-Honoré;810;27;837
84;Auvergne-Rhône-Alpes;38;1;18;397;Saint-Ismier;7064;314;7378
84;Auvergne-Rhône-Alpes;38;2;03;398;Saint-Jean-d'Avelanne;976;16;992
84;Auvergne-Rhône-Alpes;38;3;14;399;Saint-Jean-de-Bournay;4590;101;4691
84;Auvergne-Rhône-Alpes;38;1;25;400;Saint-Jean-de-Moirans;3564;80;3644
84;Auvergne-Rhône-Alpes;38;2;24;401;Saint-Jean-de-Soudain;1636;40;1676
84;Auvergne-Rhône-Alpes;38;1;15;402;Saint-Jean-de-Vaulx;529;19;548
84;Auvergne-Rhône-Alpes;38;1;15;403;Saint-Jean-d'Hérans;286;5;291
84;Auvergne-Rhône-Alpes;38;1;18;404;Saint-Jean-le-Vieux;300;4;304
84;Auvergne-Rhône-Alpes;38;1;03;405;Saint-Joseph-de-Rivière;1224;28;1252
84;Auvergne-Rhône-Alpes;38;3;21;406;Saint-Julien-de-l'Herms;152;4;156
84;Auvergne-Rhône-Alpes;38;1;29;407;La Sure en Chartreuse;987;30;1017
84;Auvergne-Rhône-Alpes;38;3;26;408;Saint-Just-Chaleyssin;2656;61;2717
84;Auvergne-Rhône-Alpes;38;1;23;409;Saint-Just-de-Claix;1311;33;1344
84;Auvergne-Rhône-Alpes;38;1;23;410;Saint-Lattier;1399;24;1423
84;Auvergne-Rhône-Alpes;38;1;03;412;Saint-Laurent-du-Pont;4510;102;4612
84;Auvergne-Rhône-Alpes;38;1;15;413;Saint-Laurent-en-Beaumont;429;9;438
84;Auvergne-Rhône-Alpes;38;1;15;414;Sainte-Luce;41;2;43
84;Auvergne-Rhône-Alpes;38;2;02;415;Saint-Marcel-Bel-Accueil;1432;39;1471
84;Auvergne-Rhône-Alpes;38;1;23;416;Saint-Marcellin;7766;179;7945
84;Auvergne-Rhône-Alpes;38;1;13;417;Sainte-Marie-d'Alloix;479;17;496
84;Auvergne-Rhône-Alpes;38;1;13;418;Sainte-Marie-du-Mont;235;2;237
84;Auvergne-Rhône-Alpes;38;1;15;419;Saint-Martin-de-Clelles;185;2;187
84;Auvergne-Rhône-Alpes;38;2;03;420;Saint-Martin-de-Vaulserre;248;5;253
84;Auvergne-Rhône-Alpes;38;1;22;421;Saint-Martin-d'Hères;37935;265;38200
84;Auvergne-Rhône-Alpes;38;1;19;422;Saint-Martin-d'Uriage;5512;175;5687
84;Auvergne-Rhône-Alpes;38;1;10;423;Saint-Martin-le-Vinoux;5880;62;5942
84;Auvergne-Rhône-Alpes;38;1;15;424;Saint-Maurice-en-Trièves;168;3;171
84;Auvergne-Rhône-Alpes;38;3;28;425;Saint-Maurice-l'Exil;6387;94;6481
84;Auvergne-Rhône-Alpes;38;1;13;426;Saint-Maximin;656;16;672
84;Auvergne-Rhône-Alpes;38;3;01;427;Saint-Michel-de-Saint-Geoirs;299;4;303
84;Auvergne-Rhône-Alpes;38;1;15;428;Saint-Michel-en-Beaumont;31;0;31
84;Auvergne-Rhône-Alpes;38;1;15;429;Saint-Michel-les-Portes;281;7;288
84;Auvergne-Rhône-Alpes;38;1;18;430;Saint-Mury-Monteymond;325;7;332
84;Auvergne-Rhône-Alpes;38;1;18;431;Saint-Nazaire-les-Eymes;2960;90;3050
84;Auvergne-Rhône-Alpes;38;1;29;432;Saint-Nicolas-de-Macherin;977;25;1002
84;Auvergne-Rhône-Alpes;38;1;07;433;Saint-Nizier-du-Moucherotte;1083;31;1114
84;Auvergne-Rhône-Alpes;38;2;08;434;Saint-Ondras;648;6;654
84;Auvergne-Rhône-Alpes;38;1;20;436;Saint-Paul-de-Varces;2247;41;2288
84;Auvergne-Rhône-Alpes;38;3;01;437;Saint-Paul-d'Izeaux;293;6;299
84;Auvergne-Rhône-Alpes;38;1;15;438;Saint-Paul-lès-Monestier;267;1;268
84;Auvergne-Rhône-Alpes;38;1;13;439;Crêts en Belledonne;3372;55;3427
84;Auvergne-Rhône-Alpes;38;3;01;440;Saint-Pierre-de-Bressieux;758;16;774
84;Auvergne-Rhône-Alpes;38;1;03;442;Saint-Pierre-de-Chartreuse;962;26;988
84;Auvergne-Rhône-Alpes;38;1;23;443;Saint-Pierre-de-Chérennes;465;12;477
84;Auvergne-Rhône-Alpes;38;1;15;444;Saint-Pierre-de-Méaroz;116;6;122
84;Auvergne-Rhône-Alpes;38;1;19;445;Saint-Pierre-de-Mésage;781;6;787
84;Auvergne-Rhône-Alpes;38;1;03;446;Saint-Pierre-d'Entremont;570;14;584
84;Auvergne-Rhône-Alpes;38;3;28;448;Saint-Prim;1407;31;1438
84;Auvergne-Rhône-Alpes;38;2;26;449;Saint-Quentin-Fallavier;6020;64;6084
84;Auvergne-Rhône-Alpes;38;1;25;450;Saint-Quentin-sur-Isère;1475;19;1494
84;Auvergne-Rhône-Alpes;38;2;04;451;Saint-Romain-de-Jalionas;3346;41;3387
84;Auvergne-Rhône-Alpes;38;3;21;452;Saint-Romain-de-Surieu;368;10;378
84;Auvergne-Rhône-Alpes;38;1;23;453;Saint-Romans;1785;41;1826
84;Auvergne-Rhône-Alpes;38;1;23;454;Saint-Sauveur;2107;50;2157
84;Auvergne-Rhône-Alpes;38;2;02;455;Saint-Savin;4202;83;4285
84;Auvergne-Rhône-Alpes;38;1;15;456;Châtel-en-Trièves;477;10;487
84;Auvergne-Rhône-Alpes;38;3;01;457;Saint-Siméon-de-Bressieux;2921;65;2986
84;Auvergne-Rhône-Alpes;38;2;17;458;Saint-Sorlin-de-Morestel;614;16;630
84;Auvergne-Rhône-Alpes;38;3;28;459;Saint-Sorlin-de-Vienne;918;7;925
84;Auvergne-Rhône-Alpes;38;2;08;460;Saint-Sulpice-des-Rivoires;431;12;443
84;Auvergne-Rhône-Alpes;38;1;15;462;Saint-Théoffrey;540;14;554
84;Auvergne-Rhône-Alpes;38;1;23;463;Saint-Vérand;1713;38;1751
84;Auvergne-Rhône-Alpes;38;2;24;464;Saint-Victor-de-Cessieu;2249;49;2298
84;Auvergne-Rhône-Alpes;38;2;17;465;Saint-Victor-de-Morestel;1093;22;1115
84;Auvergne-Rhône-Alpes;38;1;13;466;Saint-Vincent-de-Mercuze;1505;48;1553
84;Auvergne-Rhône-Alpes;38;2;02;467;Salagnon;1452;38;1490
84;Auvergne-Rhône-Alpes;38;3;21;468;Salaise-sur-Sanne;4488;71;4559
84;Auvergne-Rhône-Alpes;38;1;15;469;La Salette-Fallavaux;68;0;68
84;Auvergne-Rhône-Alpes;38;1;15;470;La Salle-en-Beaumont;335;8;343
84;Auvergne-Rhône-Alpes;38;1;16;471;Le Sappey-en-Chartreuse;1133;30;1163
84;Auvergne-Rhône-Alpes;38;1;10;472;Sarcenas;214;4;218
84;Auvergne-Rhône-Alpes;38;3;01;473;Sardieu;1158;22;1180
84;Auvergne-Rhône-Alpes;38;1;07;474;Sassenage;11062;197;11259
84;Auvergne-Rhône-Alpes;38;2;26;475;Satolas-et-Bonce;2487;28;2515
84;Auvergne-Rhône-Alpes;38;3;01;476;Savas-Mépin;898;10;908
84;Auvergne-Rhône-Alpes;38;1;19;478;Séchilienne;1063;13;1076
84;Auvergne-Rhône-Alpes;38;3;01;479;Porte-des-Bonnevaux;2016;52;2068
84;Auvergne-Rhône-Alpes;38;3;27;480;Septème;2071;41;2112
84;Auvergne-Rhône-Alpes;38;2;02;481;Sérézin-de-la-Tour;1106;32;1138
84;Auvergne-Rhône-Alpes;38;2;17;483;Sermérieu;1659;50;1709
84;Auvergne-Rhône-Alpes;38;3;27;484;Serpaize;2116;27;2143
84;Auvergne-Rhône-Alpes;38;1;06;485;Seyssinet-Pariset;11891;142;12033
84;Auvergne-Rhône-Alpes;38;1;06;486;Seyssins;7827;108;7935
84;Auvergne-Rhône-Alpes;38;3;27;487;Seyssuel;2049;52;2101
84;Auvergne-Rhône-Alpes;38;2;04;488;Siccieu-Saint-Julien-et-Carisieu;583;16;599
84;Auvergne-Rhône-Alpes;38;1;15;489;Siévoz;133;2;135
84;Auvergne-Rhône-Alpes;38;3;01;490;Sillans;1946;47;1993
84;Auvergne-Rhône-Alpes;38;1;15;492;Sinard;703;21;724
84;Auvergne-Rhône-Alpes;38;2;17;494;Soleymieu;797;21;818
84;Auvergne-Rhône-Alpes;38;1;23;495;La Sône;585;4;589
84;Auvergne-Rhône-Alpes;38;3;21;496;Sonnay;1239;25;1264
84;Auvergne-Rhône-Alpes;38;1;15;497;Sousville;143;0;143
84;Auvergne-Rhône-Alpes;38;2;02;498;Succieu;735;22;757
84;Auvergne-Rhône-Alpes;38;1;15;499;Susville;1206;16;1222
84;Auvergne-Rhône-Alpes;38;1;23;500;Têche;574;6;580
84;Auvergne-Rhône-Alpes;38;1;13;501;Tencin;2128;23;2151
84;Auvergne-Rhône-Alpes;38;1;18;503;La Terrasse;2510;127;2637
84;Auvergne-Rhône-Alpes;38;1;13;504;Theys;1995;95;2090
84;Auvergne-Rhône-Alpes;38;3;01;505;Thodure;772;15;787
84;Auvergne-Rhône-Alpes;38;2;04;507;Tignieu-Jameyzieu;7555;99;7654
84;Auvergne-Rhône-Alpes;38;2;24;508;Torchefelon;794;26;820
84;Auvergne-Rhône-Alpes;38;2;24;509;La Tour-du-Pin;8167;207;8374
84;Auvergne-Rhône-Alpes;38;1;13;511;Le Touvet;3176;101;3277
84;Auvergne-Rhône-Alpes;38;3;14;512;Tramolé;777;25;802
84;Auvergne-Rhône-Alpes;38;1;15;513;Treffort;301;7;308
84;Auvergne-Rhône-Alpes;38;1;15;514;Tréminis;177;1;178
84;Auvergne-Rhône-Alpes;38;2;04;515;Trept;2212;56;2268
84;Auvergne-Rhône-Alpes;38;1;16;516;La Tronche;6602;140;6742
84;Auvergne-Rhône-Alpes;38;1;25;517;Tullins;7816;123;7939
84;Auvergne-Rhône-Alpes;38;1;15;518;Valbonnais;506;12;518
84;Auvergne-Rhône-Alpes;38;3;26;519;Valencin;2879;49;2928
84;Auvergne-Rhône-Alpes;38;2;08;520;Valencogne;698;20;718
84;Auvergne-Rhône-Alpes;38;1;15;521;La Valette;67;2;69
84;Auvergne-Rhône-Alpes;38;1;15;522;Valjouffrey;130;2;132
84;Auvergne-Rhône-Alpes;38;1;23;523;Varacieux;843;19;862
84;Auvergne-Rhône-Alpes;38;1;20;524;Varces-Allières-et-Risset;8301;164;8465
84;Auvergne-Rhône-Alpes;38;2;17;525;Vasselin;461;5;466
84;Auvergne-Rhône-Alpes;38;1;23;526;Vatilieu;360;11;371
84;Auvergne-Rhône-Alpes;38;1;19;527;Vaujany;342;4;346
84;Auvergne-Rhône-Alpes;38;1;19;528;Vaulnaveys-le-Bas;1321;30;1351
84;Auvergne-Rhône-Alpes;38;1;19;529;Vaulnaveys-le-Haut;3965;60;4025
84;Auvergne-Rhône-Alpes;38;2;14;530;Vaulx-Milieu;2537;51;2588
84;Auvergne-Rhône-Alpes;38;2;03;531;Velanne;561;6;567
84;Auvergne-Rhône-Alpes;38;2;04;532;Vénérieu;923;10;933
84;Auvergne-Rhône-Alpes;38;1;22;533;Venon;732;16;748
84;Auvergne-Rhône-Alpes;38;2;04;535;Vernas;262;7;269
84;Auvergne-Rhône-Alpes;38;3;28;536;Vernioz;1397;24;1421
84;Auvergne-Rhône-Alpes;38;2;26;537;La Verpillière;7293;88;7381
84;Auvergne-Rhône-Alpes;38;1;18;538;Le Versoud;4933;64;4997
84;Auvergne-Rhône-Alpes;38;2;17;539;Vertrieu;617;21;638
84;Auvergne-Rhône-Alpes;38;1;07;540;Veurey-Voroize;1433;26;1459
84;Auvergne-Rhône-Alpes;38;2;04;542;Veyssilieu;330;15;345
84;Auvergne-Rhône-Alpes;38;2;17;543;Vézeronce-Curtin;2142;35;2177
84;Auvergne-Rhône-Alpes;38;3;99;544;Vienne;29993;341;30334
84;Auvergne-Rhône-Alpes;38;1;20;545;Vif;8547;126;8673
84;Auvergne-Rhône-Alpes;38;2;17;546;Vignieu;973;81;1054
84;Auvergne-Rhône-Alpes;38;1;18;547;Villard-Bonnot;7249;105;7354
84;Auvergne-Rhône-Alpes;38;1;07;548;Villard-de-Lans;4234;225;4459
84;Auvergne-Rhône-Alpes;38;1;19;549;Villard-Notre-Dame;28;3;31
84;Auvergne-Rhône-Alpes;38;1;19;550;Villard-Reculas;57;0;57
84;Auvergne-Rhône-Alpes;38;1;19;551;Villard-Reymond;40;1;41
84;Auvergne-Rhône-Alpes;38;1;15;552;Villard-Saint-Christophe;403;12;415
84;Auvergne-Rhône-Alpes;38;2;14;553;Villefontaine;18835;271;19106
84;Auvergne-Rhône-Alpes;38;2;04;554;Villemoirieu;1820;69;1889
84;Auvergne-Rhône-Alpes;38;3;01;555;Villeneuve-de-Marc;1160;30;1190
84;Auvergne-Rhône-Alpes;38;3;21;556;Ville-sous-Anjou;1179;20;1199
84;Auvergne-Rhône-Alpes;38;2;04;557;Villette-d'Anthon;5113;89;5202
84;Auvergne-Rhône-Alpes;38;3;27;558;Villette-de-Vienne;1920;31;1951
84;Auvergne-Rhône-Alpes;38;1;23;559;Vinay;4352;73;4425
84;Auvergne-Rhône-Alpes;38;2;08;560;Val-de-Virieu;1537;19;1556
84;Auvergne-Rhône-Alpes;38;3;01;561;Viriville;1664;32;1696
84;Auvergne-Rhône-Alpes;38;1;19;562;Vizille;7246;168;7414
84;Auvergne-Rhône-Alpes;38;1;29;563;Voiron;20372;499;20871
84;Auvergne-Rhône-Alpes;38;2;03;564;Voissant;234;10;244
84;Auvergne-Rhône-Alpes;38;1;29;565;Voreppe;9275;373;9648
84;Auvergne-Rhône-Alpes;38;1;25;566;Vourey;1700;48;1748
84;Auvergne-Rhône-Alpes;38;1;19;567;Chamrousse;407;5;412
27;Bourgogne-Franche-Comté;39;1;17;001;Abergement-la-Ronce;859;25;884
27;Bourgogne-Franche-Comté;39;1;01;002;Abergement-le-Grand;61;1;62
27;Bourgogne-Franche-Comté;39;1;03;003;Abergement-le-Petit;46;0;46
27;Bourgogne-Franche-Comté;39;1;01;004;Abergement-lès-Thésy;53;3;56
27;Bourgogne-Franche-Comté;39;1;01;006;Aiglepierre;444;16;460
27;Bourgogne-Franche-Comté;39;2;09;007;Alièze;151;5;156
27;Bourgogne-Franche-Comté;39;1;02;008;Amange;444;49;493
27;Bourgogne-Franche-Comté;39;2;04;009;Andelot-en-Montagne;509;11;520
27;Bourgogne-Franche-Comté;39;2;13;010;Andelot-Morval;93;1;94
27;Bourgogne-Franche-Comté;39;1;17;011;Annoire;404;5;409
27;Bourgogne-Franche-Comté;39;1;01;013;Arbois;3295;209;3504
27;Bourgogne-Franche-Comté;39;1;02;014;Archelange;216;6;222
27;Bourgogne-Franche-Comté;39;2;04;015;Ardon;116;2;118
27;Bourgogne-Franche-Comté;39;2;09;016;Arinthod;1094;34;1128
27;Bourgogne-Franche-Comté;39;2;03;017;Arlay;1206;37;1243
27;Bourgogne-Franche-Comté;39;2;09;018;Aromas;658;18;676
27;Bourgogne-Franche-Comté;39;1;01;019;Les Arsures;218;10;228
27;Bourgogne-Franche-Comté;39;2;15;020;Arsure-Arsurette;100;4;104
27;Bourgogne-Franche-Comté;39;2;13;021;La Chailleuse;594;14;608
27;Bourgogne-Franche-Comté;39;1;17;022;Asnans-Beauvoisin;739;12;751
27;Bourgogne-Franche-Comté;39;1;02;024;Audelange;272;6;278
27;Bourgogne-Franche-Comté;39;2;13;025;Augea;269;7;276
27;Bourgogne-Franche-Comté;39;1;10;026;Augerans;181;1;182
27;Bourgogne-Franche-Comté;39;2;13;027;Augisey;191;6;197
27;Bourgogne-Franche-Comté;39;1;03;028;Aumont;475;7;482
27;Bourgogne-Franche-Comté;39;1;17;029;Aumur;370;9;379
27;Bourgogne-Franche-Comté;39;1;02;030;Authume;820;21;841
27;Bourgogne-Franche-Comté;39;1;02;031;Auxange;201;3;204
27;Bourgogne-Franche-Comté;39;3;14;032;Avignon-lès-Saint-Claude;364;17;381
27;Bourgogne-Franche-Comté;39;1;17;034;Balaiseaux;315;8;323
27;Bourgogne-Franche-Comté;39;2;13;035;Balanod;351;9;360
27;Bourgogne-Franche-Comté;39;1;10;037;Bans;195;4;199
27;Bourgogne-Franche-Comté;39;2;15;038;Barésia-sur-l'Ain;146;2;148
27;Bourgogne-Franche-Comté;39;1;10;039;La Barre;239;5;244
27;Bourgogne-Franche-Comté;39;1;03;040;Barretaine;177;2;179
27;Bourgogne-Franche-Comté;39;2;12;041;Baume-les-Messieurs;160;6;166
27;Bourgogne-Franche-Comté;39;1;02;042;Baverans;492;21;513
27;Bourgogne-Franche-Comté;39;2;13;043;Beaufort-Orbagna;1398;20;1418
27;Bourgogne-Franche-Comté;39;2;09;045;Beffia;81;3;84
27;Bourgogne-Franche-Comté;39;3;16;046;Bellecombe;71;4;75
27;Bourgogne-Franche-Comté;39;3;11;047;Bellefontaine;527;16;543
27;Bourgogne-Franche-Comté;39;1;10;048;Belmont;251;8;259
27;Bourgogne-Franche-Comté;39;1;03;049;Bersaillin;408;14;422
27;Bourgogne-Franche-Comté;39;1;12;050;Besain;158;10;168
27;Bourgogne-Franche-Comté;39;1;02;051;Biarne;409;5;414
27;Bourgogne-Franche-Comté;39;2;15;052;Bief-des-Maisons;68;0;68
27;Bourgogne-Franche-Comté;39;2;15;053;Bief-du-Fourg;208;4;212
27;Bourgogne-Franche-Comté;39;1;03;054;Biefmorin;110;1;111
27;Bourgogne-Franche-Comté;39;2;15;055;Billecul;47;1;48
27;Bourgogne-Franche-Comté;39;2;03;056;Bletterans;1500;28;1528
27;Bourgogne-Franche-Comté;39;2;12;057;Blois-sur-Seille;101;1;102
27;Bourgogne-Franche-Comté;39;2;12;058;Blye;174;5;179
27;Bourgogne-Franche-Comté;39;3;11;059;Bois-d'Amont;1642;42;1684
27;Bourgogne-Franche-Comté;39;2;03;060;Bois-de-Gand;55;1;56
27;Bourgogne-Franche-Comté;39;2;15;061;Boissia;109;5;114
27;Bourgogne-Franche-Comté;39;2;09;062;La Boissière;70;0;70
27;Bourgogne-Franche-Comté;39;2;15;063;Bonlieu;267;6;273
27;Bourgogne-Franche-Comté;39;2;12;065;Bonnefontaine;112;0;112
27;Bourgogne-Franche-Comté;39;2;08;066;Bornay;179;6;185
27;Bourgogne-Franche-Comté;39;3;16;068;Les Bouchoux;308;9;317
27;Bourgogne-Franche-Comté;39;2;04;070;Bourg-de-Sirod;94;2;96
27;Bourgogne-Franche-Comté;39;1;01;072;Bracon;268;7;275
27;Bourgogne-Franche-Comté;39;1;03;073;Brainans;170;6;176
27;Bourgogne-Franche-Comté;39;1;02;074;Brans;206;8;214
27;Bourgogne-Franche-Comté;39;1;10;076;La Bretenière;220;1;221
27;Bourgogne-Franche-Comté;39;1;17;077;Bretenières;43;1;44
27;Bourgogne-Franche-Comté;39;1;02;078;Brevans;682;14;696
27;Bourgogne-Franche-Comté;39;2;12;079;Briod;204;9;213
27;Bourgogne-Franche-Comté;39;2;13;080;Broissia;62;2;64
27;Bourgogne-Franche-Comté;39;1;12;081;Buvilly;388;8;396
27;Bourgogne-Franche-Comté;39;2;15;083;Censeau;319;6;325
27;Bourgogne-Franche-Comté;39;1;01;084;Cernans;143;4;147
27;Bourgogne-Franche-Comté;39;2;15;085;Cerniébaud;89;1;90
27;Bourgogne-Franche-Comté;39;2;09;086;Cernon;237;2;239
27;Bourgogne-Franche-Comté;39;2;13;088;Cesancey;392;11;403
27;Bourgogne-Franche-Comté;39;1;17;090;Chaînée-des-Coupis;184;4;188
27;Bourgogne-Franche-Comté;39;2;15;091;Les Chalesmes;91;1;92
27;Bourgogne-Franche-Comté;39;2;09;092;Chambéria;182;1;183
27;Bourgogne-Franche-Comté;39;1;10;093;Chamblay;424;10;434
27;Bourgogne-Franche-Comté;39;1;12;094;Chamole;163;7;170
27;Bourgogne-Franche-Comté;39;1;10;095;Champagne-sur-Loue;123;5;128
27;Bourgogne-Franche-Comté;39;1;02;096;Champagney;469;8;477
27;Bourgogne-Franche-Comté;39;2;04;097;Champagnole;8014;407;8421
27;Bourgogne-Franche-Comté;39;1;17;099;Champdivers;438;7;445
27;Bourgogne-Franche-Comté;39;2;03;100;Champrougier;102;3;105
27;Bourgogne-Franche-Comté;39;1;05;101;Champvans;1442;33;1475
27;Bourgogne-Franche-Comté;39;3;09;102;Chancia;228;4;232
27;Bourgogne-Franche-Comté;39;1;01;103;La Chapelle-sur-Furieuse;308;1;309
27;Bourgogne-Franche-Comté;39;2;03;104;Chapelle-Voland;604;9;613
27;Bourgogne-Franche-Comté;39;2;04;105;Chapois;219;9;228
27;Bourgogne-Franche-Comté;39;3;09;106;Charchilla;289;6;295
27;Bourgogne-Franche-Comté;39;2;15;107;Charcier;139;3;142
27;Bourgogne-Franche-Comté;39;2;15;108;Charency;55;3;58
27;Bourgogne-Franche-Comté;39;2;15;109;Charézier;178;2;180
27;Bourgogne-Franche-Comté;39;2;03;110;La Charme;66;0;66
27;Bourgogne-Franche-Comté;39;2;09;111;Charnod;39;0;39
27;Bourgogne-Franche-Comté;39;2;03;112;La Chassagne;110;1;111
27;Bourgogne-Franche-Comté;39;2;12;114;Château-Chalon;141;7;148
27;Bourgogne-Franche-Comté;39;1;01;116;La Châtelaine;149;2;151
27;Bourgogne-Franche-Comté;39;1;10;117;Chatelay;109;6;115
27;Bourgogne-Franche-Comté;39;3;09;118;Châtel-de-Joux;53;0;53
27;Bourgogne-Franche-Comté;39;1;03;119;Le Chateley;86;3;89
27;Bourgogne-Franche-Comté;39;2;04;120;Châtelneuf;130;8;138
27;Bourgogne-Franche-Comté;39;1;02;121;Châtenois;406;7;413
27;Bourgogne-Franche-Comté;39;2;12;122;Châtillon;108;5;113
27;Bourgogne-Franche-Comté;39;2;03;124;Chaumergy;472;15;487
27;Bourgogne-Franche-Comté;39;3;15;126;La Chaumusse;395;11;406
27;Bourgogne-Franche-Comté;39;1;12;127;Chaussenans;106;1;107
27;Bourgogne-Franche-Comté;39;1;17;128;Chaussin;1575;24;1599
27;Bourgogne-Franche-Comté;39;2;15;129;Chaux-des-Crotenay;396;14;410
27;Bourgogne-Franche-Comté;39;3;14;130;Nanchez;805;22;827
27;Bourgogne-Franche-Comté;39;3;15;131;La Chaux-du-Dombief;571;13;584
27;Bourgogne-Franche-Comté;39;2;03;132;La Chaux-en-Bresse;34;0;34
27;Bourgogne-Franche-Comté;39;1;01;133;Chaux-Champagny;70;2;72
27;Bourgogne-Franche-Comté;39;2;09;134;Chavéria;227;8;235
27;Bourgogne-Franche-Comté;39;2;03;136;Chemenot;37;1;38
27;Bourgogne-Franche-Comté;39;2;09;137;Saint-Hymetière-sur-Valouse;440;15;455
27;Bourgogne-Franche-Comté;39;1;17;138;Chemin;343;10;353
27;Bourgogne-Franche-Comté;39;1;17;139;Chêne-Bernard;73;0;73
27;Bourgogne-Franche-Comté;39;2;03;140;Chêne-Sec;39;0;39
27;Bourgogne-Franche-Comté;39;1;02;141;Chevigny;281;6;287
27;Bourgogne-Franche-Comté;39;2;13;142;Chevreaux;129;1;130
27;Bourgogne-Franche-Comté;39;2;15;143;Chevrotaine;34;0;34
27;Bourgogne-Franche-Comté;39;2;07;145;Chille;295;19;314
27;Bourgogne-Franche-Comté;39;2;08;146;Chilly-le-Vignoble;627;25;652
27;Bourgogne-Franche-Comté;39;1;01;147;Chilly-sur-Salins;100;4;104
27;Bourgogne-Franche-Comté;39;1;10;149;Chissey-sur-Loue;310;9;319
27;Bourgogne-Franche-Comté;39;1;06;150;Choisey;1023;30;1053
27;Bourgogne-Franche-Comté;39;3;16;151;Choux;124;6;130
27;Bourgogne-Franche-Comté;39;2;04;153;Cize;795;31;826
27;Bourgogne-Franche-Comté;39;2;15;154;Clairvaux-les-Lacs;1435;43;1478
27;Bourgogne-Franche-Comté;39;1;01;155;Clucy;77;0;77
27;Bourgogne-Franche-Comté;39;2;15;156;Cogna;245;7;252
27;Bourgogne-Franche-Comté;39;3;16;157;Coiserette;53;3;56
27;Bourgogne-Franche-Comté;39;1;03;159;Colonne;262;2;264
27;Bourgogne-Franche-Comté;39;2;03;160;Commenailles;896;17;913
27;Bourgogne-Franche-Comté;39;2;07;162;Condamine;260;5;265
27;Bourgogne-Franche-Comté;39;2;09;163;Condes;114;3;117
27;Bourgogne-Franche-Comté;39;2;12;164;Conliège;664;27;691
27;Bourgogne-Franche-Comté;39;2;15;165;Conte;55;0;55
27;Bourgogne-Franche-Comté;39;2;09;166;Cornod;216;4;220
27;Bourgogne-Franche-Comté;39;2;03;167;Cosges;360;5;365
27;Bourgogne-Franche-Comté;39;2;09;168;Courbette;46;0;46
27;Bourgogne-Franche-Comté;39;2;08;169;Courbouzon;592;15;607
27;Bourgogne-Franche-Comté;39;2;07;170;Courlans;923;28;951
27;Bourgogne-Franche-Comté;39;2;07;171;Courlaoux;1144;31;1175
27;Bourgogne-Franche-Comté;39;1;10;172;Courtefontaine;254;14;268
27;Bourgogne-Franche-Comté;39;2;13;173;Cousance;1300;25;1325
27;Bourgogne-Franche-Comté;39;3;16;174;Coyrière;65;0;65
27;Bourgogne-Franche-Comté;39;3;09;175;Coyron;72;7;79
27;Bourgogne-Franche-Comté;39;1;10;176;Cramans;526;8;534
27;Bourgogne-Franche-Comté;39;2;12;177;Hauteroche;969;24;993
27;Bourgogne-Franche-Comté;39;2;15;178;Crans;73;1;74
27;Bourgogne-Franche-Comté;39;3;09;179;Crenans;237;5;242
27;Bourgogne-Franche-Comté;39;2;13;180;Cressia;253;120;373
27;Bourgogne-Franche-Comté;39;1;06;182;Crissey;677;25;702
27;Bourgogne-Franche-Comté;39;2;04;183;Crotenay;630;80;710
27;Bourgogne-Franche-Comté;39;3;09;184;Les Crozets;194;5;199
27;Bourgogne-Franche-Comté;39;2;13;185;Cuisia;390;12;402
27;Bourgogne-Franche-Comté;39;2;15;187;Cuvier;270;7;277
27;Bourgogne-Franche-Comté;39;1;02;188;Dammartin-Marpain;345;4;349
27;Bourgogne-Franche-Comté;39;1;06;189;Damparis;2629;79;2708
27;Bourgogne-Franche-Comté;39;1;10;190;Dampierre;1293;28;1321
27;Bourgogne-Franche-Comté;39;1;03;191;Darbonnay;85;5;90
27;Bourgogne-Franche-Comté;39;2;15;192;Denezières;72;1;73
27;Bourgogne-Franche-Comté;39;1;17;193;Le Deschaux;1012;17;1029
27;Bourgogne-Franche-Comté;39;2;03;194;Desnes;481;6;487
27;Bourgogne-Franche-Comté;39;2;03;196;Les Deux-Fays;114;2;116
27;Bourgogne-Franche-Comté;39;2;13;197;Digna;359;11;370
27;Bourgogne-Franche-Comté;39;1;98;198;Dole;23711;893;24604
27;Bourgogne-Franche-Comté;39;2;12;199;Domblans;1232;30;1262
27;Bourgogne-Franche-Comté;39;2;09;200;Dompierre-sur-Mont;219;7;226
27;Bourgogne-Franche-Comté;39;2;15;201;Doucier;281;39;320
27;Bourgogne-Franche-Comté;39;1;01;202;Dournon;139;1;140
27;Bourgogne-Franche-Comté;39;2;15;203;Doye;104;2;106
27;Bourgogne-Franche-Comté;39;2;09;204;Dramelay;29;3;32
27;Bourgogne-Franche-Comté;39;1;02;205;Éclans-Nenon;382;8;390
27;Bourgogne-Franche-Comté;39;1;10;206;Écleux;228;10;238
27;Bourgogne-Franche-Comté;39;2;09;207;Écrille;78;3;81
27;Bourgogne-Franche-Comté;39;2;15;208;Entre-deux-Monts;136;8;144
27;Bourgogne-Franche-Comté;39;2;13;209;Val-d'Épy;325;7;332
27;Bourgogne-Franche-Comté;39;2;04;210;Équevillon;582;14;596
27;Bourgogne-Franche-Comté;39;1;17;211;Les Essards-Taignevaux;256;3;259
27;Bourgogne-Franche-Comté;39;2;15;214;Esserval-Tartre;122;3;125
27;Bourgogne-Franche-Comté;39;3;09;216;Étival;310;11;321
27;Bourgogne-Franche-Comté;39;2;07;217;L'Étoile;565;14;579
27;Bourgogne-Franche-Comté;39;1;10;218;Étrepigney;427;6;433
27;Bourgogne-Franche-Comté;39;1;10;219;Évans;657;12;669
27;Bourgogne-Franche-Comté;39;1;02;220;Falletans;401;9;410
27;Bourgogne-Franche-Comté;39;2;15;221;La Favière;31;1;32
27;Bourgogne-Franche-Comté;39;1;12;222;Fay-en-Montagne;82;7;89
27;Bourgogne-Franche-Comté;39;1;01;223;La Ferté;197;2;199
27;Bourgogne-Franche-Comté;39;1;12;225;Le Fied;195;6;201
27;Bourgogne-Franche-Comté;39;2;15;227;Foncine-le-Bas;189;7;196
27;Bourgogne-Franche-Comté;39;2;15;228;Foncine-le-Haut;1081;28;1109
27;Bourgogne-Franche-Comté;39;2;03;229;Fontainebrux;203;10;213
27;Bourgogne-Franche-Comté;39;2;15;230;Fontenu;75;3;78
27;Bourgogne-Franche-Comté;39;3;15;232;Fort-du-Plasne;442;11;453
27;Bourgogne-Franche-Comté;39;1;05;233;Foucherans;2266;40;2306
27;Bourgogne-Franche-Comté;39;2;03;234;Foulenay;79;0;79
27;Bourgogne-Franche-Comté;39;1;10;235;Fraisans;1192;14;1206
27;Bourgogne-Franche-Comté;39;2;03;236;Francheville;59;1;60
27;Bourgogne-Franche-Comté;39;2;15;237;Fraroz;51;4;55
27;Bourgogne-Franche-Comté;39;1;02;238;Frasne-les-Meulières;110;7;117
27;Bourgogne-Franche-Comté;39;2;15;239;La Frasnée;39;2;41
27;Bourgogne-Franche-Comté;39;2;15;240;Le Frasnois;167;5;172
27;Bourgogne-Franche-Comté;39;2;08;241;Frébuans;375;9;384
27;Bourgogne-Franche-Comté;39;2;12;244;Frontenay;159;5;164
27;Bourgogne-Franche-Comté;39;1;17;245;Gatey;360;9;369
27;Bourgogne-Franche-Comté;39;1;02;246;Gendrey;425;13;438
27;Bourgogne-Franche-Comté;39;2;09;247;Genod;72;2;74
27;Bourgogne-Franche-Comté;39;1;01;248;Geraise;44;0;44
27;Bourgogne-Franche-Comté;39;1;10;249;Germigney;76;4;80
27;Bourgogne-Franche-Comté;39;2;08;250;Geruge;172;7;179
27;Bourgogne-Franche-Comté;39;2;08;251;Gevingey;452;95;547
27;Bourgogne-Franche-Comté;39;1;06;252;Gevry;706;10;716
27;Bourgogne-Franche-Comté;39;2;13;253;Gigny;276;8;284
27;Bourgogne-Franche-Comté;39;2;15;254;Gillois;137;6;143
27;Bourgogne-Franche-Comté;39;2;13;255;Gizia;232;4;236
27;Bourgogne-Franche-Comté;39;3;15;258;Grande-Rivière Château;626;19;645
27;Bourgogne-Franche-Comté;39;1;10;259;Grange-de-Vaivre;32;1;33
27;Bourgogne-Franche-Comté;39;2;13;261;Graye-et-Charnay;141;2;143
27;Bourgogne-Franche-Comté;39;1;02;262;Gredisans;135;1;136
27;Bourgogne-Franche-Comté;39;1;03;263;Grozon;396;14;410
27;Bourgogne-Franche-Comté;39;2;15;265;Hautecour;197;4;201
27;Bourgogne-Franche-Comté;39;1;17;266;Les Hays;344;2;346
27;Bourgogne-Franche-Comté;39;1;01;267;Ivory;103;1;104
27;Bourgogne-Franche-Comté;39;1;01;268;Ivrey;58;1;59
27;Bourgogne-Franche-Comté;39;3;09;269;Jeurre;269;1;270
27;Bourgogne-Franche-Comté;39;1;02;270;Jouhe;546;62;608
27;Bourgogne-Franche-Comté;39;3;15;271;Lac-des-Rouges-Truites;394;17;411
27;Bourgogne-Franche-Comté;39;2;12;272;Ladoye-sur-Seille;49;3;52
27;Bourgogne-Franche-Comté;39;2;13;273;Montlainsia;241;7;248
27;Bourgogne-Franche-Comté;39;3;16;274;Lajoux;285;13;298
27;Bourgogne-Franche-Comté;39;3;16;275;Lamoura;647;17;664
27;Bourgogne-Franche-Comté;39;2;04;277;Le Larderet;60;1;61
27;Bourgogne-Franche-Comté;39;2;15;278;Largillay-Marsonnay;143;2;145
27;Bourgogne-Franche-Comté;39;2;03;279;Larnaud;606;13;619
27;Bourgogne-Franche-Comté;39;3;16;280;Larrivoire;101;2;103
27;Bourgogne-Franche-Comté;39;2;04;281;Le Latet;85;2;87
27;Bourgogne-Franche-Comté;39;2;15;282;La Latette;80;2;82
27;Bourgogne-Franche-Comté;39;3;16;283;Lavancia-Epercy;629;18;647
27;Bourgogne-Franche-Comté;39;1;02;284;Lavangeot;142;2;144
27;Bourgogne-Franche-Comté;39;1;02;285;Lavans-lès-Dole;328;8;336
27;Bourgogne-Franche-Comté;39;3;16;286;Lavans-lès-Saint-Claude;2352;108;2460
27;Bourgogne-Franche-Comté;39;2;12;288;Lavigny;385;5;390
27;Bourgogne-Franche-Comté;39;3;09;289;Lect;350;7;357
27;Bourgogne-Franche-Comté;39;2;09;290;Valzin en Petite Montagne;476;17;493
27;Bourgogne-Franche-Comté;39;1;01;291;Lemuy;240;5;245
27;Bourgogne-Franche-Comté;39;2;04;292;Lent;154;4;158
27;Bourgogne-Franche-Comté;39;3;14;293;Leschères;207;4;211
27;Bourgogne-Franche-Comté;39;2;13;295;Loisia;167;1;168
27;Bourgogne-Franche-Comté;39;2;03;296;Lombard;215;5;220
27;Bourgogne-Franche-Comté;39;3;11;297;Longchaumois;1143;32;1175
27;Bourgogne-Franche-Comté;39;2;15;298;Longcochon;60;3;63
27;Bourgogne-Franche-Comté;39;1;17;299;Longwy-sur-le-Doubs;491;10;501
27;Bourgogne-Franche-Comté;39;2;99;300;Lons-le-Saunier;17189;810;17999
27;Bourgogne-Franche-Comté;39;2;04;301;Loulle;171;4;175
27;Bourgogne-Franche-Comté;39;1;02;302;Louvatange;94;4;98
27;Bourgogne-Franche-Comté;39;2;12;304;Le Louverot;222;9;231
27;Bourgogne-Franche-Comté;39;1;10;305;La Loye;562;10;572
27;Bourgogne-Franche-Comté;39;2;08;306;Macornay;955;36;991
27;Bourgogne-Franche-Comté;39;3;09;307;Maisod;332;10;342
27;Bourgogne-Franche-Comté;39;1;02;308;Malange;318;7;325
27;Bourgogne-Franche-Comté;39;2;03;310;Mantry;470;13;483
27;Bourgogne-Franche-Comté;39;2;09;312;Marigna-sur-Valouse;111;4;115
27;Bourgogne-Franche-Comté;39;2;15;313;Marigny;213;1;214
27;Bourgogne-Franche-Comté;39;2;09;314;Marnézia;80;4;84
27;Bourgogne-Franche-Comté;39;1;01;315;Marnoz;396;22;418
27;Bourgogne-Franche-Comté;39;2;12;317;La Marre;352;15;367
27;Bourgogne-Franche-Comté;39;3;09;318;Martigna;192;13;205
27;Bourgogne-Franche-Comté;39;1;01;319;Mathenay;144;1;145
27;Bourgogne-Franche-Comté;39;2;13;320;Maynal;334;1;335
27;Bourgogne-Franche-Comté;39;2;12;321;Menétru-le-Vignoble;157;2;159
27;Bourgogne-Franche-Comté;39;2;15;322;Menétrux-en-Joux;53;2;55
27;Bourgogne-Franche-Comté;39;1;02;323;Menotey;312;14;326
27;Bourgogne-Franche-Comté;39;2;09;324;Mérona;7;0;7
27;Bourgogne-Franche-Comté;39;1;01;325;Mesnay;577;15;592
27;Bourgogne-Franche-Comté;39;2;15;326;Mesnois;177;4;181
27;Bourgogne-Franche-Comté;39;2;08;327;Messia-sur-Sorne;847;13;860
27;Bourgogne-Franche-Comté;39;3;09;328;Meussia;421;7;428
27;Bourgogne-Franche-Comté;39;2;15;329;Mièges;172;3;175
27;Bourgogne-Franche-Comté;39;1;03;330;Miéry;152;5;157
27;Bourgogne-Franche-Comté;39;2;15;331;Mignovillard;828;26;854
27;Bourgogne-Franche-Comté;39;3;09;333;Moirans-en-Montagne;2120;113;2233
27;Bourgogne-Franche-Comté;39;2;08;334;Moiron;127;5;132
27;Bourgogne-Franche-Comté;39;1;02;335;Moissey;567;11;578
27;Bourgogne-Franche-Comté;39;1;12;336;Molain;110;4;114
27;Bourgogne-Franche-Comté;39;1;01;337;Molamboz;88;3;91
27;Bourgogne-Franche-Comté;39;1;17;338;Molay;506;6;512
27;Bourgogne-Franche-Comté;39;3;16;339;Chassal-Molinges;1123;28;1151
27;Bourgogne-Franche-Comté;39;1;03;342;Monay;123;1;124
27;Bourgogne-Franche-Comté;39;2;13;343;Monnetay;15;1;16
27;Bourgogne-Franche-Comté;39;2;04;344;Monnet-la-Ville;335;14;349
27;Bourgogne-Franche-Comté;39;1;05;345;Monnières;405;15;420
27;Bourgogne-Franche-Comté;39;2;13;346;Montagna-le-Reconduit;114;5;119
27;Bourgogne-Franche-Comté;39;2;12;348;Montaigu;417;47;464
27;Bourgogne-Franche-Comté;39;2;12;349;Montain;490;23;513
27;Bourgogne-Franche-Comté;39;1;10;350;Montbarrey;310;4;314
27;Bourgogne-Franche-Comté;39;3;09;351;Montcusel;147;7;154
27;Bourgogne-Franche-Comté;39;1;10;352;Monteplain;132;2;134
27;Bourgogne-Franche-Comté;39;2;13;353;Montfleur;166;9;175
27;Bourgogne-Franche-Comté;39;1;03;354;Montholier;367;3;370
27;Bourgogne-Franche-Comté;39;1;01;355;Montigny-lès-Arsures;238;8;246
27;Bourgogne-Franche-Comté;39;2;04;356;Montigny-sur-l'Ain;207;8;215
27;Bourgogne-Franche-Comté;39;1;01;359;Montmarlon;32;1;33
27;Bourgogne-Franche-Comté;39;1;02;360;Montmirey-la-Ville;171;2;173
27;Bourgogne-Franche-Comté;39;1;02;361;Montmirey-le-Château;195;5;200
27;Bourgogne-Franche-Comté;39;2;07;362;Montmorot;3082;331;3413
27;Bourgogne-Franche-Comté;39;2;13;363;Montrevel;84;1;85
27;Bourgogne-Franche-Comté;39;2;04;364;Montrond;491;14;505
27;Bourgogne-Franche-Comté;39;1;10;365;Mont-sous-Vaudrey;1275;22;1297
27;Bourgogne-Franche-Comté;39;2;04;366;Mont-sur-Monnet;242;6;248
27;Bourgogne-Franche-Comté;39;3;11;367;Morbier;2263;82;2345
27;Bourgogne-Franche-Comté;39;3;11;368;Hauts de Bienne;5275;270;5545
27;Bourgogne-Franche-Comté;39;1;10;370;Mouchard;1070;313;1383
27;Bourgogne-Franche-Comté;39;2;15;372;Mournans-Charbonny;87;9;96
27;Bourgogne-Franche-Comté;39;3;16;373;Les Moussières;160;4;164
27;Bourgogne-Franche-Comté;39;2;09;375;Moutonne;129;0;129
27;Bourgogne-Franche-Comté;39;2;04;376;Moutoux;74;2;76
27;Bourgogne-Franche-Comté;39;1;02;377;Mutigney;173;8;181
27;Bourgogne-Franche-Comté;39;2;13;378;Les Trois-Châteaux;765;15;780
27;Bourgogne-Franche-Comté;39;2;03;379;Nance;525;11;536
27;Bourgogne-Franche-Comté;39;2;09;380;Nancuise;46;2;48
27;Bourgogne-Franche-Comté;39;2;04;381;Les Nans;96;3;99
27;Bourgogne-Franche-Comté;39;1;17;385;Neublans-Abergement;541;5;546
27;Bourgogne-Franche-Comté;39;1;03;386;Neuvilley;89;0;89
27;Bourgogne-Franche-Comté;39;1;10;387;Nevy-lès-Dole;291;6;297
27;Bourgogne-Franche-Comté;39;2;12;388;Nevy-sur-Seille;196;8;204
27;Bourgogne-Franche-Comté;39;2;04;389;Ney;589;14;603
27;Bourgogne-Franche-Comté;39;2;12;390;Nogna;296;12;308
27;Bourgogne-Franche-Comté;39;2;15;391;Nozeroy;408;12;420
27;Bourgogne-Franche-Comté;39;1;02;392;Offlanges;194;3;197
27;Bourgogne-Franche-Comté;39;2;15;393;Onglières;63;2;65
27;Bourgogne-Franche-Comté;39;2;09;394;Onoz;71;4;75
27;Bourgogne-Franche-Comté;39;1;10;396;Orchamps;1134;16;1150
27;Bourgogne-Franche-Comté;39;2;09;397;Orgelet;1606;45;1651
27;Bourgogne-Franche-Comté;39;1;02;398;Ougney;395;3;398
27;Bourgogne-Franche-Comté;39;1;10;399;Ounans;349;8;357
27;Bourgogne-Franche-Comté;39;1;10;400;Our;144;2;146
27;Bourgogne-Franche-Comté;39;1;03;401;Oussières;238;5;243
27;Bourgogne-Franche-Comté;39;1;02;402;Pagney;319;7;326
27;Bourgogne-Franche-Comté;39;1;10;403;Pagnoz;220;5;225
27;Bourgogne-Franche-Comté;39;2;12;404;Pannessières;488;10;498
27;Bourgogne-Franche-Comté;39;1;06;405;Parcey;999;21;1020
27;Bourgogne-Franche-Comté;39;2;04;406;Le Pasquier;262;3;265
27;Bourgogne-Franche-Comté;39;2;03;407;Passenans;335;6;341
27;Bourgogne-Franche-Comté;39;2;15;408;Patornay;149;6;155
27;Bourgogne-Franche-Comté;39;1;02;409;Peintre;133;1;134
27;Bourgogne-Franche-Comté;39;2;12;411;Perrigny;1515;46;1561
27;Bourgogne-Franche-Comté;39;1;17;412;Peseux;320;2;322
27;Bourgogne-Franche-Comté;39;3;16;413;La Pesse;334;7;341
27;Bourgogne-Franche-Comté;39;1;17;415;Petit-Noir;1095;10;1105
27;Bourgogne-Franche-Comté;39;1;12;418;Picarreau;98;2;100
27;Bourgogne-Franche-Comté;39;2;04;419;Pillemoine;62;1;63
27;Bourgogne-Franche-Comté;39;2;09;420;Pimorin;209;3;212
27;Bourgogne-Franche-Comté;39;2;12;421;Le Pin;238;15;253
27;Bourgogne-Franche-Comté;39;2;12;422;Plainoiseau;528;13;541
27;Bourgogne-Franche-Comté;39;2;09;423;Plaisia;106;9;115
27;Bourgogne-Franche-Comté;39;2;15;424;Les Planches-en-Montagne;161;3;164
27;Bourgogne-Franche-Comté;39;1;01;425;Les Planches-près-Arbois;89;1;90
27;Bourgogne-Franche-Comté;39;1;03;426;Plasne;212;10;222
27;Bourgogne-Franche-Comté;39;2;15;427;Plénise;62;0;62
27;Bourgogne-Franche-Comté;39;2;15;428;Plénisette;23;3;26
27;Bourgogne-Franche-Comté;39;1;17;429;Pleure;440;3;443
27;Bourgogne-Franche-Comté;39;1;10;430;Plumont;105;2;107
27;Bourgogne-Franche-Comté;39;2;12;431;Poids-de-Fiole;335;4;339
27;Bourgogne-Franche-Comté;39;1;02;432;Pointre;127;1;128
27;Bourgogne-Franche-Comté;39;1;12;434;Poligny;4003;362;4365
27;Bourgogne-Franche-Comté;39;2;15;435;Pont-de-Poitte;630;22;652
27;Bourgogne-Franche-Comté;39;1;01;436;Pont-d'Héry;230;8;238
27;Bourgogne-Franche-Comté;39;2;04;437;Pont-du-Navoy;274;5;279
27;Bourgogne-Franche-Comté;39;1;10;439;Port-Lesney;524;12;536
27;Bourgogne-Franche-Comté;39;3;11;441;Prémanon;1200;31;1231
27;Bourgogne-Franche-Comté;39;2;09;443;Présilly;123;5;128
27;Bourgogne-Franche-Comté;39;1;01;444;Pretin;61;2;63
27;Bourgogne-Franche-Comté;39;2;12;445;Publy;283;15;298
27;Bourgogne-Franche-Comté;39;1;01;446;Pupillin;244;3;247
27;Bourgogne-Franche-Comté;39;2;03;447;Quintigny;253;6;259
27;Bourgogne-Franche-Comté;39;1;17;448;Rahon;477;15;492
27;Bourgogne-Franche-Comté;39;1;02;449;Rainans;266;10;276
27;Bourgogne-Franche-Comté;39;1;10;451;Ranchot;504;4;508
27;Bourgogne-Franche-Comté;39;1;10;452;Rans;532;7;539
27;Bourgogne-Franche-Comté;39;3;14;453;Ravilloles;453;12;465
27;Bourgogne-Franche-Comté;39;2;03;454;Recanoz;91;2;93
27;Bourgogne-Franche-Comté;39;2;09;455;Reithouse;55;1;56
27;Bourgogne-Franche-Comté;39;2;03;456;Relans;342;4;346
27;Bourgogne-Franche-Comté;39;2;03;457;Les Repôts;54;0;54
27;Bourgogne-Franche-Comté;39;2;12;458;Revigny;243;12;255
27;Bourgogne-Franche-Comté;39;3;14;460;La Rixouse;193;8;201
27;Bourgogne-Franche-Comté;39;2;15;461;Rix;82;0;82
27;Bourgogne-Franche-Comté;39;1;02;462;Rochefort-sur-Nenon;677;5;682
27;Bourgogne-Franche-Comté;39;3;16;463;Rogna;230;6;236
27;Bourgogne-Franche-Comté;39;1;02;464;Romain;210;6;216
27;Bourgogne-Franche-Comté;39;1;02;465;Romange;201;2;203
27;Bourgogne-Franche-Comté;39;2;13;466;Rosay;123;0;123
27;Bourgogne-Franche-Comté;39;2;13;467;Rotalier;156;6;162
27;Bourgogne-Franche-Comté;39;2;09;468;Rothonay;138;4;142
27;Bourgogne-Franche-Comté;39;1;02;469;Rouffange;113;2;115
27;Bourgogne-Franche-Comté;39;3;11;470;Les Rousses;3648;82;3730
27;Bourgogne-Franche-Comté;39;2;03;471;Ruffey-sur-Seille;747;17;764
27;Bourgogne-Franche-Comté;39;2;03;472;Rye;213;4;217
27;Bourgogne-Franche-Comté;39;2;15;473;Saffloz;90;2;92
27;Bourgogne-Franche-Comté;39;2;13;474;Sainte-Agnès;355;10;365
27;Bourgogne-Franche-Comté;39;2;13;475;Saint-Amour;2392;100;2492
27;Bourgogne-Franche-Comté;39;1;17;476;Saint-Aubin;1814;43;1857
27;Bourgogne-Franche-Comté;39;1;17;477;Saint-Baraing;260;5;265
27;Bourgogne-Franche-Comté;39;3;14;478;Saint-Claude;8985;240;9225
27;Bourgogne-Franche-Comté;39;1;01;479;Saint-Cyr-Montmalin;241;6;247
27;Bourgogne-Franche-Comté;39;2;07;480;Saint-Didier;260;15;275
27;Bourgogne-Franche-Comté;39;2;04;481;Saint-Germain-en-Montagne;389;9;398
27;Bourgogne-Franche-Comté;39;2;13;485;Val Suran;787;13;800
27;Bourgogne-Franche-Comté;39;2;03;486;Saint-Lamain;115;4;119
27;Bourgogne-Franche-Comté;39;3;15;487;Saint-Laurent-en-Grandvaux;1812;36;1848
27;Bourgogne-Franche-Comté;39;1;03;489;Saint-Lothain;461;11;472
27;Bourgogne-Franche-Comté;39;1;17;490;Saint-Loup;249;7;256
27;Bourgogne-Franche-Comté;39;3;16;491;Coteaux du Lizon;2260;94;2354
27;Bourgogne-Franche-Comté;39;2;12;492;Saint-Maur;236;3;239
27;Bourgogne-Franche-Comté;39;2;15;493;Saint-Maurice-Crillat;235;2;237
27;Bourgogne-Franche-Comté;39;3;15;494;Saint-Pierre;359;21;380
27;Bourgogne-Franche-Comté;39;1;01;495;Saint-Thiébaud;66;0;66
27;Bourgogne-Franche-Comté;39;1;01;497;Saizenay;93;2;95
27;Bourgogne-Franche-Comté;39;1;10;498;Salans;602;12;614
27;Bourgogne-Franche-Comté;39;1;02;499;Saligney;194;3;197
27;Bourgogne-Franche-Comté;39;1;01;500;Salins-les-Bains;2551;149;2700
27;Bourgogne-Franche-Comté;39;1;05;501;Sampans;1200;12;1212
27;Bourgogne-Franche-Comté;39;1;10;502;Santans;281;7;288
27;Bourgogne-Franche-Comté;39;2;04;503;Sapois;385;15;400
27;Bourgogne-Franche-Comté;39;2;09;504;Sarrogna;224;9;233
27;Bourgogne-Franche-Comté;39;2;15;505;Saugeot;61;3;64
27;Bourgogne-Franche-Comté;39;1;17;507;Séligney;79;1;80
27;Bourgogne-Franche-Comté;39;2;03;508;Sellières;719;10;729
27;Bourgogne-Franche-Comté;39;3;16;510;Septmoncel les Molunes;800;24;824
27;Bourgogne-Franche-Comté;39;2;03;511;Sergenaux;63;3;66
27;Bourgogne-Franche-Comté;39;2;03;512;Sergenon;49;1;50
27;Bourgogne-Franche-Comté;39;1;02;513;Sermange;236;1;237
27;Bourgogne-Franche-Comté;39;1;02;514;Serre-les-Moulières;189;11;200
27;Bourgogne-Franche-Comté;39;2;04;517;Sirod;517;20;537
27;Bourgogne-Franche-Comté;39;2;15;518;Songeson;70;1;71
27;Bourgogne-Franche-Comté;39;2;15;519;Soucia;177;6;183
27;Bourgogne-Franche-Comté;39;1;10;520;Souvans;478;5;483
27;Bourgogne-Franche-Comté;39;2;04;522;Supt;103;2;105
27;Bourgogne-Franche-Comté;39;2;04;523;Syam;189;8;197
27;Bourgogne-Franche-Comté;39;1;17;525;Tassenières;395;7;402
27;Bourgogne-Franche-Comté;39;1;17;526;Tavaux;3957;97;4054
27;Bourgogne-Franche-Comté;39;1;02;527;Taxenne;118;1;119
27;Bourgogne-Franche-Comté;39;1;02;528;Thervay;384;7;391
27;Bourgogne-Franche-Comté;39;1;01;529;Thésy;65;1;66
27;Bourgogne-Franche-Comté;39;2;09;530;Thoirette-Coisia;855;24;879
27;Bourgogne-Franche-Comté;39;2;15;531;Thoiria;185;5;190
27;Bourgogne-Franche-Comté;39;2;13;532;Thoissia;39;1;40
27;Bourgogne-Franche-Comté;39;2;03;533;Toulouse-le-Château;217;6;223
27;Bourgogne-Franche-Comté;39;2;09;534;La Tour-du-Meix;245;4;249
27;Bourgogne-Franche-Comté;39;1;03;535;Tourmont;462;16;478
27;Bourgogne-Franche-Comté;39;2;08;537;Trenal;456;12;468
27;Bourgogne-Franche-Comté;39;2;15;538;Uxelles;59;1;60
27;Bourgogne-Franche-Comté;39;1;01;539;Vadans;286;7;293
27;Bourgogne-Franche-Comté;39;2;04;540;Valempoulières;191;11;202
27;Bourgogne-Franche-Comté;39;2;04;543;Vannoz;216;8;224
27;Bourgogne-Franche-Comté;39;2;04;545;Le Vaudioux;173;7;180
27;Bourgogne-Franche-Comté;39;1;10;546;Vaudrey;354;13;367
27;Bourgogne-Franche-Comté;39;3;16;547;Vaux-lès-Saint-Claude;682;18;700
27;Bourgogne-Franche-Comté;39;1;12;548;Vaux-sur-Poligny;74;5;79
27;Bourgogne-Franche-Comté;39;2;12;550;Verges;193;5;198
27;Bourgogne-Franche-Comté;39;2;13;551;Véria;116;3;119
27;Bourgogne-Franche-Comté;39;2;08;552;Vernantois;303;11;314
27;Bourgogne-Franche-Comté;39;2;12;553;Le Vernois;292;10;302
27;Bourgogne-Franche-Comté;39;2;04;554;Vers-en-Montagne;230;5;235
27;Bourgogne-Franche-Comté;39;2;03;555;Vers-sous-Sellières;247;2;249
27;Bourgogne-Franche-Comté;39;2;15;556;Vertamboz;95;3;98
27;Bourgogne-Franche-Comté;39;2;09;557;Vescles;187;9;196
27;Bourgogne-Franche-Comté;39;2;12;558;Vevy;288;12;300
27;Bourgogne-Franche-Comté;39;1;10;559;La Vieille-Loye;395;4;399
27;Bourgogne-Franche-Comté;39;3;16;560;Villard-Saint-Sauveur;615;20;635
27;Bourgogne-Franche-Comté;39;3;09;561;Villards-d'Héria;391;6;397
27;Bourgogne-Franche-Comté;39;1;10;565;Villeneuve-d'Aval;85;1;86
27;Bourgogne-Franche-Comté;39;2;07;567;Villeneuve-sous-Pymont;301;9;310
27;Bourgogne-Franche-Comté;39;1;03;568;Villerserine;42;3;45
27;Bourgogne-Franche-Comté;39;1;10;569;Villers-Farlay;678;10;688
27;Bourgogne-Franche-Comté;39;1;03;570;Villers-les-Bois;215;1;216
27;Bourgogne-Franche-Comté;39;1;17;571;Villers-Robert;232;2;234
27;Bourgogne-Franche-Comté;39;1;01;572;Villette-lès-Arbois;392;7;399
27;Bourgogne-Franche-Comté;39;1;06;573;Villette-lès-Dole;775;13;788
27;Bourgogne-Franche-Comté;39;2;03;574;Villevieux;712;20;732
27;Bourgogne-Franche-Comté;39;2;03;575;Le Villey;88;0;88
27;Bourgogne-Franche-Comté;39;2;13;576;Val-Sonnette;928;34;962
27;Bourgogne-Franche-Comté;39;2;03;577;Vincent-Froideville;399;2;401
27;Bourgogne-Franche-Comté;39;3;16;579;Viry;904;42;946
27;Bourgogne-Franche-Comté;39;1;02;581;Vitreux;282;4;286
27;Bourgogne-Franche-Comté;39;2;12;582;Voiteur;770;23;793
27;Bourgogne-Franche-Comté;39;2;09;583;Vosbles-Valfin;184;6;190
27;Bourgogne-Franche-Comté;39;1;02;584;Vriange;163;2;165
27;Bourgogne-Franche-Comté;39;3;16;585;Vulvoz;22;0;22
27;Bourgogne-Franche-Comté;39;1;01;586;Aresches;30;0;30
75;Nouvelle-Aquitaine;40;2;01;001;Aire-sur-l'Adour;6189;555;6744
75;Nouvelle-Aquitaine;40;1;04;002;Amou;1569;23;1592
75;Nouvelle-Aquitaine;40;1;05;003;Angoumé;274;9;283
75;Nouvelle-Aquitaine;40;1;09;004;Angresse;2129;49;2178
75;Nouvelle-Aquitaine;40;2;02;005;Arboucave;202;3;205
75;Nouvelle-Aquitaine;40;2;13;006;Arengosse;698;7;705
75;Nouvelle-Aquitaine;40;1;04;007;Argelos;166;2;168
75;Nouvelle-Aquitaine;40;2;08;008;Argelouse;97;2;99
75;Nouvelle-Aquitaine;40;1;04;011;Arsague;334;3;337
75;Nouvelle-Aquitaine;40;2;01;012;Artassenx;259;4;263
75;Nouvelle-Aquitaine;40;2;01;013;Arthez-d'Armagnac;101;5;106
75;Nouvelle-Aquitaine;40;2;08;014;Arue;358;4;362
75;Nouvelle-Aquitaine;40;2;08;015;Arx;48;1;49
75;Nouvelle-Aquitaine;40;2;02;016;Aubagnan;253;3;256
75;Nouvelle-Aquitaine;40;2;02;017;Audignon;397;1;398
75;Nouvelle-Aquitaine;40;1;13;018;Audon;384;6;390
75;Nouvelle-Aquitaine;40;2;03;019;Aureilhan;1068;28;1096
75;Nouvelle-Aquitaine;40;2;02;020;Aurice;620;23;643
75;Nouvelle-Aquitaine;40;1;09;021;Azur;883;20;903
75;Nouvelle-Aquitaine;40;2;01;022;Bahus-Soubiran;396;14;410
75;Nouvelle-Aquitaine;40;1;04;023;Baigts;350;8;358
75;Nouvelle-Aquitaine;40;2;02;024;Banos;264;4;268
75;Nouvelle-Aquitaine;40;2;01;025;Bascons;831;31;862
75;Nouvelle-Aquitaine;40;2;02;026;Bas-Mauco;359;10;369
75;Nouvelle-Aquitaine;40;1;04;027;Bassercles;154;2;156
75;Nouvelle-Aquitaine;40;1;04;028;Bastennes;253;9;262
75;Nouvelle-Aquitaine;40;2;02;029;Bats;313;3;316
75;Nouvelle-Aquitaine;40;2;08;030;Baudignan;50;0;50
75;Nouvelle-Aquitaine;40;1;13;031;Bégaar;1185;12;1197
75;Nouvelle-Aquitaine;40;2;07;032;Belhade;207;1;208
75;Nouvelle-Aquitaine;40;2;08;033;Bélis;160;5;165
75;Nouvelle-Aquitaine;40;1;12;034;Bélus;604;13;617
75;Nouvelle-Aquitaine;40;1;06;035;Bénesse-lès-Dax;574;11;585
75;Nouvelle-Aquitaine;40;1;14;036;Bénesse-Maremne;3683;70;3753
75;Nouvelle-Aquitaine;40;2;11;037;Benquet;1832;46;1878
75;Nouvelle-Aquitaine;40;1;04;038;Bergouey;105;4;109
75;Nouvelle-Aquitaine;40;2;08;039;Betbezer-d'Armagnac;151;0;151
75;Nouvelle-Aquitaine;40;1;13;040;Beylongue;358;2;360
75;Nouvelle-Aquitaine;40;1;04;041;Beyries;128;2;130
75;Nouvelle-Aquitaine;40;1;15;042;Biarrotte;328;7;335
75;Nouvelle-Aquitaine;40;2;03;043;Bias;763;13;776
75;Nouvelle-Aquitaine;40;1;15;044;Biaudos;919;33;952
75;Nouvelle-Aquitaine;40;2;07;046;Biscarrosse;13947;345;14292
75;Nouvelle-Aquitaine;40;1;04;047;Bonnegarde;268;5;273
75;Nouvelle-Aquitaine;40;2;01;049;Bordères-et-Lamensans;394;6;400
75;Nouvelle-Aquitaine;40;2;10;050;Bostens;211;2;213
75;Nouvelle-Aquitaine;40;2;11;051;Bougue;820;25;845
75;Nouvelle-Aquitaine;40;2;01;052;Bourdalat;224;4;228
75;Nouvelle-Aquitaine;40;2;08;053;Bourriot-Bergonce;306;4;310
75;Nouvelle-Aquitaine;40;1;04;054;Brassempouy;263;6;269
75;Nouvelle-Aquitaine;40;2;11;055;Bretagne-de-Marsan;1612;29;1641
75;Nouvelle-Aquitaine;40;2;08;056;Brocas;780;22;802
75;Nouvelle-Aquitaine;40;2;01;057;Buanes;252;6;258
75;Nouvelle-Aquitaine;40;2;08;058;Cachen;227;11;238
75;Nouvelle-Aquitaine;40;1;12;059;Cagnotte;763;20;783
75;Nouvelle-Aquitaine;40;2;08;060;Callen;142;4;146
75;Nouvelle-Aquitaine;40;2;11;061;Campagne;999;26;1025
75;Nouvelle-Aquitaine;40;2;10;062;Campet-et-Lamolère;510;7;517
75;Nouvelle-Aquitaine;40;1;06;063;Candresse;812;27;839
75;Nouvelle-Aquitaine;40;2;08;064;Canenx-et-Réaut;166;2;168
75;Nouvelle-Aquitaine;40;1;14;065;Capbreton;9037;314;9351
75;Nouvelle-Aquitaine;40;1;13;066;Carcarès-Sainte-Croix;528;4;532
75;Nouvelle-Aquitaine;40;1;13;067;Carcen-Ponson;632;5;637
75;Nouvelle-Aquitaine;40;1;04;068;Cassen;585;17;602
75;Nouvelle-Aquitaine;40;1;04;069;Castaignos-Souslens;409;5;414
75;Nouvelle-Aquitaine;40;2;01;070;Castandet;398;17;415
75;Nouvelle-Aquitaine;40;1;04;071;Castelnau-Chalosse;601;43;644
75;Nouvelle-Aquitaine;40;2;02;072;Castelnau-Tursan;186;2;188
75;Nouvelle-Aquitaine;40;2;02;073;Castelner;115;2;117
75;Nouvelle-Aquitaine;40;1;04;074;Castel-Sarrazin;556;20;576
75;Nouvelle-Aquitaine;40;1;03;075;Castets;2463;27;2490
75;Nouvelle-Aquitaine;40;2;02;076;Cauna;443;7;450
75;Nouvelle-Aquitaine;40;1;12;077;Cauneille;799;17;816
75;Nouvelle-Aquitaine;40;1;04;078;Caupenne;397;8;405
75;Nouvelle-Aquitaine;40;2;02;079;Cazalis;137;5;142
75;Nouvelle-Aquitaine;40;2;01;080;Cazères-sur-l'Adour;1115;32;1147
75;Nouvelle-Aquitaine;40;2;08;081;Cère;411;6;417
75;Nouvelle-Aquitaine;40;2;01;082;Classun;258;8;266
75;Nouvelle-Aquitaine;40;2;02;083;Clèdes;123;7;130
75;Nouvelle-Aquitaine;40;1;04;084;Clermont;754;35;789
75;Nouvelle-Aquitaine;40;2;08;085;Commensacq;426;12;438
75;Nouvelle-Aquitaine;40;2;02;086;Coudures;508;9;517
75;Nouvelle-Aquitaine;40;2;08;087;Créon-d'Armagnac;361;7;368
75;Nouvelle-Aquitaine;40;1;98;088;Dax;20843;841;21684
75;Nouvelle-Aquitaine;40;1;04;089;Doazit;855;27;882
75;Nouvelle-Aquitaine;40;1;04;090;Donzacq;464;10;474
75;Nouvelle-Aquitaine;40;2;01;091;Duhort-Bachen;654;19;673
75;Nouvelle-Aquitaine;40;2;02;092;Dumes;229;6;235
75;Nouvelle-Aquitaine;40;2;08;093;Escalans;254;3;257
75;Nouvelle-Aquitaine;40;2;08;094;Escource;744;11;755
75;Nouvelle-Aquitaine;40;1;12;095;Estibeaux;701;18;719
75;Nouvelle-Aquitaine;40;2;08;096;Estigarde;104;2;106
75;Nouvelle-Aquitaine;40;2;01;097;Eugénie-les-Bains;447;10;457
75;Nouvelle-Aquitaine;40;2;02;098;Eyres-Moncube;355;13;368
75;Nouvelle-Aquitaine;40;2;02;099;Fargues;321;3;324
75;Nouvelle-Aquitaine;40;2;01;100;Le Frêche;410;2;412
75;Nouvelle-Aquitaine;40;1;12;101;Gaas;480;18;498
75;Nouvelle-Aquitaine;40;2;08;102;Gabarret;1289;246;1535
75;Nouvelle-Aquitaine;40;2;10;103;Gaillères;627;16;643
75;Nouvelle-Aquitaine;40;1;04;104;Gamarde-les-Bains;1405;34;1439
75;Nouvelle-Aquitaine;40;2;08;105;Garein;437;11;448
75;Nouvelle-Aquitaine;40;1;04;106;Garrey;210;6;216
75;Nouvelle-Aquitaine;40;2;07;108;Gastes;862;14;876
75;Nouvelle-Aquitaine;40;1;04;109;Gaujacq;431;10;441
75;Nouvelle-Aquitaine;40;2;02;110;Geaune;723;14;737
75;Nouvelle-Aquitaine;40;2;10;111;Geloux;701;16;717
75;Nouvelle-Aquitaine;40;1;04;112;Gibret;101;1;102
75;Nouvelle-Aquitaine;40;1;04;113;Goos;517;9;526
75;Nouvelle-Aquitaine;40;1;05;114;Gourbera;363;13;376
75;Nouvelle-Aquitaine;40;1;04;115;Gousse;289;10;299
75;Nouvelle-Aquitaine;40;1;13;116;Gouts;274;3;277
75;Nouvelle-Aquitaine;40;2;01;117;Grenade-sur-l'Adour;2440;82;2522
75;Nouvelle-Aquitaine;40;1;12;118;Habas;1466;25;1491
75;Nouvelle-Aquitaine;40;2;02;119;Hagetmau;4651;113;4764
75;Nouvelle-Aquitaine;40;1;12;120;Hastingues;592;17;609
75;Nouvelle-Aquitaine;40;1;04;121;Hauriet;277;5;282
75;Nouvelle-Aquitaine;40;2;02;122;Haut-Mauco;970;30;1000
75;Nouvelle-Aquitaine;40;1;05;123;Herm;1150;33;1183
75;Nouvelle-Aquitaine;40;2;08;124;Herré;141;2;143
75;Nouvelle-Aquitaine;40;1;06;125;Heugas;1352;38;1390
75;Nouvelle-Aquitaine;40;1;04;126;Hinx;1875;42;1917
75;Nouvelle-Aquitaine;40;2;01;127;Hontanx;618;4;622
75;Nouvelle-Aquitaine;40;2;02;128;Horsarrieu;694;20;714
75;Nouvelle-Aquitaine;40;1;14;129;Josse;869;27;896
75;Nouvelle-Aquitaine;40;2;02;130;Labastide-Chalosse;157;0;157
75;Nouvelle-Aquitaine;40;2;08;131;Labastide-d'Armagnac;691;5;696
75;Nouvelle-Aquitaine;40;1;12;132;Labatut;1420;25;1445
75;Nouvelle-Aquitaine;40;1;14;133;Labenne;6887;115;7002
75;Nouvelle-Aquitaine;40;2;08;134;Labouheyre;2736;44;2780
75;Nouvelle-Aquitaine;40;2;08;135;Labrit;866;8;874
75;Nouvelle-Aquitaine;40;2;02;136;Lacajunte;157;4;161
75;Nouvelle-Aquitaine;40;2;01;137;Lacquy;283;10;293
75;Nouvelle-Aquitaine;40;2;02;138;Lacrabe;281;6;287
75;Nouvelle-Aquitaine;40;2;11;139;Laglorieuse;552;15;567
75;Nouvelle-Aquitaine;40;2;08;140;Lagrange;189;3;192
75;Nouvelle-Aquitaine;40;1;04;141;Lahosse;296;4;300
75;Nouvelle-Aquitaine;40;1;13;142;Laluque;1049;21;1070
75;Nouvelle-Aquitaine;40;1;13;143;Lamothe;305;4;309
75;Nouvelle-Aquitaine;40;1;04;144;Larbey;244;9;253
75;Nouvelle-Aquitaine;40;2;01;145;Larrivière-Saint-Savin;615;23;638
75;Nouvelle-Aquitaine;40;2;01;146;Latrille;162;3;165
75;Nouvelle-Aquitaine;40;1;04;147;Laurède;371;3;374
75;Nouvelle-Aquitaine;40;2;02;148;Lauret;83;3;86
75;Nouvelle-Aquitaine;40;2;08;149;Lencouacq;376;5;381
75;Nouvelle-Aquitaine;40;1;03;150;Léon;1918;52;1970
75;Nouvelle-Aquitaine;40;1;13;151;Lesgor;431;12;443
75;Nouvelle-Aquitaine;40;2;13;152;Lesperon;1033;25;1058
75;Nouvelle-Aquitaine;40;1;13;153;Le Leuy;238;6;244
75;Nouvelle-Aquitaine;40;1;03;154;Lévignacq;310;6;316
75;Nouvelle-Aquitaine;40;1;03;155;Linxe;1502;39;1541
75;Nouvelle-Aquitaine;40;2;07;156;Liposthey;556;5;561
75;Nouvelle-Aquitaine;40;1;03;157;Lit-et-Mixe;1657;39;1696
75;Nouvelle-Aquitaine;40;2;08;158;Losse;276;3;279
75;Nouvelle-Aquitaine;40;1;04;159;Louer;310;7;317
75;Nouvelle-Aquitaine;40;1;04;160;Lourquen;180;6;186
75;Nouvelle-Aquitaine;40;2;08;161;Lubbon;86;1;87
75;Nouvelle-Aquitaine;40;2;10;162;Lucbardez-et-Bargues;581;13;594
75;Nouvelle-Aquitaine;40;2;07;163;Lüe;567;9;576
75;Nouvelle-Aquitaine;40;2;08;164;Retjons;356;1;357
75;Nouvelle-Aquitaine;40;2;08;165;Luglon;386;11;397
75;Nouvelle-Aquitaine;40;2;01;166;Lussagnet;75;1;76
75;Nouvelle-Aquitaine;40;2;08;167;Luxey;657;10;667
75;Nouvelle-Aquitaine;40;1;09;168;Magescq;2322;35;2357
75;Nouvelle-Aquitaine;40;2;08;169;Maillas;125;3;128
75;Nouvelle-Aquitaine;40;2;08;170;Maillères;235;3;238
75;Nouvelle-Aquitaine;40;2;07;171;Mano;114;3;117
75;Nouvelle-Aquitaine;40;2;02;172;Mant;266;4;270
75;Nouvelle-Aquitaine;40;1;04;173;Marpaps;139;5;144
75;Nouvelle-Aquitaine;40;2;02;174;Mauries;86;1;87
75;Nouvelle-Aquitaine;40;2;01;175;Maurrin;440;6;446
75;Nouvelle-Aquitaine;40;2;08;176;Mauvezin-d'Armagnac;89;1;90
75;Nouvelle-Aquitaine;40;1;04;177;Maylis;315;17;332
75;Nouvelle-Aquitaine;40;2;11;178;Mazerolles;628;28;656
75;Nouvelle-Aquitaine;40;1;05;179;Mées;1820;47;1867
75;Nouvelle-Aquitaine;40;1;13;180;Meilhan;1147;31;1178
75;Nouvelle-Aquitaine;40;1;09;181;Messanges;968;31;999
75;Nouvelle-Aquitaine;40;2;03;182;Mézos;828;11;839
75;Nouvelle-Aquitaine;40;1;12;183;Mimbaste;978;32;1010
75;Nouvelle-Aquitaine;40;2;03;184;Mimizan;7255;165;7420
75;Nouvelle-Aquitaine;40;2;02;185;Miramont-Sensacq;357;8;365
75;Nouvelle-Aquitaine;40;1;12;186;Misson;810;17;827
75;Nouvelle-Aquitaine;40;1;09;187;Moliets-et-Maa;1185;16;1201
75;Nouvelle-Aquitaine;40;2;02;188;Momuy;468;12;480
75;Nouvelle-Aquitaine;40;2;02;189;Monget;83;3;86
75;Nouvelle-Aquitaine;40;2;02;190;Monségur;385;11;396
75;Nouvelle-Aquitaine;40;2;02;191;Montaut;620;13;633
75;Nouvelle-Aquitaine;40;2;99;192;Mont-de-Marsan;29807;1413;31220
75;Nouvelle-Aquitaine;40;2;01;193;Montégut;75;2;77
75;Nouvelle-Aquitaine;40;1;04;194;Montfort-en-Chalosse;1183;30;1213
75;Nouvelle-Aquitaine;40;2;02;195;Montgaillard;620;13;633
75;Nouvelle-Aquitaine;40;2;02;196;Montsoué;574;11;585
75;Nouvelle-Aquitaine;40;2;13;197;Morcenx-la-Nouvelle;4987;132;5119
75;Nouvelle-Aquitaine;40;2;02;198;Morganx;173;8;181
75;Nouvelle-Aquitaine;40;1;12;199;Mouscardès;270;3;273
75;Nouvelle-Aquitaine;40;2;07;200;Moustey;674;10;684
75;Nouvelle-Aquitaine;40;1;04;201;Mugron;1343;103;1446
75;Nouvelle-Aquitaine;40;1;06;202;Narrosse;3230;74;3304
75;Nouvelle-Aquitaine;40;1;04;203;Nassiet;325;13;338
75;Nouvelle-Aquitaine;40;1;04;204;Nerbis;265;4;269
75;Nouvelle-Aquitaine;40;1;04;205;Nousse;247;8;255
75;Nouvelle-Aquitaine;40;1;12;206;Oeyregave;325;13;338
75;Nouvelle-Aquitaine;40;1;06;207;Oeyreluy;1507;207;1714
75;Nouvelle-Aquitaine;40;1;04;208;Onard;366;6;372
75;Nouvelle-Aquitaine;40;1;15;209;Ondres;5520;121;5641
75;Nouvelle-Aquitaine;40;2;13;210;Onesse-Laharie;1025;19;1044
75;Nouvelle-Aquitaine;40;1;12;211;Orist;742;18;760
75;Nouvelle-Aquitaine;40;1;12;212;Orthevielle;1002;16;1018
75;Nouvelle-Aquitaine;40;1;14;213;Orx;635;10;645
75;Nouvelle-Aquitaine;40;1;12;214;Ossages;501;5;506
75;Nouvelle-Aquitaine;40;2;13;215;Ousse-Suzan;285;8;293
75;Nouvelle-Aquitaine;40;1;04;216;Ozourt;201;2;203
75;Nouvelle-Aquitaine;40;2;07;217;Parentis-en-Born;6684;216;6900
75;Nouvelle-Aquitaine;40;2;08;218;Parleboscq;505;4;509
75;Nouvelle-Aquitaine;40;2;02;219;Payros-Cazautets;107;2;109
75;Nouvelle-Aquitaine;40;2;02;220;Pécorade;139;6;145
75;Nouvelle-Aquitaine;40;2;01;221;Perquie;338;13;351
75;Nouvelle-Aquitaine;40;1;12;222;Pey;701;22;723
75;Nouvelle-Aquitaine;40;2;02;223;Peyre;233;8;241
75;Nouvelle-Aquitaine;40;1;12;224;Peyrehorade;3648;180;3828
75;Nouvelle-Aquitaine;40;2;02;225;Philondenx;200;6;206
75;Nouvelle-Aquitaine;40;2;02;226;Pimbo;205;3;208
75;Nouvelle-Aquitaine;40;2;07;227;Pissos;1449;20;1469
75;Nouvelle-Aquitaine;40;1;04;228;Pomarez;1569;27;1596
75;Nouvelle-Aquitaine;40;2;03;229;Pontenx-les-Forges;1648;32;1680
75;Nouvelle-Aquitaine;40;1;13;230;Pontonx-sur-l'Adour;2868;97;2965
75;Nouvelle-Aquitaine;40;1;12;231;Port-de-Lanne;1154;31;1185
75;Nouvelle-Aquitaine;40;2;02;232;Poudenx;222;10;232
75;Nouvelle-Aquitaine;40;1;12;233;Pouillon;3071;81;3152
75;Nouvelle-Aquitaine;40;2;10;234;Pouydesseaux;906;28;934
75;Nouvelle-Aquitaine;40;1;04;235;Poyanne;691;11;702
75;Nouvelle-Aquitaine;40;1;04;236;Poyartin;782;20;802
75;Nouvelle-Aquitaine;40;1;04;237;Préchacq-les-Bains;764;6;770
75;Nouvelle-Aquitaine;40;2;01;238;Pujo-le-Plan;622;19;641
75;Nouvelle-Aquitaine;40;2;02;239;Puyol-Cazalet;105;3;108
75;Nouvelle-Aquitaine;40;2;01;240;Renung;517;19;536
75;Nouvelle-Aquitaine;40;2;08;242;Rimbez-et-Baudiets;104;0;104
75;Nouvelle-Aquitaine;40;1;13;243;Rion-des-Landes;3023;42;3065
75;Nouvelle-Aquitaine;40;1;05;244;Rivière-Saas-et-Gourby;1257;29;1286
75;Nouvelle-Aquitaine;40;2;08;245;Roquefort;1898;49;1947
75;Nouvelle-Aquitaine;40;2;08;246;Sabres;1165;150;1315
75;Nouvelle-Aquitaine;40;2;01;247;Saint-Agnet;179;6;185
75;Nouvelle-Aquitaine;40;1;15;248;Saint-André-de-Seignanx;1889;28;1917
75;Nouvelle-Aquitaine;40;1;04;249;Saint-Aubin;501;13;514
75;Nouvelle-Aquitaine;40;2;10;250;Saint-Avit;694;22;716
75;Nouvelle-Aquitaine;40;1;15;251;Saint-Barthélemy;419;14;433
75;Nouvelle-Aquitaine;40;2;02;252;Sainte-Colombe;636;16;652
75;Nouvelle-Aquitaine;40;2;02;253;Saint-Cricq-Chalosse;645;12;657
75;Nouvelle-Aquitaine;40;1;12;254;Saint-Cricq-du-Gave;428;11;439
75;Nouvelle-Aquitaine;40;2;01;255;Saint-Cricq-Villeneuve;474;11;485
75;Nouvelle-Aquitaine;40;1;12;256;Saint-Étienne-d'Orthe;711;17;728
75;Nouvelle-Aquitaine;40;2;07;257;Sainte-Eulalie-en-Born;1281;21;1302
75;Nouvelle-Aquitaine;40;2;01;258;Sainte-Foy;252;3;255
75;Nouvelle-Aquitaine;40;2;01;259;Saint-Gein;431;13;444
75;Nouvelle-Aquitaine;40;1;04;260;Saint-Geours-d'Auribat;420;8;428
75;Nouvelle-Aquitaine;40;1;09;261;Saint-Geours-de-Maremne;2752;49;2801
75;Nouvelle-Aquitaine;40;2;08;262;Saint-Gor;312;6;318
75;Nouvelle-Aquitaine;40;1;04;263;Saint-Jean-de-Lier;413;8;421
75;Nouvelle-Aquitaine;40;1;14;264;Saint-Jean-de-Marsacq;1699;24;1723
75;Nouvelle-Aquitaine;40;2;08;265;Saint-Julien-d'Armagnac;110;0;110
75;Nouvelle-Aquitaine;40;1;03;266;Saint-Julien-en-Born;1683;34;1717
75;Nouvelle-Aquitaine;40;2;08;267;Saint-Justin;1001;13;1014
75;Nouvelle-Aquitaine;40;1;15;268;Saint-Laurent-de-Gosse;685;22;707
75;Nouvelle-Aquitaine;40;1;12;269;Saint-Lon-les-Mines;1229;38;1267
75;Nouvelle-Aquitaine;40;2;01;270;Saint-Loubouer;442;14;456
75;Nouvelle-Aquitaine;40;1;14;271;Sainte-Marie-de-Gosse;1200;25;1225
75;Nouvelle-Aquitaine;40;1;14;272;Saint-Martin-de-Hinx;1625;39;1664
75;Nouvelle-Aquitaine;40;1;15;273;Saint-Martin-de-Seignanx;5776;131;5907
75;Nouvelle-Aquitaine;40;2;10;274;Saint-Martin-d'Oney;1383;40;1423
75;Nouvelle-Aquitaine;40;2;01;275;Saint-Maurice-sur-Adour;606;19;625
75;Nouvelle-Aquitaine;40;1;03;276;Saint-Michel-Escalus;311;8;319
75;Nouvelle-Aquitaine;40;1;06;277;Saint-Pandelon;711;49;760
75;Nouvelle-Aquitaine;40;2;03;278;Saint-Paul-en-Born;970;16;986
75;Nouvelle-Aquitaine;40;1;05;279;Saint-Paul-lès-Dax;13381;481;13862
75;Nouvelle-Aquitaine;40;2;11;280;Saint-Perdon;1725;32;1757
75;Nouvelle-Aquitaine;40;2;11;281;Saint-Pierre-du-Mont;9689;360;10049
75;Nouvelle-Aquitaine;40;2;02;282;Saint-Sever;4890;96;4986
75;Nouvelle-Aquitaine;40;1;05;283;Saint-Vincent-de-Paul;3307;225;3532
75;Nouvelle-Aquitaine;40;1;14;284;Saint-Vincent-de-Tyrosse;7734;252;7986
75;Nouvelle-Aquitaine;40;1;13;285;Saint-Yaguen;626;14;640
75;Nouvelle-Aquitaine;40;2;02;286;Samadet;1132;22;1154
75;Nouvelle-Aquitaine;40;2;07;287;Sanguinet;4431;66;4497
75;Nouvelle-Aquitaine;40;2;08;288;Sarbazan;1158;22;1180
75;Nouvelle-Aquitaine;40;2;02;289;Sarraziet;248;1;249
75;Nouvelle-Aquitaine;40;2;01;290;Sarron;108;3;111
75;Nouvelle-Aquitaine;40;1;14;291;Saubion;1734;32;1766
75;Nouvelle-Aquitaine;40;1;14;292;Saubrigues;1495;72;1567
75;Nouvelle-Aquitaine;40;1;09;293;Saubusse;1107;23;1130
75;Nouvelle-Aquitaine;40;1;06;294;Saugnac-et-Cambran;1560;32;1592
75;Nouvelle-Aquitaine;40;2;07;295;Saugnacq-et-Muret;1081;18;1099
75;Nouvelle-Aquitaine;40;1;09;296;Seignosse;3876;95;3971
75;Nouvelle-Aquitaine;40;2;08;297;Le Sen;232;3;235
75;Nouvelle-Aquitaine;40;2;02;298;Serres-Gaston;397;14;411
75;Nouvelle-Aquitaine;40;2;02;299;Serreslous-et-Arribans;192;11;203
75;Nouvelle-Aquitaine;40;1;06;300;Seyresse;964;34;998
75;Nouvelle-Aquitaine;40;1;05;301;Siest;139;2;141
75;Nouvelle-Aquitaine;40;2;08;303;Solférino;328;2;330
75;Nouvelle-Aquitaine;40;1;09;304;Soorts-Hossegor;3480;86;3566
75;Nouvelle-Aquitaine;40;2;02;305;Sorbets;196;8;204
75;Nouvelle-Aquitaine;40;1;12;306;Sorde-l'Abbaye;623;13;636
75;Nouvelle-Aquitaine;40;2;08;307;Sore;1153;23;1176
75;Nouvelle-Aquitaine;40;1;04;308;Sort-en-Chalosse;906;27;933
75;Nouvelle-Aquitaine;40;1;13;309;Souprosse;1125;19;1144
75;Nouvelle-Aquitaine;40;1;09;310;Soustons;8235;199;8434
75;Nouvelle-Aquitaine;40;1;03;311;Taller;628;13;641
75;Nouvelle-Aquitaine;40;1;15;312;Tarnos;12634;299;12933
75;Nouvelle-Aquitaine;40;1;13;313;Tartas;3225;45;3270
75;Nouvelle-Aquitaine;40;1;05;314;Tercis-les-Bains;1259;40;1299
75;Nouvelle-Aquitaine;40;1;05;315;Téthieu;773;11;784
75;Nouvelle-Aquitaine;40;1;12;316;Tilh;836;19;855
75;Nouvelle-Aquitaine;40;1;09;317;Tosse;3219;79;3298
75;Nouvelle-Aquitaine;40;1;04;318;Toulouzette;329;6;335
75;Nouvelle-Aquitaine;40;2;08;319;Trensacq;242;4;246
75;Nouvelle-Aquitaine;40;2;10;320;Uchacq-et-Parentis;598;20;618
75;Nouvelle-Aquitaine;40;2;02;321;Urgons;246;9;255
75;Nouvelle-Aquitaine;40;1;03;322;Uza;201;2;203
75;Nouvelle-Aquitaine;40;2;08;323;Vert;254;5;259
75;Nouvelle-Aquitaine;40;1;04;324;Vicq-d'Auribat;261;10;271
75;Nouvelle-Aquitaine;40;2;01;325;Vielle-Tursan;271;12;283
75;Nouvelle-Aquitaine;40;1;03;326;Vielle-Saint-Girons;1420;34;1454
75;Nouvelle-Aquitaine;40;2;08;327;Vielle-Soubiran;224;5;229
75;Nouvelle-Aquitaine;40;1;09;328;Vieux-Boucau-les-Bains;1614;22;1636
75;Nouvelle-Aquitaine;40;2;01;329;Le Vignau;484;6;490
75;Nouvelle-Aquitaine;40;1;13;330;Villenave;316;6;322
75;Nouvelle-Aquitaine;40;2;01;331;Villeneuve-de-Marsan;2436;46;2482
75;Nouvelle-Aquitaine;40;2;07;332;Ychoux;2304;55;2359
75;Nouvelle-Aquitaine;40;2;13;333;Ygos-Saint-Saturnin;1337;26;1363
75;Nouvelle-Aquitaine;40;1;06;334;Yzosse;381;13;394
24;Centre-Val de Loire;41;2;06;001;Ambloy;191;5;196
24;Centre-Val de Loire;41;3;11;002;Angé;818;23;841
24;Centre-Val de Loire;41;2;14;003;Areines;597;213;810
24;Centre-Val de Loire;41;2;06;004;Artins;265;5;270
24;Centre-Val de Loire;41;1;01;006;Autainville;446;8;454
24;Centre-Val de Loire;41;2;06;007;Authon;735;13;748
24;Centre-Val de Loire;41;1;01;008;Avaray;737;16;753
24;Centre-Val de Loire;41;1;08;009;Averdon;688;15;703
24;Centre-Val de Loire;41;2;14;010;Azé;1009;29;1038
24;Centre-Val de Loire;41;2;09;012;Baillou;209;12;221
24;Centre-Val de Loire;41;1;05;013;Bauzy;275;5;280
24;Centre-Val de Loire;41;2;09;014;Beauchêne;162;2;164
24;Centre-Val de Loire;41;3;12;016;Billy;1033;10;1043
24;Centre-Val de Loire;41;1;01;017;Binas;659;17;676
24;Centre-Val de Loire;41;1;99;018;Blois;45898;1520;47418
24;Centre-Val de Loire;41;1;01;019;Boisseau;95;2;97
24;Centre-Val de Loire;41;2;09;020;Bonneveau;459;6;465
24;Centre-Val de Loire;41;2;09;022;Bouffry;130;1;131
24;Centre-Val de Loire;41;2;09;024;Boursay;175;7;182
24;Centre-Val de Loire;41;1;05;025;Bracieux;1309;18;1327
24;Centre-Val de Loire;41;2;09;026;Brévainville;174;4;178
24;Centre-Val de Loire;41;1;01;027;Briou;145;2;147
24;Centre-Val de Loire;41;2;09;028;Busloup;468;9;477
24;Centre-Val de Loire;41;1;04;029;Candé-sur-Beuvron;1505;25;1530
24;Centre-Val de Loire;41;2;09;030;Cellé;228;3;231
24;Centre-Val de Loire;41;1;15;031;Cellettes;2652;70;2722
24;Centre-Val de Loire;41;1;04;032;Chailles;2674;79;2753
24;Centre-Val de Loire;41;1;05;034;Chambord;92;1;93
24;Centre-Val de Loire;41;1;08;035;Champigny-en-Beauce;618;15;633
24;Centre-Val de Loire;41;3;13;036;Chaon;453;7;460
24;Centre-Val de Loire;41;2;09;037;La Chapelle-Enchérie;208;4;212
24;Centre-Val de Loire;41;3;12;038;La Chapelle-Montmartin;419;11;430
24;Centre-Val de Loire;41;1;01;039;La Chapelle-Saint-Martin-en-Plaine;699;20;719
24;Centre-Val de Loire;41;1;08;040;La Chapelle-Vendômoise;799;27;826
24;Centre-Val de Loire;41;2;09;041;La Chapelle-Vicomtesse;162;3;165
24;Centre-Val de Loire;41;3;11;042;Châteauvieux;535;4;539
24;Centre-Val de Loire;41;3;11;043;Châtillon-sur-Cher;1691;32;1723
24;Centre-Val de Loire;41;3;12;044;Châtres-sur-Cher;1106;10;1116
24;Centre-Val de Loire;41;1;04;045;Chaumont-sur-Loire;1077;10;1087
24;Centre-Val de Loire;41;3;13;046;Chaumont-sur-Tharonne;1073;15;1088
24;Centre-Val de Loire;41;1;03;047;La Chaussée-Saint-Victor;4524;116;4640
24;Centre-Val de Loire;41;2;09;048;Chauvigny-du-Perche;226;4;230
24;Centre-Val de Loire;41;3;11;049;Chémery;942;13;955
24;Centre-Val de Loire;41;1;15;050;Cheverny;923;39;962
24;Centre-Val de Loire;41;3;07;051;Chissay-en-Touraine;1080;27;1107
24;Centre-Val de Loire;41;1;15;052;Chitenay;1101;34;1135
24;Centre-Val de Loire;41;2;09;053;Choue;533;5;538
24;Centre-Val de Loire;41;3;07;054;Choussy;337;5;342
24;Centre-Val de Loire;41;1;08;055;Valloire-sur-Cisse;2393;54;2447
24;Centre-Val de Loire;41;1;01;057;Conan;170;0;170
24;Centre-Val de Loire;41;1;01;058;Concriers;184;5;189
24;Centre-Val de Loire;41;3;89;059;Le Controis-en-Sologne;6723;157;6880
24;Centre-Val de Loire;41;2;09;060;Cormenon;689;12;701
24;Centre-Val de Loire;41;1;15;061;Cormeray;1550;26;1576
24;Centre-Val de Loire;41;3;07;062;Couddes;551;7;558
24;Centre-Val de Loire;41;3;11;063;Couffy;490;8;498
24;Centre-Val de Loire;41;2;06;065;Coulommiers-la-Tour;566;16;582
24;Centre-Val de Loire;41;1;01;066;Courbouzon;435;10;445
24;Centre-Val de Loire;41;1;15;067;Cour-Cheverny;2802;77;2879
24;Centre-Val de Loire;41;3;05;068;Courmemin;501;9;510
24;Centre-Val de Loire;41;1;01;069;Cour-sur-Loire;253;6;259
24;Centre-Val de Loire;41;2;06;070;Vallée-de-Ronsard;519;9;528
24;Centre-Val de Loire;41;1;05;071;Crouy-sur-Cosson;543;12;555
24;Centre-Val de Loire;41;2;06;072;Crucheray;398;17;415
24;Centre-Val de Loire;41;2;09;073;Danzé;681;17;698
24;Centre-Val de Loire;41;3;05;074;Dhuizon;1227;14;1241
24;Centre-Val de Loire;41;2;09;075;Droué;1009;8;1017
24;Centre-Val de Loire;41;1;01;077;Épiais;130;6;136
24;Centre-Val de Loire;41;2;09;078;Épuisay;824;17;841
24;Centre-Val de Loire;41;2;06;079;Les Essarts;103;0;103
24;Centre-Val de Loire;41;3;07;080;Faverolles-sur-Cher;1388;30;1418
24;Centre-Val de Loire;41;2;06;081;Faye;227;5;232
24;Centre-Val de Loire;41;3;05;083;La Ferté-Beauharnais;555;4;559
24;Centre-Val de Loire;41;3;13;084;La Ferté-Imbault;969;27;996
24;Centre-Val de Loire;41;1;05;085;La Ferté-Saint-Cyr;1055;14;1069
24;Centre-Val de Loire;41;1;05;086;Fontaines-en-Sologne;640;9;649
24;Centre-Val de Loire;41;2;09;087;Fontaine-les-Coteaux;330;5;335
24;Centre-Val de Loire;41;2;09;088;Fontaine-Raoul;234;6;240
24;Centre-Val de Loire;41;2;09;089;La Fontenelle;202;2;204
24;Centre-Val de Loire;41;2;09;090;Fortan;258;6;264
24;Centre-Val de Loire;41;1;08;091;Fossé;1309;19;1328
24;Centre-Val de Loire;41;1;08;093;Françay;271;9;280
24;Centre-Val de Loire;41;3;07;094;Fresnes;1145;37;1182
24;Centre-Val de Loire;41;2;09;095;Fréteval;1069;22;1091
24;Centre-Val de Loire;41;2;09;096;Le Gault-du-Perche;342;3;345
24;Centre-Val de Loire;41;3;12;097;Gièvres;2376;30;2406
24;Centre-Val de Loire;41;2;06;098;Gombergean;174;4;178
24;Centre-Val de Loire;41;3;12;099;Gy-en-Sologne;496;13;509
24;Centre-Val de Loire;41;2;06;100;Les Hayes;170;8;178
24;Centre-Val de Loire;41;1;08;101;Herbault;1181;36;1217
24;Centre-Val de Loire;41;2;06;102;Houssay;383;3;386
24;Centre-Val de Loire;41;2;06;103;Huisseau-en-Beauce;416;11;427
24;Centre-Val de Loire;41;1;05;104;Huisseau-sur-Cosson;2337;52;2389
24;Centre-Val de Loire;41;1;01;105;Josnes;862;19;881
24;Centre-Val de Loire;41;3;13;106;Lamotte-Beuvron;4667;61;4728
24;Centre-Val de Loire;41;2;06;107;Lancé;472;6;478
24;Centre-Val de Loire;41;1;08;108;Lancôme;123;3;126
24;Centre-Val de Loire;41;1;08;109;Landes-le-Gaulois;742;21;763
24;Centre-Val de Loire;41;3;12;110;Langon-sur-Cher;824;19;843
24;Centre-Val de Loire;41;3;12;112;Lassay-sur-Croisne;245;9;254
24;Centre-Val de Loire;41;2;06;113;Lavardin;179;8;187
24;Centre-Val de Loire;41;1;01;114;Lestiou;288;7;295
24;Centre-Val de Loire;41;2;09;115;Lignières;392;6;398
24;Centre-Val de Loire;41;2;09;116;Lisle;198;3;201
24;Centre-Val de Loire;41;3;10;118;Loreux;200;4;204
24;Centre-Val de Loire;41;1;01;119;Lorges;348;6;354
24;Centre-Val de Loire;41;2;06;120;Lunay;1253;35;1288
24;Centre-Val de Loire;41;1;01;121;La Madeleine-Villefrouin;31;0;31
24;Centre-Val de Loire;41;3;12;122;Maray;236;2;238
24;Centre-Val de Loire;41;1;01;123;Marchenoir;673;11;684
24;Centre-Val de Loire;41;2;06;124;Marcilly-en-Beauce;337;20;357
24;Centre-Val de Loire;41;3;13;125;Marcilly-en-Gault;725;15;740
24;Centre-Val de Loire;41;3;11;126;Mareuil-sur-Cher;1158;21;1179
24;Centre-Val de Loire;41;3;05;127;La Marolle-en-Sologne;336;6;342
24;Centre-Val de Loire;41;1;08;128;Marolles;715;17;732
24;Centre-Val de Loire;41;1;05;129;Maslives;716;13;729
24;Centre-Val de Loire;41;1;01;130;Maves;666;12;678
24;Centre-Val de Loire;41;2;14;131;Mazangé;833;28;861
24;Centre-Val de Loire;41;3;11;132;Méhers;322;6;328
24;Centre-Val de Loire;41;1;03;134;Menars;630;22;652
24;Centre-Val de Loire;41;3;12;135;Mennetou-sur-Cher;875;9;884
24;Centre-Val de Loire;41;1;01;136;Mer;6171;105;6276
24;Centre-Val de Loire;41;1;08;137;Mesland;571;24;595
24;Centre-Val de Loire;41;2;14;138;Meslay;312;9;321
24;Centre-Val de Loire;41;3;11;139;Meusnes;1091;11;1102
24;Centre-Val de Loire;41;3;10;140;Millançay;739;18;757
24;Centre-Val de Loire;41;2;09;141;Moisy;374;2;376
24;Centre-Val de Loire;41;1;08;142;Valencisse;2353;93;2446
24;Centre-Val de Loire;41;2;09;143;Mondoubleau;1313;53;1366
24;Centre-Val de Loire;41;1;08;144;Monteaux;735;23;758
24;Centre-Val de Loire;41;1;04;145;Monthou-sur-Bièvre;799;21;820
24;Centre-Val de Loire;41;3;07;146;Monthou-sur-Cher;959;15;974
24;Centre-Val de Loire;41;1;04;147;Les Montils;1920;43;1963
24;Centre-Val de Loire;41;1;05;148;Montlivault;1326;35;1361
24;Centre-Val de Loire;41;2;06;149;Montoire-sur-le-Loir;3721;196;3917
24;Centre-Val de Loire;41;1;05;150;Mont-près-Chambord;3311;90;3401
24;Centre-Val de Loire;41;3;07;151;Montrichard Val de Cher;3719;50;3769
24;Centre-Val de Loire;41;3;05;152;Montrieux-en-Sologne;637;13;650
24;Centre-Val de Loire;41;2;06;153;Montrouveau;153;3;156
24;Centre-Val de Loire;41;2;09;154;Morée;1083;27;1110
24;Centre-Val de Loire;41;1;01;155;Muides-sur-Loire;1235;30;1265
24;Centre-Val de Loire;41;1;01;156;Mulsans;527;14;541
24;Centre-Val de Loire;41;3;12;157;Mur-de-Sologne;1518;17;1535
24;Centre-Val de Loire;41;2;06;158;Naveil;2404;59;2463
24;Centre-Val de Loire;41;3;05;159;Neung-sur-Beuvron;1242;17;1259
24;Centre-Val de Loire;41;1;05;160;Neuvy;322;4;326
24;Centre-Val de Loire;41;3;13;161;Nouan-le-Fuzelier;2323;47;2370
24;Centre-Val de Loire;41;2;06;163;Nourray;117;2;119
24;Centre-Val de Loire;41;3;11;164;Noyers-sur-Cher;2721;32;2753
24;Centre-Val de Loire;41;3;07;166;Oisly;377;5;382
24;Centre-Val de Loire;41;1;08;167;Veuzain-sur-Loire;3452;102;3554
24;Centre-Val de Loire;41;3;12;168;Orçay;235;4;239
24;Centre-Val de Loire;41;1;01;171;Oucques La Nouvelle;1734;29;1763
24;Centre-Val de Loire;41;2;09;172;Ouzouer-le-Doyen;225;1;226
24;Centre-Val de Loire;41;1;01;173;Beauce la Romaine;3488;68;3556
24;Centre-Val de Loire;41;2;06;174;Périgny;178;7;185
24;Centre-Val de Loire;41;2;09;175;Pezou;1116;18;1134
24;Centre-Val de Loire;41;3;13;176;Pierrefitte-sur-Sauldre;754;18;772
24;Centre-Val de Loire;41;2;09;177;Le Plessis-Dorin;160;0;160
24;Centre-Val de Loire;41;1;01;178;Le Plessis-l'Échelle;63;2;65
24;Centre-Val de Loire;41;2;09;179;Le Poislay;186;1;187
24;Centre-Val de Loire;41;3;07;180;Pontlevoy;1523;176;1699
24;Centre-Val de Loire;41;3;11;181;Pouillé;800;21;821
24;Centre-Val de Loire;41;2;06;182;Pray;285;9;294
24;Centre-Val de Loire;41;2;06;184;Prunay-Cassereau;604;7;611
24;Centre-Val de Loire;41;3;12;185;Pruniers-en-Sologne;2319;55;2374
24;Centre-Val de Loire;41;2;09;186;Rahart;309;5;314
24;Centre-Val de Loire;41;2;09;187;Renay;175;4;179
24;Centre-Val de Loire;41;1;01;188;Rhodon;118;3;121
24;Centre-Val de Loire;41;1;04;189;Rilly-sur-Loire;476;6;482
24;Centre-Val de Loire;41;2;06;190;Rocé;216;7;223
24;Centre-Val de Loire;41;1;01;191;Roches;68;3;71
24;Centre-Val de Loire;41;2;06;192;Les Roches-l'Évêque;267;3;270
24;Centre-Val de Loire;41;2;09;193;Romilly;133;3;136
24;Centre-Val de Loire;41;3;10;194;Romorantin-Lanthenay;17924;471;18395
24;Centre-Val de Loire;41;3;11;195;Rougeou;152;2;154
24;Centre-Val de Loire;41;2;09;196;Ruan-sur-Egvonne;85;3;88
24;Centre-Val de Loire;41;3;11;198;Saint-Aignan;2852;90;2942
24;Centre-Val de Loire;41;2;06;199;Saint-Amand-Longpré;1204;28;1232
24;Centre-Val de Loire;41;2;14;200;Sainte-Anne;471;29;500
24;Centre-Val de Loire;41;2;06;201;Saint-Arnoult;322;3;325
24;Centre-Val de Loire;41;1;08;203;Saint-Bohaire;497;10;507
24;Centre-Val de Loire;41;1;05;204;Saint-Claude-de-Diray;1781;41;1822
24;Centre-Val de Loire;41;1;08;205;Saint-Cyr-du-Gault;175;2;177
24;Centre-Val de Loire;41;1;03;206;Saint-Denis-sur-Loire;863;26;889
24;Centre-Val de Loire;41;1;05;207;Saint-Dyé-sur-Loire;1133;20;1153
24;Centre-Val de Loire;41;1;08;208;Saint-Étienne-des-Guérets;115;4;119
24;Centre-Val de Loire;41;2;09;209;Saint-Firmin-des-Prés;814;41;855
24;Centre-Val de Loire;41;3;07;211;Saint-Georges-sur-Cher;2731;38;2769
24;Centre-Val de Loire;41;1;15;212;Saint-Gervais-la-Forêt;3174;96;3270
24;Centre-Val de Loire;41;2;06;213;Saint-Gourgon;104;5;109
24;Centre-Val de Loire;41;2;09;214;Saint-Hilaire-la-Gravelle;685;12;697
24;Centre-Val de Loire;41;2;06;215;Saint-Jacques-des-Guérets;96;2;98
24;Centre-Val de Loire;41;2;09;216;Saint-Jean-Froidmentel;560;8;568
24;Centre-Val de Loire;41;3;07;217;Saint-Julien-de-Chédon;753;15;768
24;Centre-Val de Loire;41;3;12;218;Saint-Julien-sur-Cher;764;12;776
24;Centre-Val de Loire;41;1;01;219;Saint-Laurent-des-Bois;310;3;313
24;Centre-Val de Loire;41;1;05;220;Saint-Laurent-Nouan;4337;85;4422
24;Centre-Val de Loire;41;1;01;221;Saint-Léonard-en-Beauce;646;17;663
24;Centre-Val de Loire;41;3;12;222;Saint-Loup;372;7;379
24;Centre-Val de Loire;41;1;08;223;Saint-Lubin-en-Vergonnois;760;10;770
24;Centre-Val de Loire;41;2;09;224;Saint-Marc-du-Cor;180;1;181
24;Centre-Val de Loire;41;2;06;225;Saint-Martin-des-Bois;568;11;579
24;Centre-Val de Loire;41;2;14;226;Saint-Ouen;3087;92;3179
24;Centre-Val de Loire;41;2;06;228;Saint-Rimay;292;3;295
24;Centre-Val de Loire;41;3;11;229;Saint-Romain-sur-Cher;1461;33;1494
24;Centre-Val de Loire;41;1;08;230;Saint-Sulpice-de-Pommeray;1840;55;1895
24;Centre-Val de Loire;41;3;13;231;Saint-Viâtre;1180;30;1210
24;Centre-Val de Loire;41;3;13;232;Salbris;4953;98;5051
24;Centre-Val de Loire;41;1;04;233;Sambin;900;15;915
24;Centre-Val de Loire;41;1;08;234;Santenay;288;9;297
24;Centre-Val de Loire;41;2;09;235;Sargé-sur-Braye;1026;22;1048
24;Centre-Val de Loire;41;2;06;236;Sasnières;97;3;100
24;Centre-Val de Loire;41;3;07;237;Sassay;1040;19;1059
24;Centre-Val de Loire;41;2;09;238;Savigny-sur-Braye;1976;28;2004
24;Centre-Val de Loire;41;3;11;239;Seigy;1017;23;1040
24;Centre-Val de Loire;41;3;13;241;Selles-Saint-Denis;1342;29;1371
24;Centre-Val de Loire;41;3;12;242;Selles-sur-Cher;4573;65;4638
24;Centre-Val de Loire;41;2;06;243;Selommes;814;13;827
24;Centre-Val de Loire;41;1;01;245;Séris;382;4;386
24;Centre-Val de Loire;41;1;04;246;Seur;482;18;500
24;Centre-Val de Loire;41;3;11;247;Soings-en-Sologne;1620;22;1642
24;Centre-Val de Loire;41;2;09;248;Couëtron-au-Perche;1042;23;1065
24;Centre-Val de Loire;41;3;13;249;Souesmes;1047;14;1061
24;Centre-Val de Loire;41;2;09;250;Sougé;480;7;487
24;Centre-Val de Loire;41;3;13;251;Souvigny-en-Sologne;535;8;543
24;Centre-Val de Loire;41;1;01;252;Suèvres;1595;37;1632
24;Centre-Val de Loire;41;1;01;253;Talcy;260;5;265
24;Centre-Val de Loire;41;2;09;254;Le Temple;186;7;193
24;Centre-Val de Loire;41;2;06;255;Ternay;331;6;337
24;Centre-Val de Loire;41;3;12;256;Theillay;1246;19;1265
24;Centre-Val de Loire;41;3;11;258;Thésée;1157;23;1180
24;Centre-Val de Loire;41;2;06;259;Thoré-la-Rochette;843;33;876
24;Centre-Val de Loire;41;1;05;260;Thoury;418;6;424
24;Centre-Val de Loire;41;2;06;261;Tourailles;134;3;137
24;Centre-Val de Loire;41;1;05;262;Tour-en-Sologne;1115;16;1131
24;Centre-Val de Loire;41;2;06;265;Troo;285;10;295
24;Centre-Val de Loire;41;1;04;266;Valaire;84;3;87
24;Centre-Val de Loire;41;3;07;267;Vallières-les-Grandes;940;18;958
24;Centre-Val de Loire;41;3;10;268;Veilleins;161;4;165
24;Centre-Val de Loire;41;2;14;269;Vendôme;15856;642;16498
24;Centre-Val de Loire;41;3;10;271;Vernou-en-Sologne;631;6;637
24;Centre-Val de Loire;41;1;01;273;Vievy-le-Rayé;457;7;464
24;Centre-Val de Loire;41;2;06;274;Villavard;127;0;127
24;Centre-Val de Loire;41;2;09;275;La Ville-aux-Clercs;1257;23;1280
24;Centre-Val de Loire;41;1;03;276;Villebarou;2463;80;2543
24;Centre-Val de Loire;41;2;09;277;Villebout;125;0;125
24;Centre-Val de Loire;41;2;06;278;Villechauve;260;8;268
24;Centre-Val de Loire;41;2;06;279;Villedieu-le-Château;397;5;402
24;Centre-Val de Loire;41;3;12;280;Villefranche-sur-Cher;2657;66;2723
24;Centre-Val de Loire;41;1;08;281;Villefrancœur;422;9;431
24;Centre-Val de Loire;41;3;10;282;Villeherviers;442;9;451
24;Centre-Val de Loire;41;2;06;283;Villemardy;273;4;277
24;Centre-Val de Loire;41;1;01;284;Villeneuve-Frouville;63;2;65
24;Centre-Val de Loire;41;3;05;285;Villeny;484;4;488
24;Centre-Val de Loire;41;2;06;286;Villeporcher;150;5;155
24;Centre-Val de Loire;41;2;06;287;Villerable;507;12;519
24;Centre-Val de Loire;41;1;03;288;Villerbon;810;16;826
24;Centre-Val de Loire;41;1;01;289;Villermain;391;8;399
24;Centre-Val de Loire;41;2;06;290;Villeromain;236;0;236
24;Centre-Val de Loire;41;2;06;291;Villetrun;321;4;325
24;Centre-Val de Loire;41;1;01;292;Villexanton;201;1;202
24;Centre-Val de Loire;41;2;06;293;Villiersfaux;241;5;246
24;Centre-Val de Loire;41;2;14;294;Villiers-sur-Loir;1120;58;1178
24;Centre-Val de Loire;41;1;15;295;Vineuil;8091;212;8303
24;Centre-Val de Loire;41;3;13;296;Vouzon;1466;34;1500
24;Centre-Val de Loire;41;3;13;297;Yvoy-le-Marron;760;8;768
84;Auvergne-Rhône-Alpes;42;1;20;001;Aboën;452;7;459
84;Auvergne-Rhône-Alpes;42;1;02;002;Ailleux;172;2;174
84;Auvergne-Rhône-Alpes;42;2;09;003;Ambierle;1903;47;1950
84;Auvergne-Rhône-Alpes;42;3;01;005;Andrézieux-Bouthéon;9963;150;10113
84;Auvergne-Rhône-Alpes;42;1;20;006;Apinac;406;8;414
84;Auvergne-Rhône-Alpes;42;2;03;007;Arcinges;215;5;220
84;Auvergne-Rhône-Alpes;42;2;09;008;Arcon;109;1;110
84;Auvergne-Rhône-Alpes;42;1;02;009;Arthun;528;5;533
84;Auvergne-Rhône-Alpes;42;1;01;010;Aveizieux;1665;22;1687
84;Auvergne-Rhône-Alpes;42;2;04;011;Balbigny;2840;56;2896
84;Auvergne-Rhône-Alpes;42;1;07;012;Bard;674;23;697
84;Auvergne-Rhône-Alpes;42;1;01;013;Bellegarde-en-Forez;1993;50;2043
84;Auvergne-Rhône-Alpes;42;2;03;014;Belleroche;314;8;322
84;Auvergne-Rhône-Alpes;42;2;03;015;Belmont-de-la-Loire;1477;26;1503
84;Auvergne-Rhône-Alpes;42;2;03;016;La Bénisson-Dieu;424;10;434
84;Auvergne-Rhône-Alpes;42;3;08;017;Le Bessat;455;6;461
84;Auvergne-Rhône-Alpes;42;3;08;018;Bessey;460;11;471
84;Auvergne-Rhône-Alpes;42;1;02;019;Boën-sur-Lignon;3120;72;3192
84;Auvergne-Rhône-Alpes;42;1;01;020;Boisset-lès-Montrond;1170;21;1191
84;Auvergne-Rhône-Alpes;42;1;07;021;Boisset-Saint-Priest;1252;10;1262
84;Auvergne-Rhône-Alpes;42;1;20;022;Bonson;4093;58;4151
84;Auvergne-Rhône-Alpes;42;3;08;023;Bourg-Argental;2937;56;2993
84;Auvergne-Rhône-Alpes;42;2;03;025;Boyer;198;4;202
84;Auvergne-Rhône-Alpes;42;2;03;026;Briennon;1719;39;1758
84;Auvergne-Rhône-Alpes;42;2;02;027;Bully;403;7;410
84;Auvergne-Rhône-Alpes;42;3;08;028;Burdignes;376;9;385
84;Auvergne-Rhône-Alpes;42;2;04;029;Bussières;1520;48;1568
84;Auvergne-Rhône-Alpes;42;1;02;030;Bussy-Albieux;536;3;539
84;Auvergne-Rhône-Alpes;42;3;06;031;Caloire;306;7;313
84;Auvergne-Rhône-Alpes;42;3;21;032;Cellieu;1704;24;1728
84;Auvergne-Rhône-Alpes;42;2;03;033;Le Cergne;622;24;646
84;Auvergne-Rhône-Alpes;42;1;02;034;Cervières;108;7;115
84;Auvergne-Rhône-Alpes;42;1;02;035;Cezay;210;9;219
84;Auvergne-Rhône-Alpes;42;3;21;036;Chagnon;496;17;513
84;Auvergne-Rhône-Alpes;42;1;07;037;Chalain-d'Uzore;592;23;615
84;Auvergne-Rhône-Alpes;42;1;07;038;Chalain-le-Comtal;709;14;723
84;Auvergne-Rhône-Alpes;42;1;02;039;Chalmazel-Jeansagnière;454;5;459
84;Auvergne-Rhône-Alpes;42;1;02;040;La Chamba;47;2;49
84;Auvergne-Rhône-Alpes;42;1;05;041;Chambéon;618;5;623
84;Auvergne-Rhône-Alpes;42;1;20;042;Chambles;1036;20;1056
84;Auvergne-Rhône-Alpes;42;1;01;043;Chambœuf;1791;37;1828
84;Auvergne-Rhône-Alpes;42;3;15;044;Le Chambon-Feugerolles;11948;80;12028
84;Auvergne-Rhône-Alpes;42;1;02;045;La Chambonie;39;1;40
84;Auvergne-Rhône-Alpes;42;1;02;046;Champdieu;1935;44;1979
84;Auvergne-Rhône-Alpes;42;2;09;047;Champoly;327;2;329
84;Auvergne-Rhône-Alpes;42;2;03;048;Chandon;1479;30;1509
84;Auvergne-Rhône-Alpes;42;2;09;049;Changy;654;21;675
84;Auvergne-Rhône-Alpes;42;1;07;050;La Chapelle-en-Lafaye;130;3;133
84;Auvergne-Rhône-Alpes;42;3;08;051;La Chapelle-Villars;532;14;546
84;Auvergne-Rhône-Alpes;42;2;03;052;Charlieu;3695;94;3789
84;Auvergne-Rhône-Alpes;42;3;10;053;Châteauneuf;1630;21;1651
84;Auvergne-Rhône-Alpes;42;1;02;054;Châtelneuf;346;8;354
84;Auvergne-Rhône-Alpes;42;1;05;055;Châtelus;140;8;148
84;Auvergne-Rhône-Alpes;42;3;08;056;Chavanay;2897;50;2947
84;Auvergne-Rhône-Alpes;42;1;07;058;Chazelles-sur-Lavieu;258;6;264
84;Auvergne-Rhône-Alpes;42;1;05;059;Chazelles-sur-Lyon;5423;99;5522
84;Auvergne-Rhône-Alpes;42;1;07;060;Chenereilles;527;6;533
84;Auvergne-Rhône-Alpes;42;2;09;061;Cherier;569;15;584
84;Auvergne-Rhône-Alpes;42;1;05;062;Chevrières;1164;25;1189
84;Auvergne-Rhône-Alpes;42;2;04;063;Chirassimont;399;9;408
84;Auvergne-Rhône-Alpes;42;3;08;064;Chuyer;761;30;791
84;Auvergne-Rhône-Alpes;42;1;05;065;Civens;1411;54;1465
84;Auvergne-Rhône-Alpes;42;1;05;066;Cleppé;512;12;524
84;Auvergne-Rhône-Alpes;42;3;08;067;Colombier;298;3;301
84;Auvergne-Rhône-Alpes;42;2;03;068;Combre;426;11;437
84;Auvergne-Rhône-Alpes;42;2;04;069;Commelle-Vernay;3005;93;3098
84;Auvergne-Rhône-Alpes;42;2;04;070;Cordelle;916;21;937
84;Auvergne-Rhône-Alpes;42;2;04;071;Le Coteau;6880;179;7059
84;Auvergne-Rhône-Alpes;42;1;02;072;La Côte-en-Couzan;65;1;66
84;Auvergne-Rhône-Alpes;42;1;05;073;Cottance;734;18;752
84;Auvergne-Rhône-Alpes;42;2;03;074;Coutouvre;1082;26;1108
84;Auvergne-Rhône-Alpes;42;1;01;075;Craintilleux;1363;14;1377
84;Auvergne-Rhône-Alpes;42;2;09;076;Cremeaux;907;22;929
84;Auvergne-Rhône-Alpes;42;2;04;077;Croizet-sur-Gand;307;6;313
84;Auvergne-Rhône-Alpes;42;2;09;078;Le Crozet;257;11;268
84;Auvergne-Rhône-Alpes;42;2;03;079;Cuinzier;711;12;723
84;Auvergne-Rhône-Alpes;42;1;01;081;Cuzieu;1544;20;1564
84;Auvergne-Rhône-Alpes;42;3;10;083;Dargoire;532;4;536
84;Auvergne-Rhône-Alpes;42;1;02;084;Débats-Rivière-d'Orpra;159;4;163
84;Auvergne-Rhône-Alpes;42;3;08;085;Doizieux;835;18;853
84;Auvergne-Rhône-Alpes;42;2;03;086;Écoche;523;13;536
84;Auvergne-Rhône-Alpes;42;1;07;087;Écotay-l'Olme;1224;53;1277
84;Auvergne-Rhône-Alpes;42;1;05;088;Épercieux-Saint-Paul;748;17;765
84;Auvergne-Rhône-Alpes;42;1;02;089;Essertines-en-Châtelneuf;666;29;695
84;Auvergne-Rhône-Alpes;42;1;05;090;Essertines-en-Donzy;495;12;507
84;Auvergne-Rhône-Alpes;42;1;20;091;Estivareilles;683;15;698
84;Auvergne-Rhône-Alpes;42;3;21;092;L'Étrat;2643;105;2748
84;Auvergne-Rhône-Alpes;42;3;10;093;Farnay;1379;20;1399
84;Auvergne-Rhône-Alpes;42;1;05;094;Feurs;8302;146;8448
84;Auvergne-Rhône-Alpes;42;3;06;095;Firminy;16901;188;17089
84;Auvergne-Rhône-Alpes;42;3;21;096;Fontanès;681;11;692
84;Auvergne-Rhône-Alpes;42;3;21;097;La Fouillouse;4666;64;4730
84;Auvergne-Rhône-Alpes;42;2;04;098;Fourneaux;582;14;596
84;Auvergne-Rhône-Alpes;42;3;06;099;Fraisses;3733;53;3786
84;Auvergne-Rhône-Alpes;42;1;05;100;La Gimond;278;11;289
84;Auvergne-Rhône-Alpes;42;3;08;101;Graix;143;1;144
84;Auvergne-Rhône-Alpes;42;1;05;102;Grammond;890;22;912
84;Auvergne-Rhône-Alpes;42;3;10;103;La Grand-Croix;5172;41;5213
84;Auvergne-Rhône-Alpes;42;2;03;104;La Gresle;861;20;881
84;Auvergne-Rhône-Alpes;42;1;07;105;Grézieux-le-Fromental;254;2;256
84;Auvergne-Rhône-Alpes;42;2;02;106;Grézolles;251;8;259
84;Auvergne-Rhône-Alpes;42;1;07;107;Gumières;320;9;329
84;Auvergne-Rhône-Alpes;42;1;07;108;L'Hôpital-le-Grand;1106;13;1119
84;Auvergne-Rhône-Alpes;42;1;02;109;L'Hôpital-sous-Rochefort;109;1;110
84;Auvergne-Rhône-Alpes;42;3;13;110;L'Horme;4746;42;4788
84;Auvergne-Rhône-Alpes;42;2;03;112;Jarnosse;419;8;427
84;Auvergne-Rhône-Alpes;42;1;05;113;Jas;233;6;239
84;Auvergne-Rhône-Alpes;42;3;08;115;Jonzieux;1224;15;1239
84;Auvergne-Rhône-Alpes;42;2;09;116;Juré;247;7;254
84;Auvergne-Rhône-Alpes;42;1;07;117;Lavieu;115;8;123
84;Auvergne-Rhône-Alpes;42;2;04;118;Lay;749;20;769
84;Auvergne-Rhône-Alpes;42;1;02;119;Leigneux;366;11;377
84;Auvergne-Rhône-Alpes;42;2;09;120;Lentigny;1777;40;1817
84;Auvergne-Rhône-Alpes;42;1;07;121;Lérigneux;156;2;158
84;Auvergne-Rhône-Alpes;42;1;07;122;Lézigneux;1715;79;1794
84;Auvergne-Rhône-Alpes;42;3;10;123;Lorette;4716;31;4747
84;Auvergne-Rhône-Alpes;42;3;08;124;Lupé;296;7;303
84;Auvergne-Rhône-Alpes;42;2;02;125;Luré;141;2;143
84;Auvergne-Rhône-Alpes;42;1;07;126;Luriecq;1284;30;1314
84;Auvergne-Rhône-Alpes;42;2;11;127;Mably;7653;118;7771
84;Auvergne-Rhône-Alpes;42;2;04;128;Machézal;391;8;399
84;Auvergne-Rhône-Alpes;42;3;08;129;Maclas;1819;68;1887
84;Auvergne-Rhône-Alpes;42;1;07;130;Magneux-Haute-Rive;569;10;579
84;Auvergne-Rhône-Alpes;42;2;03;131;Maizilly;332;9;341
84;Auvergne-Rhône-Alpes;42;3;08;132;Malleval;566;16;582
84;Auvergne-Rhône-Alpes;42;3;21;133;Marcenod;695;19;714
84;Auvergne-Rhône-Alpes;42;1;02;134;Marcilly-le-Châtel;1391;47;1438
84;Auvergne-Rhône-Alpes;42;1;05;135;Marclopt;530;27;557
84;Auvergne-Rhône-Alpes;42;1;02;136;Marcoux;765;32;797
84;Auvergne-Rhône-Alpes;42;1;07;137;Margerie-Chantagret;797;15;812
84;Auvergne-Rhône-Alpes;42;1;05;138;Maringes;668;12;680
84;Auvergne-Rhône-Alpes;42;3;08;139;Marlhes;1329;66;1395
84;Auvergne-Rhône-Alpes;42;1;07;140;Marols;443;8;451
84;Auvergne-Rhône-Alpes;42;2;03;141;Mars;570;11;581
84;Auvergne-Rhône-Alpes;42;1;20;142;Merle-Leignec;320;4;324
84;Auvergne-Rhône-Alpes;42;1;05;143;Mizérieux;490;5;495
84;Auvergne-Rhône-Alpes;42;2;03;145;Montagny;1083;19;1102
84;Auvergne-Rhône-Alpes;42;1;07;146;Montarcher;66;3;69
84;Auvergne-Rhône-Alpes;42;1;07;147;Montbrison;15915;623;16538
84;Auvergne-Rhône-Alpes;42;1;05;148;Montchal;504;9;513
84;Auvergne-Rhône-Alpes;42;1;01;149;Montrond-les-Bains;5342;79;5421
84;Auvergne-Rhône-Alpes;42;1;02;150;Montverdun;1393;30;1423
84;Auvergne-Rhône-Alpes;42;1;07;151;Mornand-en-Forez;413;80;493
84;Auvergne-Rhône-Alpes;42;2;03;152;Nandax;546;315;861
84;Auvergne-Rhône-Alpes;42;2;04;153;Neaux;481;12;493
84;Auvergne-Rhône-Alpes;42;2;04;154;Néronde;460;51;511
84;Auvergne-Rhône-Alpes;42;1;05;155;Nervieux;1007;23;1030
84;Auvergne-Rhône-Alpes;42;2;04;156;Neulise;1372;18;1390
84;Auvergne-Rhône-Alpes;42;2;09;157;Noailly;794;14;808
84;Auvergne-Rhône-Alpes;42;2;09;158;Les Noës;210;3;213
84;Auvergne-Rhône-Alpes;42;1;02;159;Noirétable;1571;106;1677
84;Auvergne-Rhône-Alpes;42;2;02;160;Nollieux;190;6;196
84;Auvergne-Rhône-Alpes;42;2;04;161;Notre-Dame-de-Boisset;573;19;592
84;Auvergne-Rhône-Alpes;42;2;09;162;Ouches;1154;19;1173
84;Auvergne-Rhône-Alpes;42;2;09;163;La Pacaudière;1057;20;1077
84;Auvergne-Rhône-Alpes;42;1;02;164;Palogneux;71;0;71
84;Auvergne-Rhône-Alpes;42;1;05;165;Panissières;2892;86;2978
84;Auvergne-Rhône-Alpes;42;2;04;166;Parigny;624;16;640
84;Auvergne-Rhône-Alpes;42;3;08;167;Pavezin;376;10;386
84;Auvergne-Rhône-Alpes;42;3;08;168;Pélussin;3738;100;3838
84;Auvergne-Rhône-Alpes;42;1;20;169;Périgneux;1580;27;1607
84;Auvergne-Rhône-Alpes;42;2;04;170;Perreux;2110;180;2290
84;Auvergne-Rhône-Alpes;42;2;04;171;Pinay;288;7;295
84;Auvergne-Rhône-Alpes;42;3;08;172;Planfoy;1059;24;1083
84;Auvergne-Rhône-Alpes;42;2;02;173;Pommiers-en-Forez;359;10;369
84;Auvergne-Rhône-Alpes;42;1;05;174;Poncins;1150;25;1175
84;Auvergne-Rhône-Alpes;42;1;05;175;Pouilly-lès-Feurs;1202;35;1237
84;Auvergne-Rhône-Alpes;42;2;09;176;Pouilly-les-Nonains;2172;46;2218
84;Auvergne-Rhône-Alpes;42;2;03;177;Pouilly-sous-Charlieu;2532;53;2585
84;Auvergne-Rhône-Alpes;42;2;03;178;Pradines;833;10;843
84;Auvergne-Rhône-Alpes;42;1;02;179;Pralong;858;28;886
84;Auvergne-Rhône-Alpes;42;1;07;180;Précieux;1035;99;1134
84;Auvergne-Rhône-Alpes;42;2;03;181;Régny;1512;30;1542
84;Auvergne-Rhône-Alpes;42;2;09;182;Renaison;3198;106;3304
84;Auvergne-Rhône-Alpes;42;3;15;183;La Ricamarie;7872;48;7920
84;Auvergne-Rhône-Alpes;42;2;12;184;Riorges;10848;280;11128
84;Auvergne-Rhône-Alpes;42;1;01;185;Rivas;698;20;718
84;Auvergne-Rhône-Alpes;42;3;10;186;Rive-de-Gier;14978;121;15099
84;Auvergne-Rhône-Alpes;42;2;98;187;Roanne;33809;738;34547
84;Auvergne-Rhône-Alpes;42;1;07;188;Roche;254;4;258
84;Auvergne-Rhône-Alpes;42;3;16;189;Roche-la-Molière;9884;92;9976
84;Auvergne-Rhône-Alpes;42;3;08;191;Roisey;980;33;1013
84;Auvergne-Rhône-Alpes;42;1;20;192;Rozier-Côtes-d'Aurec;433;7;440
84;Auvergne-Rhône-Alpes;42;1;05;193;Rozier-en-Donzy;1427;39;1466
84;Auvergne-Rhône-Alpes;42;2;09;194;Sail-les-Bains;201;2;203
84;Auvergne-Rhône-Alpes;42;1;02;195;Sail-sous-Couzan;972;23;995
84;Auvergne-Rhône-Alpes;42;2;04;196;Sainte-Agathe-en-Donzy;120;4;124
84;Auvergne-Rhône-Alpes;42;1;02;197;Sainte-Agathe-la-Bouteresse;1045;32;1077
84;Auvergne-Rhône-Alpes;42;2;09;198;Saint-Alban-les-Eaux;934;23;957
84;Auvergne-Rhône-Alpes;42;2;09;199;Saint-André-d'Apchon;1927;63;1990
84;Auvergne-Rhône-Alpes;42;1;01;200;Saint-André-le-Puy;1527;26;1553
84;Auvergne-Rhône-Alpes;42;3;08;201;Saint-Appolinard;689;31;720
84;Auvergne-Rhône-Alpes;42;1;05;202;Saint-Barthélemy-Lestra;688;15;703
84;Auvergne-Rhône-Alpes;42;2;09;203;Saint-Bonnet-des-Quarts;301;12;313
84;Auvergne-Rhône-Alpes;42;1;20;204;Saint-Bonnet-le-Château;1510;47;1557
84;Auvergne-Rhône-Alpes;42;1;02;205;Saint-Bonnet-le-Courreau;688;15;703
84;Auvergne-Rhône-Alpes;42;1;01;206;Saint-Bonnet-les-Oules;1669;41;1710
84;Auvergne-Rhône-Alpes;42;3;13;207;Saint-Chamond;34841;412;35253
84;Auvergne-Rhône-Alpes;42;3;21;208;Saint-Christo-en-Jarez;1903;42;1945
84;Auvergne-Rhône-Alpes;42;2;04;209;Sainte-Colombe-sur-Gand;396;11;407
84;Auvergne-Rhône-Alpes;42;3;08;210;Sainte-Croix-en-Jarez;477;7;484
84;Auvergne-Rhône-Alpes;42;1;20;211;Saint-Cyprien;2447;35;2482
84;Auvergne-Rhône-Alpes;42;2;04;212;Saint-Cyr-de-Favières;961;28;989
84;Auvergne-Rhône-Alpes;42;2;04;213;Saint-Cyr-de-Valorges;311;12;323
84;Auvergne-Rhône-Alpes;42;1;05;214;Saint-Cyr-les-Vignes;1041;29;1070
84;Auvergne-Rhône-Alpes;42;2;03;215;Saint-Denis-de-Cabanne;1260;25;1285
84;Auvergne-Rhône-Alpes;42;1;05;216;Saint-Denis-sur-Coise;673;19;692
84;Auvergne-Rhône-Alpes;42;1;02;217;Saint-Didier-sur-Rochefort;421;7;428
84;Auvergne-Rhône-Alpes;42;3;99;218;Saint-Étienne;173821;1971;175792
84;Auvergne-Rhône-Alpes;42;1;02;219;Saint-Étienne-le-Molard;1025;26;1051
84;Auvergne-Rhône-Alpes;42;2;09;220;Saint-Forgeux-Lespinasse;621;19;640
84;Auvergne-Rhône-Alpes;42;1;02;221;Sainte-Foy-Saint-Sulpice;514;15;529
84;Auvergne-Rhône-Alpes;42;1;01;222;Saint-Galmier;5826;146;5972
84;Auvergne-Rhône-Alpes;42;3;16;223;Saint-Genest-Lerpt;6123;70;6193
84;Auvergne-Rhône-Alpes;42;3;08;224;Saint-Genest-Malifaux;2918;144;3062
84;Auvergne-Rhône-Alpes;42;3;10;225;Genilac;3894;76;3970
84;Auvergne-Rhône-Alpes;42;2;02;226;Saint-Georges-de-Baroille;431;3;434
84;Auvergne-Rhône-Alpes;42;1;02;227;Saint-Georges-en-Couzan;412;10;422
84;Auvergne-Rhône-Alpes;42;1;07;228;Saint-Georges-Haute-Ville;1467;26;1493
84;Auvergne-Rhône-Alpes;42;2;03;229;Saint-Germain-la-Montagne;230;6;236
84;Auvergne-Rhône-Alpes;42;2;02;230;Saint-Germain-Laval;1608;31;1639
84;Auvergne-Rhône-Alpes;42;2;09;231;Saint-Germain-Lespinasse;1238;75;1313
84;Auvergne-Rhône-Alpes;42;2;09;232;Saint-Haon-le-Châtel;637;11;648
84;Auvergne-Rhône-Alpes;42;2;09;233;Saint-Haon-le-Vieux;954;24;978
84;Auvergne-Rhône-Alpes;42;3;21;234;Saint-Héand;3637;55;3692
84;Auvergne-Rhône-Alpes;42;1;20;235;Saint-Hilaire-Cusson-la-Valmitte;337;5;342
84;Auvergne-Rhône-Alpes;42;2;03;236;Saint-Hilaire-sous-Charlieu;529;10;539
84;Auvergne-Rhône-Alpes;42;3;18;237;Saint-Jean-Bonnefonds;6615;69;6684
84;Auvergne-Rhône-Alpes;42;1;02;238;Saint-Jean-la-Vêtre;320;11;331
84;Auvergne-Rhône-Alpes;42;2;09;239;Saint-Jean-Saint-Maurice-sur-Loire;1153;24;1177
84;Auvergne-Rhône-Alpes;42;1;07;240;Saint-Jean-Soleymieux;859;19;878
84;Auvergne-Rhône-Alpes;42;2;04;241;Saint-Jodard;390;5;395
84;Auvergne-Rhône-Alpes;42;3;10;242;Saint-Joseph;1928;29;1957
84;Auvergne-Rhône-Alpes;42;2;02;243;Saint-Julien-d'Oddes;283;5;288
84;Auvergne-Rhône-Alpes;42;1;02;245;Vêtre-sur-Anzon;585;6;591
84;Auvergne-Rhône-Alpes;42;3;08;246;Saint-Julien-Molin-Molette;1143;18;1161
84;Auvergne-Rhône-Alpes;42;1;02;247;Saint-Just-en-Bas;282;8;290
84;Auvergne-Rhône-Alpes;42;2;09;248;Saint-Just-en-Chevalet;1130;38;1168
84;Auvergne-Rhône-Alpes;42;2;04;249;Saint-Just-la-Pendue;1656;35;1691
84;Auvergne-Rhône-Alpes;42;1;05;251;Saint-Laurent-la-Conche;581;13;594
84;Auvergne-Rhône-Alpes;42;1;02;252;Saint-Laurent-Rochefort;252;2;254
84;Auvergne-Rhône-Alpes;42;2;12;253;Saint-Léger-sur-Roanne;1157;40;1197
84;Auvergne-Rhône-Alpes;42;2;04;254;Saint-Marcel-de-Félines;799;17;816
84;Auvergne-Rhône-Alpes;42;2;09;255;Saint-Marcel-d'Urfé;283;7;290
84;Auvergne-Rhône-Alpes;42;1;20;256;Saint-Marcellin-en-Forez;5001;50;5051
84;Auvergne-Rhône-Alpes;42;2;09;257;Saint-Martin-d'Estréaux;836;16;852
84;Auvergne-Rhône-Alpes;42;3;10;259;Saint-Martin-la-Plaine;3815;75;3890
84;Auvergne-Rhône-Alpes;42;2;02;260;Saint-Martin-la-Sauveté;890;59;949
84;Auvergne-Rhône-Alpes;42;1;05;261;Saint-Martin-Lestra;906;20;926
84;Auvergne-Rhône-Alpes;42;1;20;262;Saint-Maurice-en-Gourgois;1817;21;1838
84;Auvergne-Rhône-Alpes;42;1;05;264;Saint-Médard-en-Forez;980;24;1004
84;Auvergne-Rhône-Alpes;42;3;08;265;Saint-Michel-sur-Rhône;856;25;881
84;Auvergne-Rhône-Alpes;42;1;20;266;Saint-Nizier-de-Fornas;663;13;676
84;Auvergne-Rhône-Alpes;42;2;03;267;Saint-Nizier-sous-Charlieu;1696;47;1743
84;Auvergne-Rhône-Alpes;42;2;02;268;Vézelin-sur-Loire;796;9;805
84;Auvergne-Rhône-Alpes;42;1;07;269;Saint-Paul-d'Uzore;174;10;184
84;Auvergne-Rhône-Alpes;42;3;06;270;Saint-Paul-en-Cornillon;1357;31;1388
84;Auvergne-Rhône-Alpes;42;3;10;271;Saint-Paul-en-Jarez;4817;59;4876
84;Auvergne-Rhône-Alpes;42;3;08;272;Saint-Pierre-de-Bœuf;1704;38;1742
84;Auvergne-Rhône-Alpes;42;2;03;273;Saint-Pierre-la-Noaille;381;8;389
84;Auvergne-Rhône-Alpes;42;2;02;274;Saint-Polgues;257;8;265
84;Auvergne-Rhône-Alpes;42;3;18;275;Saint-Priest-en-Jarez;6106;95;6201
84;Auvergne-Rhône-Alpes;42;2;09;276;Saint-Priest-la-Prugne;430;6;436
84;Auvergne-Rhône-Alpes;42;2;04;277;Saint-Priest-la-Roche;341;1;342
84;Auvergne-Rhône-Alpes;42;1;02;278;Saint-Priest-la-Vêtre;144;1;145
84;Auvergne-Rhône-Alpes;42;1;20;279;Saint-Just-Saint-Rambert;15229;280;15509
84;Auvergne-Rhône-Alpes;42;3;08;280;Saint-Régis-du-Coin;402;11;413
84;Auvergne-Rhône-Alpes;42;2;09;281;Saint-Rirand;134;2;136
84;Auvergne-Rhône-Alpes;42;2;09;282;Saint-Romain-d'Urfé;239;5;244
84;Auvergne-Rhône-Alpes;42;3;21;283;Saint-Romain-en-Jarez;1218;28;1246
84;Auvergne-Rhône-Alpes;42;2;09;284;Saint-Romain-la-Motte;1417;59;1476
84;Auvergne-Rhône-Alpes;42;1;07;285;Saint-Romain-le-Puy;4090;64;4154
84;Auvergne-Rhône-Alpes;42;3;08;286;Saint-Romain-les-Atheux;949;15;964
84;Auvergne-Rhône-Alpes;42;3;08;287;Saint-Sauveur-en-Rue;1088;21;1109
84;Auvergne-Rhône-Alpes;42;1;02;288;Saint-Sixte;706;12;718
84;Auvergne-Rhône-Alpes;42;2;04;289;Saint-Symphorien-de-Lay;1899;36;1935
84;Auvergne-Rhône-Alpes;42;1;07;290;Saint-Thomas-la-Garde;588;22;610
84;Auvergne-Rhône-Alpes;42;2;03;293;Saint-Victor-sur-Rhins;1191;20;1211
84;Auvergne-Rhône-Alpes;42;2;04;294;Saint-Vincent-de-Boisset;974;28;1002
84;Auvergne-Rhône-Alpes;42;1;02;295;Les Salles;556;7;563
84;Auvergne-Rhône-Alpes;42;1;05;296;Salt-en-Donzy;547;16;563
84;Auvergne-Rhône-Alpes;42;1;05;297;Salvizinet;595;30;625
84;Auvergne-Rhône-Alpes;42;1;02;298;Sauvain;377;5;382
84;Auvergne-Rhône-Alpes;42;1;07;299;Savigneux;3430;74;3504
84;Auvergne-Rhône-Alpes;42;2;03;300;Sevelinges;643;13;656
84;Auvergne-Rhône-Alpes;42;1;07;301;Soleymieux;689;8;697
84;Auvergne-Rhône-Alpes;42;3;21;302;Sorbiers;7874;167;8041
84;Auvergne-Rhône-Alpes;42;2;02;303;Souternon;276;6;282
84;Auvergne-Rhône-Alpes;42;1;20;304;Sury-le-Comtal;6653;270;6923
84;Auvergne-Rhône-Alpes;42;3;21;305;La Talaudière;6977;99;7076
84;Auvergne-Rhône-Alpes;42;3;08;306;Tarentaise;483;6;489
84;Auvergne-Rhône-Alpes;42;3;10;307;Tartaras;902;32;934
84;Auvergne-Rhône-Alpes;42;3;08;308;La Terrasse-sur-Dorlay;776;8;784
84;Auvergne-Rhône-Alpes;42;3;08;310;Thélis-la-Combe;149;2;151
84;Auvergne-Rhône-Alpes;42;3;21;311;La Tour-en-Jarez;1471;37;1508
84;Auvergne-Rhône-Alpes;42;1;20;312;La Tourette;606;17;623
84;Auvergne-Rhône-Alpes;42;1;02;313;Trelins;665;8;673
84;Auvergne-Rhône-Alpes;42;2;09;314;La Tuilière;291;8;299
84;Auvergne-Rhône-Alpes;42;1;01;315;Unias;423;14;437
84;Auvergne-Rhône-Alpes;42;3;06;316;Unieux;8418;80;8498
84;Auvergne-Rhône-Alpes;42;2;09;317;Urbise;124;6;130
84;Auvergne-Rhône-Alpes;42;1;20;318;Usson-en-Forez;1487;23;1510
84;Auvergne-Rhône-Alpes;42;1;05;319;Valeille;705;11;716
84;Auvergne-Rhône-Alpes;42;3;21;320;Valfleury;707;10;717
84;Auvergne-Rhône-Alpes;42;1;02;321;La Valla-sur-Rochefort;102;1;103
84;Auvergne-Rhône-Alpes;42;3;08;322;La Valla-en-Gier;1075;26;1101
84;Auvergne-Rhône-Alpes;42;1;01;323;Veauche;8973;105;9078
84;Auvergne-Rhône-Alpes;42;1;01;324;Veauchette;1192;17;1209
84;Auvergne-Rhône-Alpes;42;2;04;325;Vendranges;376;5;381
84;Auvergne-Rhône-Alpes;42;3;08;326;Véranne;877;28;905
84;Auvergne-Rhône-Alpes;42;3;08;327;Vérin;664;14;678
84;Auvergne-Rhône-Alpes;42;1;07;328;Verrières-en-Forez;712;75;787
84;Auvergne-Rhône-Alpes;42;3;08;329;La Versanne;377;5;382
84;Auvergne-Rhône-Alpes;42;3;17;330;Villars;7942;159;8101
84;Auvergne-Rhône-Alpes;42;2;09;331;Villemontais;1022;31;1053
84;Auvergne-Rhône-Alpes;42;2;12;332;Villerest;5030;142;5172
84;Auvergne-Rhône-Alpes;42;2;03;333;Villers;589;13;602
84;Auvergne-Rhône-Alpes;42;2;04;334;Violay;1250;17;1267
84;Auvergne-Rhône-Alpes;42;1;05;335;Viricelles;442;20;462
84;Auvergne-Rhône-Alpes;42;1;05;336;Virigneux;637;20;657
84;Auvergne-Rhône-Alpes;42;2;09;337;Vivans;224;5;229
84;Auvergne-Rhône-Alpes;42;2;03;338;Vougy;1488;61;1549
84;Auvergne-Rhône-Alpes;42;2;09;339;Chausseterre;218;5;223
84;Auvergne-Rhône-Alpes;43;1;17;001;Agnat;178;4;182
84;Auvergne-Rhône-Alpes;43;2;13;002;Aiguilhe;1473;63;1536
84;Auvergne-Rhône-Alpes;43;2;11;003;Allègre;874;18;892
84;Auvergne-Rhône-Alpes;43;2;08;004;Alleyrac;119;7;126
84;Auvergne-Rhône-Alpes;43;2;18;005;Alleyras;156;3;159
84;Auvergne-Rhône-Alpes;43;1;10;006;Ally;129;2;131
84;Auvergne-Rhône-Alpes;43;3;19;007;Araules;602;17;619
84;Auvergne-Rhône-Alpes;43;2;18;008;Arlempdes;143;6;149
84;Auvergne-Rhône-Alpes;43;1;10;009;Arlet;23;0;23
84;Auvergne-Rhône-Alpes;43;2;15;010;Arsac-en-Velay;1193;29;1222
84;Auvergne-Rhône-Alpes;43;1;10;011;Aubazat;178;5;183
84;Auvergne-Rhône-Alpes;43;3;01;012;Aurec-sur-Loire;6142;83;6225
84;Auvergne-Rhône-Alpes;43;1;10;013;Vissac-Auteyrac;306;10;316
84;Auvergne-Rhône-Alpes;43;1;17;014;Autrac;56;2;58
84;Auvergne-Rhône-Alpes;43;1;07;015;Auvers;50;0;50
84;Auvergne-Rhône-Alpes;43;1;17;016;Auzon;898;22;920
84;Auvergne-Rhône-Alpes;43;1;17;017;Azérat;282;5;287
84;Auvergne-Rhône-Alpes;43;2;18;018;Bains;1376;126;1502
84;Auvergne-Rhône-Alpes;43;2;18;019;Barges;108;2;110
84;Auvergne-Rhône-Alpes;43;3;02;020;Bas-en-Basset;4377;86;4463
84;Auvergne-Rhône-Alpes;43;2;06;021;Beaulieu;1040;20;1060
84;Auvergne-Rhône-Alpes;43;1;04;022;Beaumont;276;12;288
84;Auvergne-Rhône-Alpes;43;2;11;023;Beaune-sur-Arzon;210;2;212
84;Auvergne-Rhône-Alpes;43;3;19;024;Beaux;851;13;864
84;Auvergne-Rhône-Alpes;43;3;02;025;Beauzac;2969;67;3036
84;Auvergne-Rhône-Alpes;43;2;16;026;Bellevue-la-Montagne;445;12;457
84;Auvergne-Rhône-Alpes;43;1;11;027;Berbezit;45;0;45
84;Auvergne-Rhône-Alpes;43;3;19;028;Bessamorel;472;15;487
84;Auvergne-Rhône-Alpes;43;1;07;029;La Besseyre-Saint-Mary;97;1;98
84;Auvergne-Rhône-Alpes;43;2;16;030;Blanzac;401;10;411
84;Auvergne-Rhône-Alpes;43;1;10;031;Blassac;135;5;140
84;Auvergne-Rhône-Alpes;43;2;14;032;Blavozy;1687;51;1738
84;Auvergne-Rhône-Alpes;43;1;17;033;Blesle;636;8;644
84;Auvergne-Rhône-Alpes;43;3;02;034;Boisset;355;1;356
84;Auvergne-Rhône-Alpes;43;1;11;035;Bonneval;68;3;71
84;Auvergne-Rhône-Alpes;43;2;16;036;Borne;409;6;415
84;Auvergne-Rhône-Alpes;43;2;18;037;Le Bouchet-Saint-Nicolas;280;7;287
84;Auvergne-Rhône-Alpes;43;1;04;038;Bournoncle-Saint-Pierre;998;27;1025
84;Auvergne-Rhône-Alpes;43;2;18;039;Le Brignon;609;13;622
84;Auvergne-Rhône-Alpes;43;1;04;040;Brioude;6609;325;6934
84;Auvergne-Rhône-Alpes;43;2;14;041;Brives-Charensac;4185;224;4409
84;Auvergne-Rhône-Alpes;43;2;18;042;Cayres;710;17;727
84;Auvergne-Rhône-Alpes;43;2;16;043;Céaux-d'Allègre;470;8;478
84;Auvergne-Rhône-Alpes;43;1;10;044;Cerzat;209;4;213
84;Auvergne-Rhône-Alpes;43;2;12;045;Ceyssac;426;13;439
84;Auvergne-Rhône-Alpes;43;2;13;046;Chadrac;2464;68;2532
84;Auvergne-Rhône-Alpes;43;2;08;047;Chadron;332;8;340
84;Auvergne-Rhône-Alpes;43;1;11;048;La Chaise-Dieu;616;36;652
84;Auvergne-Rhône-Alpes;43;2;06;049;Chamalières-sur-Loire;487;9;496
84;Auvergne-Rhône-Alpes;43;1;17;050;Chambezon;124;0;124
84;Auvergne-Rhône-Alpes;43;3;08;051;Le Chambon-sur-Lignon;2431;40;2471
84;Auvergne-Rhône-Alpes;43;1;17;052;Champagnac-le-Vieux;193;2;195
84;Auvergne-Rhône-Alpes;43;2;08;053;Champclause;205;4;209
84;Auvergne-Rhône-Alpes;43;1;07;054;Chanaleilles;176;9;185
84;Auvergne-Rhône-Alpes;43;1;04;055;Chaniat;165;4;169
84;Auvergne-Rhône-Alpes;43;1;07;056;Chanteuges;428;13;441
84;Auvergne-Rhône-Alpes;43;2;11;057;La Chapelle-Bertin;46;2;48
84;Auvergne-Rhône-Alpes;43;3;09;058;La Chapelle-d'Aurec;1054;29;1083
84;Auvergne-Rhône-Alpes;43;1;11;059;La Chapelle-Geneste;109;1;110
84;Auvergne-Rhône-Alpes;43;1;07;060;Charraix;69;4;73
84;Auvergne-Rhône-Alpes;43;2;13;061;Chaspinhac;868;23;891
84;Auvergne-Rhône-Alpes;43;2;16;062;Chaspuzac;806;15;821
84;Auvergne-Rhône-Alpes;43;1;10;063;Chassagnes;156;2;158
84;Auvergne-Rhône-Alpes;43;1;17;064;Chassignolles;64;4;68
84;Auvergne-Rhône-Alpes;43;1;10;065;Chastel;123;4;127
84;Auvergne-Rhône-Alpes;43;2;08;066;Chaudeyrolles;118;4;122
84;Auvergne-Rhône-Alpes;43;1;10;067;Chavaniac-Lafayette;268;6;274
84;Auvergne-Rhône-Alpes;43;1;07;068;Chazelles;33;2;35
84;Auvergne-Rhône-Alpes;43;3;03;069;Chenereilles;319;7;326
84;Auvergne-Rhône-Alpes;43;1;10;070;Chilhac;171;2;173
84;Auvergne-Rhône-Alpes;43;2;11;071;Chomelix;472;6;478
84;Auvergne-Rhône-Alpes;43;1;10;072;La Chomette;153;5;158
84;Auvergne-Rhône-Alpes;43;1;11;073;Cistrières;134;3;137
84;Auvergne-Rhône-Alpes;43;1;04;074;Cohade;884;25;909
84;Auvergne-Rhône-Alpes;43;1;10;075;Collat;73;3;76
84;Auvergne-Rhône-Alpes;43;1;11;076;Connangles;137;1;138
84;Auvergne-Rhône-Alpes;43;2;18;077;Costaros;538;16;554
84;Auvergne-Rhône-Alpes;43;2;15;078;Coubon;3258;89;3347
84;Auvergne-Rhône-Alpes;43;1;10;079;Couteuges;301;11;312
84;Auvergne-Rhône-Alpes;43;2;11;080;Craponne-sur-Arzon;1951;41;1992
84;Auvergne-Rhône-Alpes;43;1;10;082;Cronce;71;2;73
84;Auvergne-Rhône-Alpes;43;1;07;083;Cubelles;150;4;154
84;Auvergne-Rhône-Alpes;43;2;18;084;Cussac-sur-Loire;1678;35;1713
84;Auvergne-Rhône-Alpes;43;1;07;085;Desges;56;5;61
84;Auvergne-Rhône-Alpes;43;1;10;086;Domeyrat;179;9;188
84;Auvergne-Rhône-Alpes;43;3;03;087;Dunières;2668;65;2733
84;Auvergne-Rhône-Alpes;43;1;17;088;Espalem;322;9;331
84;Auvergne-Rhône-Alpes;43;2;12;089;Espaly-Saint-Marcel;3497;170;3667
84;Auvergne-Rhône-Alpes;43;1;07;090;Esplantas-Vazeilles;127;4;131
84;Auvergne-Rhône-Alpes;43;2;08;091;Les Estables;324;14;338
84;Auvergne-Rhône-Alpes;43;2;08;092;Fay-sur-Lignon;355;7;362
84;Auvergne-Rhône-Alpes;43;1;11;093;Félines;325;7;332
84;Auvergne-Rhône-Alpes;43;1;10;094;Ferrussac;82;2;84
84;Auvergne-Rhône-Alpes;43;2;16;095;Fix-Saint-Geneys;134;4;138
84;Auvergne-Rhône-Alpes;43;1;04;096;Fontannes;902;228;1130
84;Auvergne-Rhône-Alpes;43;2;08;097;Freycenet-la-Cuche;105;1;106
84;Auvergne-Rhône-Alpes;43;2;08;098;Freycenet-la-Tour;109;5;114
84;Auvergne-Rhône-Alpes;43;1;17;099;Frugerès-les-Mines;552;6;558
84;Auvergne-Rhône-Alpes;43;1;10;100;Frugières-le-Pin;174;2;176
84;Auvergne-Rhône-Alpes;43;2;08;101;Goudet;57;6;63
84;Auvergne-Rhône-Alpes;43;3;19;102;Grazac;1103;17;1120
84;Auvergne-Rhône-Alpes;43;1;17;103;Grenier-Montgon;113;2;115
84;Auvergne-Rhône-Alpes;43;1;07;104;Grèzes;197;6;203
84;Auvergne-Rhône-Alpes;43;1;10;105;Javaugues;178;7;185
84;Auvergne-Rhône-Alpes;43;1;10;106;Jax;145;3;148
84;Auvergne-Rhône-Alpes;43;1;10;107;Josat;86;0;86
84;Auvergne-Rhône-Alpes;43;2;11;108;Jullianges;439;10;449
84;Auvergne-Rhône-Alpes;43;2;18;109;Lafarre;77;3;80
84;Auvergne-Rhône-Alpes;43;1;04;110;Lamothe;844;14;858
84;Auvergne-Rhône-Alpes;43;2;18;111;Landos;878;22;900
84;Auvergne-Rhône-Alpes;43;1;07;112;Langeac;3489;77;3566
84;Auvergne-Rhône-Alpes;43;2;08;113;Lantriac;1923;54;1977
84;Auvergne-Rhône-Alpes;43;3;19;114;Lapte;1729;38;1767
84;Auvergne-Rhône-Alpes;43;2;08;115;Laussonne;1009;18;1027
84;Auvergne-Rhône-Alpes;43;1;11;116;Laval-sur-Doulon;63;3;66
84;Auvergne-Rhône-Alpes;43;1;04;117;Lavaudieu;247;7;254
84;Auvergne-Rhône-Alpes;43;1;10;118;Lavoûte-Chilhac;272;4;276
84;Auvergne-Rhône-Alpes;43;2;06;119;Lavoûte-sur-Loire;832;17;849
84;Auvergne-Rhône-Alpes;43;1;17;120;Lempdes-sur-Allagnon;1325;26;1351
84;Auvergne-Rhône-Alpes;43;1;17;121;Léotoing;216;5;221
84;Auvergne-Rhône-Alpes;43;2;16;122;Lissac;289;5;294
84;Auvergne-Rhône-Alpes;43;1;17;123;Lorlanges;393;16;409
84;Auvergne-Rhône-Alpes;43;2;16;124;Loudes;931;18;949
84;Auvergne-Rhône-Alpes;43;1;10;125;Lubilhac;81;1;82
84;Auvergne-Rhône-Alpes;43;2;06;126;Malrevers;761;15;776
84;Auvergne-Rhône-Alpes;43;3;02;127;Malvalette;846;15;861
84;Auvergne-Rhône-Alpes;43;1;11;128;Malvières;134;2;136
84;Auvergne-Rhône-Alpes;43;3;03;129;Le Mas-de-Tence;156;7;163
84;Auvergne-Rhône-Alpes;43;3;08;130;Mazet-Saint-Voy;1110;29;1139
84;Auvergne-Rhône-Alpes;43;1;10;131;Mazerat-Aurouze;196;2;198
84;Auvergne-Rhône-Alpes;43;1;10;132;Mazeyrat-d'Allier;1445;42;1487
84;Auvergne-Rhône-Alpes;43;1;10;133;Mercœur;139;1;140
84;Auvergne-Rhône-Alpes;43;2;06;134;Mézères;150;4;154
84;Auvergne-Rhône-Alpes;43;2;08;135;Le Monastier-sur-Gazeille;1768;31;1799
84;Auvergne-Rhône-Alpes;43;1;07;136;Monistrol-d'Allier;211;1;212
84;Auvergne-Rhône-Alpes;43;3;09;137;Monistrol-sur-Loire;8875;425;9300
84;Auvergne-Rhône-Alpes;43;2;11;138;Monlet;412;12;424
84;Auvergne-Rhône-Alpes;43;1;10;139;Montclard;54;0;54
84;Auvergne-Rhône-Alpes;43;2;13;140;Le Monteil;685;24;709
84;Auvergne-Rhône-Alpes;43;3;03;141;Montfaucon-en-Velay;1149;24;1173
84;Auvergne-Rhône-Alpes;43;3;03;142;Montregard;586;10;596
84;Auvergne-Rhône-Alpes;43;2;08;143;Montusclat;128;0;128
84;Auvergne-Rhône-Alpes;43;2;08;144;Moudeyres;98;3;101
84;Auvergne-Rhône-Alpes;43;2;18;145;Ouides;57;0;57
84;Auvergne-Rhône-Alpes;43;1;04;147;Paulhac;638;21;659
84;Auvergne-Rhône-Alpes;43;1;10;148;Paulhaguet;868;18;886
84;Auvergne-Rhône-Alpes;43;1;07;149;Pébrac;116;4;120
84;Auvergne-Rhône-Alpes;43;2;06;150;Le Pertuis;468;13;481
84;Auvergne-Rhône-Alpes;43;1;07;151;Pinols;190;5;195
84;Auvergne-Rhône-Alpes;43;2;13;152;Polignac;2810;84;2894
84;Auvergne-Rhône-Alpes;43;3;01;153;Pont-Salomon;1902;30;1932
84;Auvergne-Rhône-Alpes;43;2;18;154;Pradelles;546;16;562
84;Auvergne-Rhône-Alpes;43;1;07;155;Prades;62;1;63
84;Auvergne-Rhône-Alpes;43;2;08;156;Présailles;115;6;121
84;Auvergne-Rhône-Alpes;43;2;99;157;Le Puy-en-Velay;19215;881;20096
84;Auvergne-Rhône-Alpes;43;2;06;158;Queyrières;333;12;345
84;Auvergne-Rhône-Alpes;43;3;03;159;Raucoules;940;24;964
84;Auvergne-Rhône-Alpes;43;2;18;160;Rauret;194;3;197
84;Auvergne-Rhône-Alpes;43;3;02;162;Retournac;2990;58;3048
84;Auvergne-Rhône-Alpes;43;3;03;163;Riotord;1179;18;1197
84;Auvergne-Rhône-Alpes;43;2;11;164;Roche-en-Régnier;486;2;488
84;Auvergne-Rhône-Alpes;43;2;06;165;Rosières;1531;30;1561
84;Auvergne-Rhône-Alpes;43;3;02;166;Saint-André-de-Chalencon;375;16;391
84;Auvergne-Rhône-Alpes;43;1;07;167;Saint-Arcons-d'Allier;191;4;195
84;Auvergne-Rhône-Alpes;43;2;18;168;Saint-Arcons-de-Barges;116;1;117
84;Auvergne-Rhône-Alpes;43;1;10;169;Saint-Austremoine;50;0;50
84;Auvergne-Rhône-Alpes;43;1;10;170;Saint-Beauzire;450;6;456
84;Auvergne-Rhône-Alpes;43;1;07;171;Saint-Bérain;85;3;88
84;Auvergne-Rhône-Alpes;43;3;03;172;Saint-Bonnet-le-Froid;213;2;215
84;Auvergne-Rhône-Alpes;43;1;07;173;Saint-Christophe-d'Allier;92;2;94
84;Auvergne-Rhône-Alpes;43;2;18;174;Saint-Christophe-sur-Dolaison;953;13;966
84;Auvergne-Rhône-Alpes;43;1;10;175;Saint-Cirgues;164;6;170
84;Auvergne-Rhône-Alpes;43;3;05;177;Saint-Didier-en-Velay;3451;52;3503
84;Auvergne-Rhône-Alpes;43;1;10;178;Saint-Didier-sur-Doulon;194;8;202
84;Auvergne-Rhône-Alpes;43;2;18;180;Saint-Étienne-du-Vigan;98;5;103
84;Auvergne-Rhône-Alpes;43;2;06;181;Saint-Étienne-Lardeyrol;758;20;778
84;Auvergne-Rhône-Alpes;43;1;17;182;Saint-Étienne-sur-Blesle;53;0;53
84;Auvergne-Rhône-Alpes;43;1;10;183;Sainte-Eugénie-de-Villeneuve;113;2;115
84;Auvergne-Rhône-Alpes;43;3;01;184;Saint-Ferréol-d'Auroure;2473;31;2504
84;Auvergne-Rhône-Alpes;43;1;17;185;Sainte-Florine;3200;77;3277
84;Auvergne-Rhône-Alpes;43;2;08;186;Saint-Front;402;4;406
84;Auvergne-Rhône-Alpes;43;2;16;187;Saint-Geneys-près-Saint-Paulien;319;4;323
84;Auvergne-Rhône-Alpes;43;1;10;188;Saint-Georges-d'Aurac;473;8;481
84;Auvergne-Rhône-Alpes;43;2;11;189;Saint-Georges-Lagricol;518;13;531
84;Auvergne-Rhône-Alpes;43;2;14;190;Saint-Germain-Laprade;3666;83;3749
84;Auvergne-Rhône-Alpes;43;1;04;191;Saint-Géron;249;4;253
84;Auvergne-Rhône-Alpes;43;2;18;192;Saint-Haon;283;11;294
84;Auvergne-Rhône-Alpes;43;1;17;193;Saint-Hilaire;160;1;161
84;Auvergne-Rhône-Alpes;43;2;06;194;Saint-Hostien;716;22;738
84;Auvergne-Rhône-Alpes;43;1;10;195;Saint-Ilpize;186;5;191
84;Auvergne-Rhône-Alpes;43;2;11;196;Saint-Jean-d'Aubrigoux;174;2;176
84;Auvergne-Rhône-Alpes;43;2;16;197;Saint-Jean-de-Nay;351;5;356
84;Auvergne-Rhône-Alpes;43;2;18;198;Saint-Jean-Lachalm;295;8;303
84;Auvergne-Rhône-Alpes;43;3;03;199;Saint-Jeures;968;26;994
84;Auvergne-Rhône-Alpes;43;2;06;200;Saint-Julien-Chapteuil;1997;43;2040
84;Auvergne-Rhône-Alpes;43;2;11;201;Saint-Julien-d'Ance;245;8;253
84;Auvergne-Rhône-Alpes;43;1;07;202;Saint-Julien-des-Chazes;71;1;72
84;Auvergne-Rhône-Alpes;43;3;19;203;Saint-Julien-du-Pinet;482;13;495
84;Auvergne-Rhône-Alpes;43;3;03;204;Saint-Julien-Molhesabate;174;1;175
84;Auvergne-Rhône-Alpes;43;3;01;205;Saint-Just-Malmont;4225;60;4285
84;Auvergne-Rhône-Alpes;43;1;10;206;Saint-Just-près-Brioude;411;16;427
84;Auvergne-Rhône-Alpes;43;1;04;207;Saint-Laurent-Chabreuges;246;11;257
84;Auvergne-Rhône-Alpes;43;1;10;208;Sainte-Marguerite;43;2;45
84;Auvergne-Rhône-Alpes;43;2;08;210;Saint-Martin-de-Fugères;230;7;237
84;Auvergne-Rhône-Alpes;43;3;09;211;Saint-Maurice-de-Lignon;2634;72;2706
84;Auvergne-Rhône-Alpes;43;3;11;212;Saint-Pal-de-Chalencon;1009;16;1025
84;Auvergne-Rhône-Alpes;43;3;05;213;Saint-Pal-de-Mons;2293;52;2345
84;Auvergne-Rhône-Alpes;43;1;11;214;Saint-Pal-de-Senouire;110;3;113
84;Auvergne-Rhône-Alpes;43;2;18;215;Saint-Paul-de-Tartas;186;5;191
84;Auvergne-Rhône-Alpes;43;2;16;216;Saint-Paulien;2435;56;2491
84;Auvergne-Rhône-Alpes;43;2;11;217;Saint-Pierre-du-Champ;542;11;553
84;Auvergne-Rhône-Alpes;43;2;06;218;Saint-Pierre-Eynac;1187;27;1214
84;Auvergne-Rhône-Alpes;43;1;10;219;Saint-Préjet-Armandon;113;4;117
84;Auvergne-Rhône-Alpes;43;1;07;220;Saint-Préjet-d'Allier;174;4;178
84;Auvergne-Rhône-Alpes;43;2;16;221;Saint-Privat-d'Allier;397;13;410
84;Auvergne-Rhône-Alpes;43;1;10;222;Saint-Privat-du-Dragon;162;1;163
84;Auvergne-Rhône-Alpes;43;3;03;223;Saint-Romain-Lachalm;1106;24;1130
84;Auvergne-Rhône-Alpes;43;3;05;224;Sainte-Sigolène;5989;101;6090
84;Auvergne-Rhône-Alpes;43;1;07;225;Saint-Vénérand;52;0;52
84;Auvergne-Rhône-Alpes;43;1;17;226;Saint-Vert;107;4;111
84;Auvergne-Rhône-Alpes;43;3;05;227;Saint-Victor-Malescours;822;16;838
84;Auvergne-Rhône-Alpes;43;2;11;228;Saint-Victor-sur-Arlanc;90;2;92
84;Auvergne-Rhône-Alpes;43;2;16;229;Saint-Vidal;610;9;619
84;Auvergne-Rhône-Alpes;43;2;06;230;Saint-Vincent;1028;19;1047
84;Auvergne-Rhône-Alpes;43;2;08;231;Salettes;136;4;140
84;Auvergne-Rhône-Alpes;43;1;10;232;Salzuit;361;5;366
84;Auvergne-Rhône-Alpes;43;2;16;233;Sanssac-l'Église;1088;41;1129
84;Auvergne-Rhône-Alpes;43;1;07;234;Saugues;1697;124;1821
84;Auvergne-Rhône-Alpes;43;3;05;236;La Séauve-sur-Semène;1480;20;1500
84;Auvergne-Rhône-Alpes;43;1;11;237;Sembadel;227;6;233
84;Auvergne-Rhône-Alpes;43;2;18;238;Séneujols;299;7;306
84;Auvergne-Rhône-Alpes;43;1;07;239;Siaugues-Sainte-Marie;800;15;815
84;Auvergne-Rhône-Alpes;43;3;02;240;Solignac-sous-Roche;263;7;270
84;Auvergne-Rhône-Alpes;43;2;18;241;Solignac-sur-Loire;1272;32;1304
84;Auvergne-Rhône-Alpes;43;1;07;242;Tailhac;72;3;75
84;Auvergne-Rhône-Alpes;43;3;03;244;Tence;3074;45;3119
84;Auvergne-Rhône-Alpes;43;1;07;245;Thoras;222;8;230
84;Auvergne-Rhône-Alpes;43;3;02;246;Tiranges;464;17;481
84;Auvergne-Rhône-Alpes;43;1;17;247;Torsiac;67;1;68
84;Auvergne-Rhône-Alpes;43;3;02;249;Valprivas;520;11;531
84;Auvergne-Rhône-Alpes;43;1;10;250;Vals-le-Chastel;43;3;46
84;Auvergne-Rhône-Alpes;43;2;12;251;Vals-près-le-Puy;3420;121;3541
84;Auvergne-Rhône-Alpes;43;2;11;252;Varennes-Saint-Honorat;24;2;26
84;Auvergne-Rhône-Alpes;43;2;08;253;Les Vastres;195;9;204
84;Auvergne-Rhône-Alpes;43;2;16;254;Vazeilles-Limandre;267;4;271
84;Auvergne-Rhône-Alpes;43;1;07;256;Venteuges;343;6;349
84;Auvergne-Rhône-Alpes;43;2;16;257;Vergezac;517;7;524
84;Auvergne-Rhône-Alpes;43;1;17;258;Vergongheon;1815;50;1865
84;Auvergne-Rhône-Alpes;43;2;16;259;Vernassal;362;11;373
84;Auvergne-Rhône-Alpes;43;2;16;260;Le Vernet;23;0;23
84;Auvergne-Rhône-Alpes;43;1;17;261;Vézézoux;617;6;623
84;Auvergne-Rhône-Alpes;43;1;04;262;Vieille-Brioude;1167;37;1204
84;Auvergne-Rhône-Alpes;43;2;18;263;Vielprat;67;0;67
84;Auvergne-Rhône-Alpes;43;1;10;264;Villeneuve-d'Allier;285;15;300
84;Auvergne-Rhône-Alpes;43;3;09;265;Les Villettes;1442;46;1488
84;Auvergne-Rhône-Alpes;43;2;06;267;Vorey;1454;15;1469
84;Auvergne-Rhône-Alpes;43;3;19;268;Yssingeaux;7278;425;7703
52;Pays de la Loire;44;5;08;001;Abbaretz;2067;40;2107
52;Pays de la Loire;44;2;07;002;Aigrefeuille-sur-Maine;4014;138;4152
52;Pays de la Loire;44;5;01;003;Ancenis-Saint-Géréon;11037;398;11435
52;Pays de la Loire;44;3;89;005;Chaumes-en-Retz;6895;106;7001
52;Pays de la Loire;44;3;09;006;Assérac;1847;42;1889
52;Pays de la Loire;44;5;19;007;Avessac;2458;55;2513
52;Pays de la Loire;44;2;29;009;Basse-Goulaine;9136;241;9377
52;Pays de la Loire;44;3;02;010;Batz-sur-Mer;2824;72;2896
52;Pays de la Loire;44;3;20;012;La Bernerie-en-Retz;3049;44;3093
52;Pays de la Loire;44;3;27;013;Besné;3183;41;3224
52;Pays de la Loire;44;2;28;014;Le Bignon;3907;71;3978
52;Pays de la Loire;44;5;03;015;Blain;9954;174;10128
52;Pays de la Loire;44;2;30;016;La Boissière-du-Doré;1054;18;1072
52;Pays de la Loire;44;2;21;018;Bouaye;8008;139;8147
52;Pays de la Loire;44;3;03;019;Bouée;1019;14;1033
52;Pays de la Loire;44;2;21;020;Bouguenais;19903;305;20208
52;Pays de la Loire;44;3;10;021;Villeneuve-en-Retz;4962;88;5050
52;Pays de la Loire;44;2;07;022;Boussay;2682;49;2731
52;Pays de la Loire;44;5;03;023;Bouvron;3068;45;3113
52;Pays de la Loire;44;2;21;024;Brains;2849;59;2908
52;Pays de la Loire;44;3;03;025;Campbon;3959;67;4026
52;Pays de la Loire;44;2;04;026;Carquefou;20365;466;20831
52;Pays de la Loire;44;5;18;027;Casson;2421;28;2449
52;Pays de la Loire;44;5;18;028;Le Cellier;3974;106;4080
52;Pays de la Loire;44;2;30;029;Divatte-sur-Loire;6975;122;7097
52;Pays de la Loire;44;3;09;030;La Chapelle-des-Marais;4338;91;4429
52;Pays de la Loire;44;5;06;031;La Chapelle-Glain;798;8;806
52;Pays de la Loire;44;2;30;032;La Chapelle-Heulin;3357;49;3406
52;Pays de la Loire;44;3;03;033;La Chapelle-Launay;3145;45;3190
52;Pays de la Loire;44;2;05;035;La Chapelle-sur-Erdre;19551;406;19957
52;Pays de la Loire;44;5;06;036;Châteaubriant;12031;497;12528
52;Pays de la Loire;44;2;31;037;Château-Thébaud;3164;175;3339
52;Pays de la Loire;44;3;20;038;Chauvé;2930;46;2976
52;Pays de la Loire;44;2;10;039;Cheix-en-Retz;1120;8;1128
52;Pays de la Loire;44;2;28;041;La Chevrolière;5782;88;5870
52;Pays de la Loire;44;2;07;043;Clisson;7435;241;7676
52;Pays de la Loire;44;5;08;044;Conquereuil;1095;28;1123
52;Pays de la Loire;44;2;03;045;Cordemais;3754;47;3801
52;Pays de la Loire;44;3;23;046;Corsept;2640;55;2695
52;Pays de la Loire;44;2;24;047;Couëron;22309;275;22584
52;Pays de la Loire;44;5;01;048;Couffé;2548;51;2599
52;Pays de la Loire;44;3;02;049;Le Croisic;4118;56;4174
52;Pays de la Loire;44;3;19;050;Crossac;2983;26;3009
52;Pays de la Loire;44;5;08;051;Derval;3505;428;3933
52;Pays de la Loire;44;3;27;052;Donges;8152;94;8246
52;Pays de la Loire;44;3;19;053;Drefféac;2270;37;2307
52;Pays de la Loire;44;5;06;054;Erbray;3043;72;3115
52;Pays de la Loire;44;3;02;055;La Baule-Escoublac;16255;542;16797
52;Pays de la Loire;44;5;05;056;Fay-de-Bretagne;3676;62;3738
52;Pays de la Loire;44;5;19;057;Fégréac;2349;61;2410
52;Pays de la Loire;44;5;06;058;Fercé;472;11;483
52;Pays de la Loire;44;3;23;061;Frossay;3216;57;3273
52;Pays de la Loire;44;5;03;062;Le Gâvre;1821;41;1862
52;Pays de la Loire;44;2;07;063;Gétigné;3719;88;3807
52;Pays de la Loire;44;2;07;064;Gorges;4851;360;5211
52;Pays de la Loire;44;5;06;065;Grand-Auverné;769;21;790
52;Pays de la Loire;44;5;05;066;Grandchamps-des-Fontaines;6439;117;6556
52;Pays de la Loire;44;5;08;067;Guémené-Penfao;5233;82;5315
52;Pays de la Loire;44;3;19;068;Guenrouet;3374;55;3429
52;Pays de la Loire;44;3;09;069;Guérande;16112;575;16687
52;Pays de la Loire;44;2;31;070;La Haie-Fouassière;4691;111;4802
52;Pays de la Loire;44;2;29;071;Haute-Goulaine;5893;157;6050
52;Pays de la Loire;44;3;09;072;Herbignac;7046;127;7173
52;Pays de la Loire;44;5;18;073;Héric;6288;114;6402
52;Pays de la Loire;44;2;24;074;Indre;4040;45;4085
52;Pays de la Loire;44;5;06;075;Issé;1807;39;1846
52;Pays de la Loire;44;5;08;076;Jans;1391;21;1412
52;Pays de la Loire;44;5;18;077;Joué-sur-Erdre;2561;33;2594
52;Pays de la Loire;44;5;06;078;Juigné-des-Moutiers;332;3;335
52;Pays de la Loire;44;2;30;079;Le Landreau;3083;296;3379
52;Pays de la Loire;44;3;03;080;Lavau-sur-Loire;772;26;798
52;Pays de la Loire;44;2;28;081;Legé;4565;112;4677
52;Pays de la Loire;44;5;18;082;Ligné;5302;106;5408
52;Pays de la Loire;44;2;28;083;La Limouzinière;2467;30;2497
52;Pays de la Loire;44;2;30;084;Le Loroux-Bottereau;8397;135;8532
52;Pays de la Loire;44;5;06;085;Louisfert;986;40;1026
52;Pays de la Loire;44;5;08;086;Lusanger;1055;21;1076
52;Pays de la Loire;44;2;10;087;Machecoul-Saint-Même;7581;236;7817
52;Pays de la Loire;44;2;07;088;Maisdon-sur-Sèvre;3007;43;3050
52;Pays de la Loire;44;3;03;089;Malville;3531;55;3586
52;Pays de la Loire;44;2;10;090;La Marne;1621;17;1638
52;Pays de la Loire;44;5;08;091;Marsac-sur-Don;1519;15;1534
52;Pays de la Loire;44;5;08;092;Massérac;692;13;705
52;Pays de la Loire;44;2;04;094;Mauves-sur-Loire;3244;65;3309
52;Pays de la Loire;44;5;06;095;La Meilleraye-de-Bretagne;1547;24;1571
52;Pays de la Loire;44;5;01;096;Mésanger;4749;80;4829
52;Pays de la Loire;44;3;09;097;Mesquer;2039;45;2084
52;Pays de la Loire;44;3;19;098;Missillac;5398;68;5466
52;Pays de la Loire;44;5;06;099;Moisdon-la-Rivière;1968;60;2028
52;Pays de la Loire;44;2;07;100;Monnières;2290;60;2350
52;Pays de la Loire;44;2;23;101;La Montagne;6290;140;6430
52;Pays de la Loire;44;2;28;102;Montbert;3191;55;3246
52;Pays de la Loire;44;3;27;103;Montoir-de-Bretagne;7180;79;7259
52;Pays de la Loire;44;5;01;104;Montrelais;840;11;851
52;Pays de la Loire;44;5;08;105;Mouais;372;7;379
52;Pays de la Loire;44;3;20;106;Les Moutiers-en-Retz;1765;21;1786
52;Pays de la Loire;44;5;18;107;Mouzeil;1911;25;1936
52;Pays de la Loire;44;2;30;108;Mouzillon;2865;54;2919
52;Pays de la Loire;44;2;96;109;Nantes;318808;5167;323975
52;Pays de la Loire;44;5;18;110;Nort-sur-Erdre;9082;194;9276
52;Pays de la Loire;44;5;18;111;Notre-Dame-des-Landes;2260;25;2285
52;Pays de la Loire;44;5;06;112;Noyal-sur-Brutz;591;11;602
52;Pays de la Loire;44;5;08;113;Nozay;4195;89;4284
52;Pays de la Loire;44;2;25;114;Orvault;27209;699;27908
52;Pays de la Loire;44;5;01;115;Oudon;3872;66;3938
52;Pays de la Loire;44;3;23;116;Paimbœuf;3023;111;3134
52;Pays de la Loire;44;2;30;117;Le Pallet;3257;51;3308
52;Pays de la Loire;44;5;01;118;Pannecé;1409;24;1433
52;Pays de la Loire;44;2;10;119;Paulx;1985;27;2012
52;Pays de la Loire;44;2;23;120;Le Pellerin;5200;208;5408
52;Pays de la Loire;44;5;06;121;Petit-Auverné;426;4;430
52;Pays de la Loire;44;5;18;122;Petit-Mars;3755;53;3808
52;Pays de la Loire;44;5;08;123;Pierric;990;17;1007
52;Pays de la Loire;44;5;01;124;Le Pin;750;15;765
52;Pays de la Loire;44;3;09;125;Piriac-sur-Mer;2220;50;2270
52;Pays de la Loire;44;3;20;126;La Plaine-sur-Mer;4379;86;4465
52;Pays de la Loire;44;2;07;127;La Planche;2739;32;2771
52;Pays de la Loire;44;5;19;128;Plessé;5266;105;5371
52;Pays de la Loire;44;3;19;129;Pontchâteau;10901;260;11161
52;Pays de la Loire;44;2;28;130;Pont-Saint-Martin;6470;87;6557
52;Pays de la Loire;44;3;20;131;Pornic;15859;438;16297
52;Pays de la Loire;44;3;02;132;Pornichet;11141;299;11440
52;Pays de la Loire;44;2;10;133;Port-Saint-Père;2928;44;2972
52;Pays de la Loire;44;5;01;134;Pouillé-les-Côteaux;1071;22;1093
52;Pays de la Loire;44;3;02;135;Le Pouliguen;4015;93;4108
52;Pays de la Loire;44;3;20;136;Préfailles;1237;27;1264
52;Pays de la Loire;44;3;03;137;Prinquiau;3474;67;3541
52;Pays de la Loire;44;5;08;138;Puceul;1159;17;1176
52;Pays de la Loire;44;3;03;139;Quilly;1386;10;1396
52;Pays de la Loire;44;2;30;140;La Regrippière;1525;25;1550
52;Pays de la Loire;44;2;30;141;La Remaudière;1290;13;1303
52;Pays de la Loire;44;2;07;142;Remouillé;1958;34;1992
52;Pays de la Loire;44;2;97;143;Rezé;42919;791;43710
52;Pays de la Loire;44;5;18;144;Riaillé;2358;58;2416
52;Pays de la Loire;44;2;10;145;Rouans;3069;38;3107
52;Pays de la Loire;44;5;06;146;Rougé;2185;42;2227
52;Pays de la Loire;44;5;06;148;Ruffigné;701;8;709
52;Pays de la Loire;44;5;08;149;Saffré;3952;49;4001
52;Pays de la Loire;44;2;21;150;Saint-Aignan-Grandlieu;3954;60;4014
52;Pays de la Loire;44;3;02;151;Saint-André-des-Eaux;6744;179;6923
52;Pays de la Loire;44;3;19;152;Sainte-Anne-sur-Brivet;2933;53;2986
52;Pays de la Loire;44;5;06;153;Saint-Aubin-des-Châteaux;1763;52;1815
52;Pays de la Loire;44;3;23;154;Saint-Brevin-les-Pins;14287;318;14605
52;Pays de la Loire;44;2;28;155;Saint-Colomban;3417;75;3492
52;Pays de la Loire;44;2;28;156;Corcoué-sur-Logne;3022;39;3061
52;Pays de la Loire;44;2;10;157;Saint-Étienne-de-Mer-Morte;1727;22;1749
52;Pays de la Loire;44;2;03;158;Saint-Étienne-de-Montluc;7515;193;7708
52;Pays de la Loire;44;2;31;159;Saint-Fiacre-sur-Maine;1236;23;1259
52;Pays de la Loire;44;3;19;161;Saint-Gildas-des-Bois;3769;69;3838
52;Pays de la Loire;44;2;98;162;Saint-Herblain;47415;720;48135
52;Pays de la Loire;44;5;01;163;Vair-sur-Loire;4764;106;4870
52;Pays de la Loire;44;3;10;164;Saint-Hilaire-de-Chaléons;2322;45;2367
52;Pays de la Loire;44;2;07;165;Saint-Hilaire-de-Clisson;2320;47;2367
52;Pays de la Loire;44;2;23;166;Saint-Jean-de-Boiseau;5987;114;6101
52;Pays de la Loire;44;3;09;168;Saint-Joachim;4087;63;4150
52;Pays de la Loire;44;2;30;169;Saint-Julien-de-Concelles;7392;106;7498
52;Pays de la Loire;44;5;06;170;Saint-Julien-de-Vouvantes;967;22;989
52;Pays de la Loire;44;2;21;171;Saint-Léger-les-Vignes;1939;33;1972
52;Pays de la Loire;44;2;04;172;Sainte-Luce-sur-Loire;15319;269;15588
52;Pays de la Loire;44;2;07;173;Saint-Lumine-de-Clisson;2126;47;2173
52;Pays de la Loire;44;2;28;174;Saint-Lumine-de-Coutais;2229;39;2268
52;Pays de la Loire;44;3;09;175;Saint-Lyphard;4817;94;4911
52;Pays de la Loire;44;3;27;176;Saint-Malo-de-Guersac;3193;54;3247
52;Pays de la Loire;44;2;10;178;Saint-Mars-de-Coutais;2571;42;2613
52;Pays de la Loire;44;5;18;179;Saint-Mars-du-Désert;5118;85;5203
52;Pays de la Loire;44;5;01;180;Vallons-de-l'Erdre;6480;125;6605
52;Pays de la Loire;44;3;20;182;Saint-Michel-Chef-Chef;5233;89;5322
52;Pays de la Loire;44;3;09;183;Saint-Molf;2716;59;2775
52;Pays de la Loire;44;3;99;184;Saint-Nazaire;71394;1745;73139
52;Pays de la Loire;44;5;19;185;Saint-Nicolas-de-Redon;3245;66;3311
52;Pays de la Loire;44;2;10;186;Sainte-Pazanne;6980;132;7112
52;Pays de la Loire;44;3;23;187;Saint-Père-en-Retz;4576;147;4723
52;Pays de la Loire;44;2;28;188;Saint-Philbert-de-Grand-Lieu;9076;194;9270
52;Pays de la Loire;44;3;19;189;Sainte-Reine-de-Bretagne;2397;34;2431
52;Pays de la Loire;44;2;29;190;Saint-Sébastien-sur-Loire;27493;676;28169
52;Pays de la Loire;44;3;23;192;Saint-Viaud;2631;44;2675
52;Pays de la Loire;44;5;08;193;Saint-Vincent-des-Landes;1533;26;1559
52;Pays de la Loire;44;2;24;194;Sautron;8478;166;8644
52;Pays de la Loire;44;3;03;195;Savenay;9064;186;9250
52;Pays de la Loire;44;3;19;196;Sévérac;1631;25;1656
52;Pays de la Loire;44;5;08;197;Sion-les-Mines;1630;34;1664
52;Pays de la Loire;44;2;31;198;Les Sorinières;8765;132;8897
52;Pays de la Loire;44;5;06;199;Soudan;2003;56;2059
52;Pays de la Loire;44;5;06;200;Soulvache;343;7;350
52;Pays de la Loire;44;5;05;201;Sucé-sur-Erdre;7221;202;7423
52;Pays de la Loire;44;5;18;202;Teillé;1804;25;1829
52;Pays de la Loire;44;2;03;203;Le Temple-de-Bretagne;2028;17;2045
52;Pays de la Loire;44;2;04;204;Thouaré-sur-Loire;10482;179;10661
52;Pays de la Loire;44;5;18;205;Les Touches;2494;29;2523
52;Pays de la Loire;44;2;28;206;Touvois;1867;25;1892
52;Pays de la Loire;44;5;18;207;Trans-sur-Erdre;1094;10;1104
52;Pays de la Loire;44;5;08;208;Treffieux;930;11;941
52;Pays de la Loire;44;5;05;209;Treillières;9617;246;9863
52;Pays de la Loire;44;3;27;210;Trignac;7983;81;8064
52;Pays de la Loire;44;3;09;211;La Turballe;4734;95;4829
52;Pays de la Loire;44;2;30;212;Vallet;9460;179;9639
52;Pays de la Loire;44;5;01;213;Loireauxence;7480;127;7607
52;Pays de la Loire;44;5;08;214;Vay;2051;29;2080
52;Pays de la Loire;44;2;31;215;Vertou;25541;599;26140
52;Pays de la Loire;44;2;07;216;Vieillevigne;4010;75;4085
52;Pays de la Loire;44;5;05;217;Vigneux-de-Bretagne;6175;130;6305
52;Pays de la Loire;44;5;06;218;Villepot;682;14;696
52;Pays de la Loire;44;2;10;220;Vue;1615;25;1640
52;Pays de la Loire;44;5;08;221;La Chevallerais;1536;19;1555
52;Pays de la Loire;44;5;01;222;La Roche-Blanche;1225;21;1246
52;Pays de la Loire;44;2;28;223;Geneston;3677;48;3725
52;Pays de la Loire;44;5;08;224;La Grigonnais;1711;21;1732
24;Centre-Val de Loire;45;1;07;001;Adon;202;5;207
24;Centre-Val de Loire;45;1;08;002;Aillant-sur-Milleron;383;5;388
24;Centre-Val de Loire;45;1;02;004;Amilly;13233;590;13823
24;Centre-Val de Loire;45;3;17;005;Andonville;258;6;264
24;Centre-Val de Loire;45;2;05;006;Ardon;1092;28;1120
24;Centre-Val de Loire;45;2;10;008;Artenay;1951;30;1981
24;Centre-Val de Loire;45;3;17;009;Aschères-le-Marché;1136;30;1166
24;Centre-Val de Loire;45;3;09;010;Ascoux;1104;39;1143
24;Centre-Val de Loire;45;3;17;011;Attray;208;4;212
24;Centre-Val de Loire;45;3;17;012;Audeville;184;3;187
24;Centre-Val de Loire;45;3;09;013;Augerville-la-Rivière;227;8;235
24;Centre-Val de Loire;45;3;09;014;Aulnay-la-Rivière;500;13;513
24;Centre-Val de Loire;45;3;17;015;Autruy-sur-Juine;699;13;712
24;Centre-Val de Loire;45;1;07;016;Autry-le-Châtel;967;28;995
24;Centre-Val de Loire;45;1;08;017;Auvilliers-en-Gâtinais;339;3;342
24;Centre-Val de Loire;45;3;09;018;Auxy;971;18;989
24;Centre-Val de Loire;45;2;01;019;Baccon;654;27;681
24;Centre-Val de Loire;45;2;10;020;Le Bardon;987;18;1005
24;Centre-Val de Loire;45;3;09;021;Barville-en-Gâtinais;313;6;319
24;Centre-Val de Loire;45;3;09;022;Batilly-en-Gâtinais;449;4;453
24;Centre-Val de Loire;45;1;07;023;Batilly-en-Puisaye;114;2;116
24;Centre-Val de Loire;45;2;01;024;Baule;2065;39;2104
24;Centre-Val de Loire;45;3;17;025;Bazoches-les-Gallerandes;1548;21;1569
24;Centre-Val de Loire;45;1;04;026;Bazoches-sur-le-Betz;969;15;984
24;Centre-Val de Loire;45;1;08;027;Beauchamps-sur-Huillard;393;8;401
24;Centre-Val de Loire;45;2;01;028;Beaugency;7339;186;7525
24;Centre-Val de Loire;45;1;07;029;Beaulieu-sur-Loire;1789;21;1810
24;Centre-Val de Loire;45;3;09;030;Beaune-la-Rolande;2021;129;2150
24;Centre-Val de Loire;45;1;08;031;Bellegarde;1455;88;1543
24;Centre-Val de Loire;45;1;04;032;Le Bignon-Mirabeau;317;8;325
24;Centre-Val de Loire;45;3;09;033;Boësses;373;20;393
24;Centre-Val de Loire;45;2;18;034;Boigny-sur-Bionne;2094;50;2144
24;Centre-Val de Loire;45;3;09;035;Boiscommun;1132;23;1155
24;Centre-Val de Loire;45;1;07;036;Boismorand;840;29;869
24;Centre-Val de Loire;45;3;17;037;Boisseaux;505;10;515
24;Centre-Val de Loire;45;3;09;038;Bondaroy;413;12;425
24;Centre-Val de Loire;45;2;21;039;Bonnée;710;16;726
24;Centre-Val de Loire;45;1;07;040;Bonny-sur-Loire;1867;26;1893
24;Centre-Val de Loire;45;3;09;041;Bordeaux-en-Gâtinais;109;3;112
24;Centre-Val de Loire;45;2;21;042;Les Bordes;1920;46;1966
24;Centre-Val de Loire;45;2;18;043;Bou;1002;24;1026
24;Centre-Val de Loire;45;2;17;044;Bougy-lez-Neuville;161;7;168
24;Centre-Val de Loire;45;3;09;045;Bouilly-en-Gâtinais;314;12;326
24;Centre-Val de Loire;45;2;10;046;Boulay-les-Barres;1053;18;1071
24;Centre-Val de Loire;45;3;09;047;Bouzonville-aux-Bois;417;13;430
24;Centre-Val de Loire;45;2;03;049;Bouzy-la-Forêt;1218;31;1249
24;Centre-Val de Loire;45;3;09;050;Boynes;1324;38;1362
24;Centre-Val de Loire;45;2;21;051;Bray-Saint-Aignan;1741;34;1775
24;Centre-Val de Loire;45;1;07;052;Breteau;97;0;97
24;Centre-Val de Loire;45;1;07;053;Briare;5213;96;5309
24;Centre-Val de Loire;45;3;09;054;Briarres-sur-Essonne;546;10;556
24;Centre-Val de Loire;45;2;10;055;Bricy;554;15;569
24;Centre-Val de Loire;45;3;09;056;Bromeilles;322;6;328
24;Centre-Val de Loire;45;2;10;058;Bucy-le-Roi;176;7;183
24;Centre-Val de Loire;45;2;10;059;Bucy-Saint-Liphard;193;1;194
24;Centre-Val de Loire;45;1;07;060;La Bussière;786;18;804
24;Centre-Val de Loire;45;1;02;061;Cepoy;2419;53;2472
24;Centre-Val de Loire;45;2;10;062;Cercottes;1491;24;1515
24;Centre-Val de Loire;45;2;21;063;Cerdon;932;19;951
24;Centre-Val de Loire;45;1;07;064;Cernoy-en-Berry;450;10;460
24;Centre-Val de Loire;45;3;17;065;Césarville-Dossainville;240;3;243
24;Centre-Val de Loire;45;1;08;066;Chailly-en-Gâtinais;679;11;690
24;Centre-Val de Loire;45;2;10;067;Chaingy;3881;110;3991
24;Centre-Val de Loire;45;1;02;068;Châlette-sur-Loing;12688;262;12950
24;Centre-Val de Loire;45;3;09;069;Chambon-la-Forêt;952;14;966
24;Centre-Val de Loire;45;1;07;070;Champoulet;62;0;62
24;Centre-Val de Loire;45;2;06;072;Chanteau;1574;22;1596
24;Centre-Val de Loire;45;1;04;073;Chantecoq;483;8;491
24;Centre-Val de Loire;45;2;10;074;La Chapelle-Onzerain;115;2;117
24;Centre-Val de Loire;45;2;19;075;La Chapelle-Saint-Mesmin;10180;218;10398
24;Centre-Val de Loire;45;1;04;076;La Chapelle-Saint-Sépulcre;232;7;239
24;Centre-Val de Loire;45;1;08;077;La Chapelle-sur-Aveyron;626;6;632
24;Centre-Val de Loire;45;1;08;078;Chapelon;253;2;255
24;Centre-Val de Loire;45;1;08;079;Le Charme;156;0;156
24;Centre-Val de Loire;45;3;17;080;Charmont-en-Beauce;350;14;364
24;Centre-Val de Loire;45;2;10;081;Charsonville;613;16;629
24;Centre-Val de Loire;45;2;03;082;Châteauneuf-sur-Loire;8212;118;8330
24;Centre-Val de Loire;45;1;04;083;Château-Renard;2118;34;2152
24;Centre-Val de Loire;45;1;08;084;Châtenoy;445;9;454
24;Centre-Val de Loire;45;1;08;085;Châtillon-Coligny;1874;26;1900
24;Centre-Val de Loire;45;3;17;086;Châtillon-le-Roi;278;8;286
24;Centre-Val de Loire;45;1;07;087;Châtillon-sur-Loire;3108;52;3160
24;Centre-Val de Loire;45;3;17;088;Chaussy;293;10;303
24;Centre-Val de Loire;45;2;18;089;Chécy;8652;175;8827
24;Centre-Val de Loire;45;1;04;091;Chevannes;319;13;332
24;Centre-Val de Loire;45;1;11;092;Chevillon-sur-Huillard;1463;36;1499
24;Centre-Val de Loire;45;2;10;093;Chevilly;2658;39;2697
24;Centre-Val de Loire;45;1;04;094;Chevry-sous-le-Bignon;223;2;225
24;Centre-Val de Loire;45;3;09;095;Chilleurs-aux-Bois;2061;41;2102
24;Centre-Val de Loire;45;1;07;096;Les Choux;525;8;533
24;Centre-Val de Loire;45;1;04;097;Chuelles;1215;13;1228
24;Centre-Val de Loire;45;2;01;098;Cléry-Saint-André;3425;67;3492
24;Centre-Val de Loire;45;2;10;099;Coinces;516;9;525
24;Centre-Val de Loire;45;2;18;100;Combleux;494;21;515
24;Centre-Val de Loire;45;2;03;101;Combreux;274;6;280
24;Centre-Val de Loire;45;1;02;102;Conflans-sur-Loing;356;10;366
24;Centre-Val de Loire;45;1;04;103;Corbeilles;1551;18;1569
24;Centre-Val de Loire;45;1;02;104;Corquilleroy;2815;56;2871
24;Centre-Val de Loire;45;1;08;105;Cortrat;75;2;77
24;Centre-Val de Loire;45;1;08;107;Coudroy;318;0;318
24;Centre-Val de Loire;45;1;21;108;Coullons;2294;36;2330
24;Centre-Val de Loire;45;2;10;109;Coulmiers;541;11;552
24;Centre-Val de Loire;45;3;09;110;Courcelles-le-Roi;311;2;313
24;Centre-Val de Loire;45;3;09;111;Courcy-aux-Loges;451;3;454
24;Centre-Val de Loire;45;1;08;112;La Cour-Marigny;342;11;353
24;Centre-Val de Loire;45;1;04;113;Courtemaux;260;5;265
24;Centre-Val de Loire;45;1;04;114;Courtempierre;236;6;242
24;Centre-Val de Loire;45;1;04;115;Courtenay;3907;65;3972
24;Centre-Val de Loire;45;2;01;116;Cravant;956;24;980
24;Centre-Val de Loire;45;3;17;118;Crottes-en-Pithiverais;338;6;344
24;Centre-Val de Loire;45;3;17;119;Dadonville;2430;66;2496
24;Centre-Val de Loire;45;1;07;120;Dammarie-en-Puisaye;173;2;175
24;Centre-Val de Loire;45;1;08;121;Dammarie-sur-Loing;475;9;484
24;Centre-Val de Loire;45;2;21;122;Dampierre-en-Burly;1452;37;1489
24;Centre-Val de Loire;45;2;03;123;Darvoy;1864;31;1895
24;Centre-Val de Loire;45;3;09;124;Desmonts;175;3;178
24;Centre-Val de Loire;45;3;09;125;Dimancheville;113;3;116
24;Centre-Val de Loire;45;2;03;126;Donnery;2864;39;2903
24;Centre-Val de Loire;45;1;04;127;Dordives;3280;36;3316
24;Centre-Val de Loire;45;1;04;129;Douchy-Montcorbon;1358;28;1386
24;Centre-Val de Loire;45;2;01;130;Dry;1397;34;1431
24;Centre-Val de Loire;45;3;09;131;Échilleuses;389;10;399
24;Centre-Val de Loire;45;3;09;132;Égry;353;5;358
24;Centre-Val de Loire;45;3;17;133;Engenville;562;17;579
24;Centre-Val de Loire;45;2;10;134;Épieds-en-Beauce;1430;27;1457
24;Centre-Val de Loire;45;3;17;135;Erceville;311;5;316
24;Centre-Val de Loire;45;1;04;136;Ervauville;535;5;540
24;Centre-Val de Loire;45;3;09;137;Escrennes;726;17;743
24;Centre-Val de Loire;45;1;07;138;Escrignelles;51;0;51
24;Centre-Val de Loire;45;3;09;139;Estouy;493;17;510
24;Centre-Val de Loire;45;1;07;141;Faverelles;157;1;158
24;Centre-Val de Loire;45;2;03;142;Fay-aux-Loges;3754;67;3821
24;Centre-Val de Loire;45;1;07;143;Feins-en-Gâtinais;33;1;34
24;Centre-Val de Loire;45;2;20;144;Férolles;1142;85;1227
24;Centre-Val de Loire;45;1;04;145;Ferrières-en-Gâtinais;3702;81;3783
24;Centre-Val de Loire;45;2;05;146;La Ferté-Saint-Aubin;7404;160;7564
24;Centre-Val de Loire;45;2;06;147;Fleury-les-Aubrais;21010;266;21276
24;Centre-Val de Loire;45;1;04;148;Fontenay-sur-Loing;1726;13;1739
24;Centre-Val de Loire;45;1;04;149;Foucherolles;273;2;275
24;Centre-Val de Loire;45;1;08;150;Fréville-du-Gâtinais;181;4;185
24;Centre-Val de Loire;45;3;09;151;Gaubertin;253;8;261
24;Centre-Val de Loire;45;2;10;152;Gémigny;211;4;215
24;Centre-Val de Loire;45;2;21;153;Germigny-des-Prés;728;24;752
24;Centre-Val de Loire;45;2;10;154;Gidy;2057;34;2091
24;Centre-Val de Loire;45;1;07;155;Gien;13566;408;13974
24;Centre-Val de Loire;45;1;04;156;Girolles;603;17;620
24;Centre-Val de Loire;45;3;09;157;Givraines;414;6;420
24;Centre-Val de Loire;45;1;04;158;Gondreville;322;10;332
24;Centre-Val de Loire;45;3;09;159;Grangermont;193;3;196
24;Centre-Val de Loire;45;3;17;160;Greneville-en-Beauce;704;8;712
24;Centre-Val de Loire;45;1;04;161;Griselles;797;19;816
24;Centre-Val de Loire;45;3;17;162;Guigneville;524;14;538
24;Centre-Val de Loire;45;2;21;164;Guilly;645;16;661
24;Centre-Val de Loire;45;1;04;165;Gy-les-Nonains;612;9;621
24;Centre-Val de Loire;45;2;10;166;Huêtre;284;8;292
24;Centre-Val de Loire;45;2;10;167;Huisseau-sur-Mauves;1704;29;1733
24;Centre-Val de Loire;45;2;03;168;Ingrannes;556;4;560
24;Centre-Val de Loire;45;2;19;169;Ingré;9482;236;9718
24;Centre-Val de Loire;45;3;17;170;Intville-la-Guétard;165;2;167
24;Centre-Val de Loire;45;2;21;171;Isdes;548;14;562
24;Centre-Val de Loire;45;2;03;173;Jargeau;4676;49;4725
24;Centre-Val de Loire;45;3;17;174;Jouy-en-Pithiverais;265;6;271
24;Centre-Val de Loire;45;2;01;175;Jouy-le-Potier;1440;33;1473
24;Centre-Val de Loire;45;3;09;176;Juranville;430;4;434
24;Centre-Val de Loire;45;3;09;177;Laas;236;4;240
24;Centre-Val de Loire;45;1;08;178;Ladon;1386;22;1408
24;Centre-Val de Loire;45;2;01;179;Lailly-en-Val;3103;47;3150
24;Centre-Val de Loire;45;1;07;180;Langesse;82;0;82
24;Centre-Val de Loire;45;3;17;181;Léouville;88;2;90
24;Centre-Val de Loire;45;2;05;182;Ligny-le-Ribault;1230;27;1257
24;Centre-Val de Loire;45;2;10;183;Lion-en-Beauce;139;1;140
24;Centre-Val de Loire;45;2;21;184;Lion-en-Sullias;398;6;404
24;Centre-Val de Loire;45;1;11;185;Lombreuil;299;10;309
24;Centre-Val de Loire;45;3;09;186;Lorcy;579;13;592
24;Centre-Val de Loire;45;1;08;187;Lorris;2973;62;3035
24;Centre-Val de Loire;45;2;06;188;Loury;2492;61;2553
24;Centre-Val de Loire;45;1;04;189;Louzouer;250;6;256
24;Centre-Val de Loire;45;3;09;191;Le Malesherbois;8073;166;8239
24;Centre-Val de Loire;45;2;05;193;Marcilly-en-Villette;2138;47;2185
24;Centre-Val de Loire;45;2;18;194;Mardié;2866;56;2922
24;Centre-Val de Loire;45;3;09;195;Mareau-aux-Bois;562;14;576
24;Centre-Val de Loire;45;2;01;196;Mareau-aux-Prés;1508;25;1533
24;Centre-Val de Loire;45;2;06;197;Marigny-les-Usages;1692;37;1729
24;Centre-Val de Loire;45;3;09;198;Marsainvilliers;300;9;309
24;Centre-Val de Loire;45;1;04;199;Melleroy;502;4;506
24;Centre-Val de Loire;45;2;05;200;Ménestreau-en-Villette;1423;40;1463
24;Centre-Val de Loire;45;1;04;201;Mérinville;179;3;182
24;Centre-Val de Loire;45;2;01;202;Messas;1004;15;1019
24;Centre-Val de Loire;45;2;10;203;Meung-sur-Loire;6540;95;6635
24;Centre-Val de Loire;45;2;01;204;Mézières-lez-Cléry;815;20;835
24;Centre-Val de Loire;45;1;08;205;Mézières-en-Gâtinais;262;5;267
24;Centre-Val de Loire;45;1;04;206;Mignères;321;4;325
24;Centre-Val de Loire;45;1;04;207;Mignerette;405;9;414
24;Centre-Val de Loire;45;1;11;208;Montargis;14976;545;15521
24;Centre-Val de Loire;45;3;09;209;Montbarrois;305;5;310
24;Centre-Val de Loire;45;1;08;210;Montbouy;736;18;754
24;Centre-Val de Loire;45;1;08;212;Montcresson;1269;26;1295
24;Centre-Val de Loire;45;1;08;213;Montereau;627;15;642
24;Centre-Val de Loire;45;2;17;214;Montigny;239;4;243
24;Centre-Val de Loire;45;3;09;215;Montliard;242;3;245
24;Centre-Val de Loire;45;1;11;216;Mormant-sur-Vernisson;132;2;134
24;Centre-Val de Loire;45;3;17;217;Morville-en-Beauce;167;5;172
24;Centre-Val de Loire;45;1;07;218;Le Moulinet-sur-Solin;115;1;116
24;Centre-Val de Loire;45;1;08;219;Moulon;196;1;197
24;Centre-Val de Loire;45;3;09;220;Nancray-sur-Rimarde;576;17;593
24;Centre-Val de Loire;45;1;04;222;Nargis;1480;38;1518
24;Centre-Val de Loire;45;1;08;223;Nesploy;355;7;362
24;Centre-Val de Loire;45;2;17;224;Neuville-aux-Bois;4947;77;5024
24;Centre-Val de Loire;45;3;09;225;La Neuville-sur-Essonne;357;13;370
24;Centre-Val de Loire;45;2;21;226;Neuvy-en-Sullias;1359;27;1386
24;Centre-Val de Loire;45;1;07;227;Nevoy;1167;23;1190
24;Centre-Val de Loire;45;3;09;228;Nibelle;1195;11;1206
24;Centre-Val de Loire;45;1;08;229;Nogent-sur-Vernisson;2589;38;2627
24;Centre-Val de Loire;45;1;08;230;Noyers;737;5;742
24;Centre-Val de Loire;45;3;17;231;Oison;132;9;141
24;Centre-Val de Loire;45;2;12;232;Olivet;22386;481;22867
24;Centre-Val de Loire;45;3;09;233;Ondreville-sur-Essonne;402;3;405
24;Centre-Val de Loire;45;2;99;234;Orléans;116269;2363;118632
24;Centre-Val de Loire;45;2;15;235;Ormes;4147;79;4226
24;Centre-Val de Loire;45;3;09;237;Orville;124;1;125
24;Centre-Val de Loire;45;1;07;238;Ousson-sur-Loire;711;12;723
24;Centre-Val de Loire;45;1;08;239;Oussoy-en-Gâtinais;413;6;419
24;Centre-Val de Loire;45;3;17;240;Outarville;1312;23;1335
24;Centre-Val de Loire;45;2;20;241;Ouvrouer-les-Champs;547;11;558
24;Centre-Val de Loire;45;1;08;242;Ouzouer-des-Champs;266;5;271
24;Centre-Val de Loire;45;1;08;243;Ouzouer-sous-Bellegarde;313;6;319
24;Centre-Val de Loire;45;2;21;244;Ouzouer-sur-Loire;2641;82;2723
24;Centre-Val de Loire;45;1;07;245;Ouzouer-sur-Trézée;1117;20;1137
24;Centre-Val de Loire;45;3;17;246;Pannecières;138;1;139
24;Centre-Val de Loire;45;1;11;247;Pannes;3688;66;3754
24;Centre-Val de Loire;45;2;10;248;Patay;2244;37;2281
24;Centre-Val de Loire;45;1;02;249;Paucourt;908;24;932
24;Centre-Val de Loire;45;1;04;250;Pers-en-Gâtinais;252;2;254
24;Centre-Val de Loire;45;1;07;251;Pierrefitte-ès-Bois;316;4;320
24;Centre-Val de Loire;45;3;17;252;Pithiviers;9023;144;9167
24;Centre-Val de Loire;45;3;17;253;Pithiviers-le-Vieil;1769;41;1810
24;Centre-Val de Loire;45;1;21;254;Poilly-lez-Gien;2396;62;2458
24;Centre-Val de Loire;45;1;04;255;Préfontaines;442;9;451
24;Centre-Val de Loire;45;1;08;256;Presnoy;244;6;250
24;Centre-Val de Loire;45;1;08;257;Pressigny-les-Pins;501;7;508
24;Centre-Val de Loire;45;3;09;258;Puiseaux;3424;58;3482
24;Centre-Val de Loire;45;1;08;259;Quiers-sur-Bézonde;1133;22;1155
24;Centre-Val de Loire;45;3;09;260;Ramoulu;250;7;257
24;Centre-Val de Loire;45;2;06;261;Rebréchien;1311;16;1327
24;Centre-Val de Loire;45;2;10;262;Rouvray-Sainte-Croix;140;2;142
24;Centre-Val de Loire;45;3;17;263;Rouvres-Saint-Jean;300;8;308
24;Centre-Val de Loire;45;2;10;264;Rozières-en-Beauce;185;5;190
24;Centre-Val de Loire;45;1;04;265;Rozoy-le-Vieil;410;5;415
24;Centre-Val de Loire;45;2;10;266;Ruan;204;1;205
24;Centre-Val de Loire;45;2;21;268;Saint-Aignan-le-Jaillard;611;8;619
24;Centre-Val de Loire;45;2;10;269;Saint-Ay;3561;71;3632
24;Centre-Val de Loire;45;2;21;270;Saint-Benoît-sur-Loire;2004;51;2055
24;Centre-Val de Loire;45;1;21;271;Saint-Brisson-sur-Loire;968;23;991
24;Centre-Val de Loire;45;2;05;272;Saint-Cyr-en-Val;3295;76;3371
24;Centre-Val de Loire;45;2;03;273;Saint-Denis-de-l'Hôtel;3021;40;3061
24;Centre-Val de Loire;45;2;20;274;Saint-Denis-en-Val;7589;191;7780
24;Centre-Val de Loire;45;1;04;275;Saint-Firmin-des-Bois;451;4;455
24;Centre-Val de Loire;45;1;07;276;Saint-Firmin-sur-Loire;508;5;513
24;Centre-Val de Loire;45;2;21;277;Saint-Florent;453;12;465
24;Centre-Val de Loire;45;1;08;278;Sainte-Geneviève-des-Bois;1065;68;1133
24;Centre-Val de Loire;45;1;04;279;Saint-Germain-des-Prés;1904;18;1922
24;Centre-Val de Loire;45;1;21;280;Saint-Gondon;1096;19;1115
24;Centre-Val de Loire;45;1;04;281;Saint-Hilaire-les-Andrésis;953;17;970
24;Centre-Val de Loire;45;2;12;282;Saint-Hilaire-Saint-Mesmin;3071;85;3156
24;Centre-Val de Loire;45;1;08;283;Saint-Hilaire-sur-Puiseaux;164;6;170
24;Centre-Val de Loire;45;2;18;284;Saint-Jean-de-Braye;21288;592;21880
24;Centre-Val de Loire;45;2;19;285;Saint-Jean-de-la-Ruelle;16411;267;16678
24;Centre-Val de Loire;45;2;20;286;Saint-Jean-le-Blanc;9070;233;9303
24;Centre-Val de Loire;45;3;09;288;Saint-Loup-des-Vignes;395;10;405
24;Centre-Val de Loire;45;2;17;289;Saint-Lyé-la-Forêt;1202;18;1220
24;Centre-Val de Loire;45;2;03;290;Saint-Martin-d'Abbat;1761;27;1788
24;Centre-Val de Loire;45;1;21;291;Saint-Martin-sur-Ocre;1235;47;1282
24;Centre-Val de Loire;45;1;08;292;Saint-Maurice-sur-Aveyron;856;12;868
24;Centre-Val de Loire;45;1;11;293;Saint-Maurice-sur-Fessard;1155;25;1180
24;Centre-Val de Loire;45;3;09;294;Saint-Michel;135;1;136
24;Centre-Val de Loire;45;2;10;296;Saint-Péravy-la-Colombe;752;15;767
24;Centre-Val de Loire;45;2;21;297;Saint-Père-sur-Loire;1031;16;1047
24;Centre-Val de Loire;45;2;12;298;Saint-Pryvé-Saint-Mesmin;6076;102;6178
24;Centre-Val de Loire;45;2;10;299;Saint-Sigismond;267;1;268
24;Centre-Val de Loire;45;2;20;300;Sandillon;4114;100;4214
24;Centre-Val de Loire;45;3;09;301;Santeau;405;3;408
24;Centre-Val de Loire;45;2;15;302;Saran;16357;206;16563
24;Centre-Val de Loire;45;1;04;303;Sceaux-du-Gâtinais;632;13;645
24;Centre-Val de Loire;45;2;03;305;Seichebrières;212;1;213
24;Centre-Val de Loire;45;1;04;306;La Selle-en-Hermoy;788;14;802
24;Centre-Val de Loire;45;1;04;307;La Selle-sur-le-Bied;1099;24;1123
24;Centre-Val de Loire;45;2;18;308;Semoy;3224;77;3301
24;Centre-Val de Loire;45;2;05;309;Sennely;713;6;719
24;Centre-Val de Loire;45;3;17;310;Sermaises;1684;25;1709
24;Centre-Val de Loire;45;2;20;311;Sigloy;665;17;682
24;Centre-Val de Loire;45;1;11;312;Solterre;475;8;483
24;Centre-Val de Loire;45;2;10;313;Sougy;814;13;827
24;Centre-Val de Loire;45;2;03;314;Sully-la-Chapelle;450;9;459
24;Centre-Val de Loire;45;2;21;315;Sully-sur-Loire;5213;66;5279
24;Centre-Val de Loire;45;2;03;316;Sury-aux-Bois;790;23;813
24;Centre-Val de Loire;45;2;01;317;Tavers;1357;37;1394
24;Centre-Val de Loire;45;3;17;320;Thignonville;413;11;424
24;Centre-Val de Loire;45;1;08;321;Thimory;712;19;731
24;Centre-Val de Loire;45;1;04;322;Thorailles;185;4;189
24;Centre-Val de Loire;45;1;07;323;Thou;222;4;226
24;Centre-Val de Loire;45;2;20;324;Tigy;2333;51;2384
24;Centre-Val de Loire;45;3;17;325;Tivernon;288;4;292
24;Centre-Val de Loire;45;2;10;326;Tournoisis;392;9;401
24;Centre-Val de Loire;45;2;06;327;Traînou;3448;83;3531
24;Centre-Val de Loire;45;1;04;328;Treilles-en-Gâtinais;295;5;300
24;Centre-Val de Loire;45;1;04;329;Triguères;1288;25;1313
24;Centre-Val de Loire;45;2;10;330;Trinay;217;4;221
24;Centre-Val de Loire;45;2;20;331;Vannes-sur-Cosson;614;9;623
24;Centre-Val de Loire;45;1;08;332;Varennes-Changy;1494;26;1520
24;Centre-Val de Loire;45;2;06;333;Vennecy;1953;39;1992
24;Centre-Val de Loire;45;1;08;334;Vieilles-Maisons-sur-Joudry;632;8;640
24;Centre-Val de Loire;45;2;20;335;Vienne-en-Val;1939;44;1983
24;Centre-Val de Loire;45;2;21;336;Viglain;868;13;881
24;Centre-Val de Loire;45;2;10;337;Villamblain;286;8;294
24;Centre-Val de Loire;45;1;11;338;Villemandeur;6782;367;7149
24;Centre-Val de Loire;45;1;08;339;Villemoutiers;484;8;492
24;Centre-Val de Loire;45;2;21;340;Villemurlin;575;6;581
24;Centre-Val de Loire;45;2;10;341;Villeneuve-sur-Conie;200;6;206
24;Centre-Val de Loire;45;2;17;342;Villereau;394;3;397
24;Centre-Val de Loire;45;1;04;343;Villevoques;208;6;214
24;Centre-Val de Loire;45;2;01;344;Villorceau;1100;21;1121
24;Centre-Val de Loire;45;1;11;345;Vimory;1128;34;1162
24;Centre-Val de Loire;45;2;03;346;Vitry-aux-Loges;2243;40;2283
24;Centre-Val de Loire;45;3;09;347;Vrigny;815;16;831
24;Centre-Val de Loire;45;3;09;348;Yèvre-la-Ville;698;17;715
76;Occitanie;46;1;12;001;Albas;521;14;535
76;Occitanie;46;2;10;002;Albiac;64;2;66
76;Occitanie;46;3;10;003;Alvignac;691;24;715
76;Occitanie;46;2;11;004;Anglars;221;6;227
76;Occitanie;46;1;12;005;Anglars-Juillac;333;9;342
76;Occitanie;46;3;09;006;Anglars-Nozac;383;4;387
76;Occitanie;46;1;02;007;Arcambal;983;23;1006
76;Occitanie;46;3;15;008;Les Arques;210;3;213
76;Occitanie;46;2;11;009;Assier;633;18;651
76;Occitanie;46;1;13;010;Aujols;370;10;380
76;Occitanie;46;2;16;011;Autoire;356;9;365
76;Occitanie;46;2;16;012;Aynac;553;12;565
76;Occitanie;46;1;13;013;Bach;174;2;176
76;Occitanie;46;2;08;015;Bagnac-sur-Célé;1467;38;1505
76;Occitanie;46;3;14;016;Baladou;386;15;401
76;Occitanie;46;2;16;017;Bannes;141;4;145
76;Occitanie;46;3;10;018;Le Bastit;137;3;140
76;Occitanie;46;1;13;020;Beauregard;232;12;244
76;Occitanie;46;2;07;021;Béduer;705;26;731
76;Occitanie;46;1;12;022;Bélaye;209;1;210
76;Occitanie;46;1;13;023;Belfort-du-Quercy;517;6;523
76;Occitanie;46;2;06;024;Belmont-Bretenoux;404;12;416
76;Occitanie;46;1;13;026;Belmont-Sainte-Foi;115;3;118
76;Occitanie;46;1;05;027;Berganty;118;2;120
76;Occitanie;46;3;14;028;Bétaille;1064;29;1093
76;Occitanie;46;2;06;029;Biars-sur-Cère;2044;57;2101
76;Occitanie;46;3;10;030;Bio;340;13;353
76;Occitanie;46;3;05;031;Blars;131;3;134
76;Occitanie;46;1;04;032;Boissières;403;5;408
76;Occitanie;46;1;15;033;Porte-du-Quercy;577;8;585
76;Occitanie;46;2;11;034;Le Bourg;314;9;323
76;Occitanie;46;2;07;035;Boussac;182;8;190
76;Occitanie;46;2;11;036;Le Bouyssou;126;2;128
76;Occitanie;46;1;05;037;Bouziès;92;1;93
76;Occitanie;46;2;06;038;Bretenoux;1368;29;1397
76;Occitanie;46;2;05;039;Brengues;221;5;226
76;Occitanie;46;1;05;040;Cabrerets;225;8;233
76;Occitanie;46;2;05;041;Cadrieu;157;8;165
76;Occitanie;46;1;98;042;Cahors;19937;940;20877
76;Occitanie;46;2;06;043;Cahus;206;1;207
76;Occitanie;46;1;12;044;Caillac;597;22;619
76;Occitanie;46;2;05;045;Cajarc;1119;32;1151
76;Occitanie;46;1;04;046;Calamane;457;10;467
76;Occitanie;46;3;17;047;Calès;169;6;175
76;Occitanie;46;2;05;049;Calvignac;202;3;205
76;Occitanie;46;1;12;050;Cambayrac;141;4;145
76;Occitanie;46;2;07;051;Cambes;388;11;399
76;Occitanie;46;2;07;052;Camboulit;257;5;262
76;Occitanie;46;2;07;053;Camburat;424;13;437
76;Occitanie;46;3;05;054;Caniac-du-Causse;386;2;388
76;Occitanie;46;2;08;055;Capdenac;1112;25;1137
76;Occitanie;46;2;05;056;Carayac;106;5;111
76;Occitanie;46;2;11;057;Cardaillac;616;13;629
76;Occitanie;46;3;14;058;Carennac;413;15;428
76;Occitanie;46;3;10;059;Carlucet;223;10;233
76;Occitanie;46;1;12;060;Carnac-Rouffiac;228;1;229
76;Occitanie;46;1;15;061;Cassagnes;178;4;182
76;Occitanie;46;1;12;062;Castelfranc;434;8;442
76;Occitanie;46;1;13;063;Castelnau Montratier-Sainte Alauzie;1833;38;1871
76;Occitanie;46;1;04;064;Catus;896;7;903
76;Occitanie;46;3;14;065;Cavagnac;436;14;450
76;Occitanie;46;3;09;066;Cazals;637;5;642
76;Occitanie;46;1;05;068;Cénevières;170;3;173
76;Occitanie;46;1;13;069;Cézac;165;2;167
76;Occitanie;46;1;03;070;Cieurac;587;14;601
76;Occitanie;46;3;04;072;Concorès;305;6;311
76;Occitanie;46;1;13;073;Concots;420;17;437
76;Occitanie;46;3;14;074;Condat;410;8;418
76;Occitanie;46;2;07;075;Corn;237;5;242
76;Occitanie;46;2;06;076;Cornac;344;9;353
76;Occitanie;46;3;10;078;Couzou;97;2;99
76;Occitanie;46;3;05;079;Cras;102;2;104
76;Occitanie;46;1;04;080;Crayssac;778;14;792
76;Occitanie;46;1;05;081;Crégols;73;3;76
76;Occitanie;46;1;13;082;Cremps;360;9;369
76;Occitanie;46;3;14;083;Cressensac-Sarrazac;1118;23;1141
76;Occitanie;46;3;14;084;Creysse;314;8;322
76;Occitanie;46;2;08;085;Cuzac;235;6;241
76;Occitanie;46;3;14;086;Cuzance;632;13;645
76;Occitanie;46;3;09;087;Dégagnac;657;17;674
76;Occitanie;46;1;12;088;Douelle;822;22;844
76;Occitanie;46;1;15;089;Duravel;955;7;962
76;Occitanie;46;2;10;090;Durbans;148;2;150
76;Occitanie;46;1;13;091;Escamps;210;4;214
76;Occitanie;46;1;05;092;Esclauzels;221;3;224
76;Occitanie;46;2;05;093;Espagnac-Sainte-Eulalie;88;2;90
76;Occitanie;46;2;05;094;Espédaillac;268;5;273
76;Occitanie;46;1;04;095;Espère;1041;25;1066
76;Occitanie;46;2;11;096;Espeyroux;96;2;98
76;Occitanie;46;2;06;097;Estal;108;6;114
76;Occitanie;46;3;17;098;Fajoles;300;7;307
76;Occitanie;46;2;07;100;Faycelles;684;28;712
76;Occitanie;46;2;08;101;Felzins;461;7;468
76;Occitanie;46;2;99;102;Figeac;9802;670;10472
76;Occitanie;46;1;13;103;Saint-Paul-Flaugnac;1003;26;1029
76;Occitanie;46;2;10;104;Flaujac-Gare;94;6;100
76;Occitanie;46;1;03;105;Flaujac-Poujols;780;17;797
76;Occitanie;46;3;14;106;Floirac;241;8;249
76;Occitanie;46;1;15;107;Floressas;170;5;175
76;Occitanie;46;2;07;108;Fons;409;19;428
76;Occitanie;46;1;13;109;Fontanes;501;9;510
76;Occitanie;46;2;07;111;Fourmagnac;167;4;171
76;Occitanie;46;1;04;112;Francoulès;240;5;245
76;Occitanie;46;3;04;113;Frayssinet;305;6;311
76;Occitanie;46;3;15;114;Frayssinet-le-Gélat;361;7;368
76;Occitanie;46;2;16;115;Frayssinhes;163;7;170
76;Occitanie;46;2;05;116;Frontenac;70;6;76
76;Occitanie;46;2;06;117;Gagnac-sur-Cère;670;43;713
76;Occitanie;46;3;17;118;Gignac;675;15;690
76;Occitanie;46;1;04;119;Gigouzac;292;0;292
76;Occitanie;46;3;09;120;Gindou;336;4;340
76;Occitanie;46;3;04;121;Ginouillac;146;3;149
76;Occitanie;46;2;06;122;Gintrac;104;4;108
76;Occitanie;46;2;06;123;Girac;365;7;372
76;Occitanie;46;2;06;124;Glanes;301;12;313
76;Occitanie;46;2;11;125;Gorses;327;10;337
76;Occitanie;46;3;15;126;Goujounac;221;4;225
76;Occitanie;46;3;09;127;Gourdon;3981;127;4108
76;Occitanie;46;3;10;128;Gramat;3469;58;3527
76;Occitanie;46;2;05;129;Gréalou;287;11;298
76;Occitanie;46;1;15;130;Grézels;222;5;227
76;Occitanie;46;2;05;131;Grèzes;169;5;174
76;Occitanie;46;2;10;132;Issendolus;519;21;540
76;Occitanie;46;2;11;133;Issepts;265;3;268
76;Occitanie;46;1;15;134;Les Junies;274;6;280
76;Occitanie;46;2;11;135;Labastide-du-Haut-Mont;50;1;51
76;Occitanie;46;1;04;136;Labastide-du-Vert;270;7;277
76;Occitanie;46;1;03;137;Labastide-Marnhac;1244;22;1266
76;Occitanie;46;3;05;138;Cœur de Causse;918;20;938
76;Occitanie;46;2;11;139;Labathude;201;7;208
76;Occitanie;46;1;13;140;Laburgade;363;15;378
76;Occitanie;46;1;15;142;Lacapelle-Cabanac;169;2;171
76;Occitanie;46;2;11;143;Lacapelle-Marival;1277;36;1313
76;Occitanie;46;3;17;144;Lacave;255;13;268
76;Occitanie;46;3;17;145;Lachapelle-Auzac;793;13;806
76;Occitanie;46;2;16;146;Ladirat;94;1;95
76;Occitanie;46;1;15;147;Lagardelle;126;0;126
76;Occitanie;46;1;13;148;Lalbenque;1785;46;1831
76;Occitanie;46;1;02;149;Lamagdelaine;695;21;716
76;Occitanie;46;3;04;151;Lamothe-Cassel;117;3;120
76;Occitanie;46;3;17;152;Lamothe-Fénelon;301;4;305
76;Occitanie;46;3;17;153;Lanzac;580;16;596
76;Occitanie;46;1;13;154;Laramière;350;13;363
76;Occitanie;46;2;05;155;Larnagol;138;1;139
76;Occitanie;46;1;02;156;Bellefont-La Rauze;1226;24;1250
76;Occitanie;46;2;05;157;Larroque-Toirac;134;5;139
76;Occitanie;46;2;16;159;Latouille-Lentillac;223;12;235
76;Occitanie;46;2;11;160;Latronquière;424;15;439
76;Occitanie;46;2;11;161;Lauresses;248;6;254
76;Occitanie;46;3;05;162;Lauzès;201;6;207
76;Occitanie;46;2;06;163;Laval-de-Cère;288;4;292
76;Occitanie;46;3;09;164;Lavercantière;251;11;262
76;Occitanie;46;3;10;165;Lavergne;462;11;473
76;Occitanie;46;3;05;167;Lentillac-du-Causse;106;0;106
76;Occitanie;46;2;08;168;Lentillac-Saint-Blaise;187;1;188
76;Occitanie;46;3;09;169;Léobard;206;7;213
76;Occitanie;46;2;16;170;Leyme;927;23;950
76;Occitanie;46;1;15;171;Lherm;227;3;230
76;Occitanie;46;1;13;172;Lhospitalet;500;16;516
76;Occitanie;46;1;13;173;Limogne-en-Quercy;738;17;755
76;Occitanie;46;2;08;174;Linac;233;8;241
76;Occitanie;46;2;07;175;Lissac-et-Mouret;917;33;950
76;Occitanie;46;2;11;176;Livernon;699;13;712
76;Occitanie;46;2;16;177;Loubressac;512;20;532
76;Occitanie;46;3;17;178;Loupiac;261;1;262
76;Occitanie;46;1;13;179;Lugagnac;127;5;132
76;Occitanie;46;2;08;180;Lunan;593;25;618
76;Occitanie;46;3;05;181;Lunegarde;96;4;100
76;Occitanie;46;1;12;182;Luzech;1789;26;1815
76;Occitanie;46;2;05;183;Marcilhac-sur-Célé;203;2;205
76;Occitanie;46;3;09;184;Marminiac;350;12;362
76;Occitanie;46;3;14;185;Martel;1625;41;1666
76;Occitanie;46;3;17;186;Masclat;362;7;369
76;Occitanie;46;1;15;187;Mauroux;524;10;534
76;Occitanie;46;1;04;188;Maxou;300;10;310
76;Occitanie;46;2;16;189;Mayrinhac-Lentour;498;16;514
76;Occitanie;46;1;04;190;Mechmont;129;3;132
76;Occitanie;46;1;01;191;Mercuès;1140;20;1160
76;Occitanie;46;3;17;192;Meyronne;269;8;277
76;Occitanie;46;3;10;193;Miers;457;11;468
76;Occitanie;46;3;09;194;Milhac;182;3;185
76;Occitanie;46;2;16;195;Molières;357;9;366
76;Occitanie;46;3;04;196;Montamel;99;1;100
76;Occitanie;46;1;03;197;Le Montat;1062;125;1187
76;Occitanie;46;2;05;198;Montbrun;110;1;111
76;Occitanie;46;1;15;199;Montcabrier;348;6;354
76;Occitanie;46;3;15;200;Montcléra;267;5;272
76;Occitanie;46;1;12;201;Montcuq-en-Quercy-Blanc;1772;48;1820
76;Occitanie;46;1;13;202;Montdoumerc;549;5;554
76;Occitanie;46;2;11;203;Montet-et-Bouxal;212;6;218
76;Occitanie;46;3;04;204;Montfaucon;600;9;609
76;Occitanie;46;1;04;205;Montgesty;325;2;327
76;Occitanie;46;1;12;206;Montlauzun;120;6;126
76;Occitanie;46;2;08;207;Montredon;301;5;306
76;Occitanie;46;3;14;208;Montvalent;287;11;298
76;Occitanie;46;3;17;209;Nadaillac-de-Rouge;163;8;171
76;Occitanie;46;3;05;210;Nadillac;68;1;69
76;Occitanie;46;1;04;211;Nuzéjouls;353;2;355
76;Occitanie;46;3;05;212;Orniac;70;3;73
76;Occitanie;46;3;10;213;Padirac;154;10;164
76;Occitanie;46;1;12;214;Parnac;385;9;394
76;Occitanie;46;3;17;215;Payrac;618;17;635
76;Occitanie;46;3;09;216;Payrignac;658;29;687
76;Occitanie;46;1;13;217;Pern;437;11;448
76;Occitanie;46;1;15;218;Pescadoires;187;3;190
76;Occitanie;46;3;04;219;Peyrilles;346;13;359
76;Occitanie;46;3;17;220;Pinsac;788;25;813
76;Occitanie;46;2;07;221;Planioles;533;9;542
76;Occitanie;46;3;15;222;Pomarède;192;3;195
76;Occitanie;46;1;04;223;Pontcirq;175;1;176
76;Occitanie;46;1;01;224;Pradines;3562;102;3664
76;Occitanie;46;1;15;225;Prayssac;2384;76;2460
76;Occitanie;46;2;08;226;Prendeignes;230;7;237
76;Occitanie;46;1;13;227;Promilhanes;222;4;226
76;Occitanie;46;2;06;228;Prudhomat;718;15;733
76;Occitanie;46;2;06;229;Puybrun;1015;18;1033
76;Occitanie;46;2;05;230;Puyjourdes;86;4;90
76;Occitanie;46;1;15;231;Puy-l'Évêque;1940;29;1969
76;Occitanie;46;3;14;232;Le Vignon-en-Quercy;1006;24;1030
76;Occitanie;46;2;05;233;Quissac;109;1;110
76;Occitanie;46;3;09;234;Rampoux;100;2;102
76;Occitanie;46;2;10;235;Reilhac;172;4;176
76;Occitanie;46;3;17;236;Reilhaguet;143;0;143
76;Occitanie;46;2;11;237;Reyrevignes;372;10;382
76;Occitanie;46;3;10;238;Rignac;279;9;288
76;Occitanie;46;3;17;239;Le Roc;212;5;217
76;Occitanie;46;3;10;240;Rocamadour;623;20;643
76;Occitanie;46;3;09;241;Rouffilhac;190;4;194
76;Occitanie;46;2;11;242;Rudelle;179;5;184
76;Occitanie;46;2;11;243;Rueyres;191;1;192
76;Occitanie;46;2;11;244;Sabadel-Latronquière;94;1;95
76;Occitanie;46;3;05;245;Sabadel-Lauzès;77;1;78
76;Occitanie;46;2;16;246;Saignes;74;1;75
76;Occitanie;46;1;13;247;Saillac;154;5;159
76;Occitanie;46;2;11;249;Saint-Bressou;120;5;125
76;Occitanie;46;3;15;250;Saint-Caprais;81;2;83
76;Occitanie;46;2;16;251;Saint-Céré;3414;160;3574
76;Occitanie;46;3;05;252;Les Pechs du Vers;312;8;320
76;Occitanie;46;3;04;253;Saint-Chamarand;181;2;183
76;Occitanie;46;2;05;254;Saint-Chels;139;5;144
76;Occitanie;46;2;11;255;Saint-Cirgues;334;13;347
76;Occitanie;46;1;05;256;Saint-Cirq-Lapopie;200;2;202
76;Occitanie;46;3;09;257;Saint-Cirq-Madelon;122;3;125
76;Occitanie;46;3;09;258;Saint-Cirq-Souillaguet;163;1;164
76;Occitanie;46;3;09;259;Saint-Clair;141;2;143
76;Occitanie;46;2;11;260;Sainte-Colombe;221;9;230
76;Occitanie;46;1;12;262;Lendou-en-Quercy;633;14;647
76;Occitanie;46;1;12;263;Barguelonne-en-Quercy;696;17;713
76;Occitanie;46;1;04;264;Saint-Denis-Catus;200;7;207
76;Occitanie;46;3;14;265;Saint-Denis-lès-Martel;331;7;338
76;Occitanie;46;2;08;266;Saint-Félix;538;8;546
76;Occitanie;46;3;04;267;Saint-Germain-du-Bel-Air;569;12;581
76;Occitanie;46;1;05;268;Saint Géry-Vers;893;20;913
76;Occitanie;46;2;11;269;Saint-Hilaire;61;2;63
76;Occitanie;46;2;05;270;Saint-Jean-de-Laur;242;3;245
76;Occitanie;46;2;16;271;Saint-Jean-Lespinasse;404;17;421
76;Occitanie;46;2;08;272;Saint-Jean-Mirabel;271;4;275
76;Occitanie;46;2;16;273;Saint-Laurent-les-Tours;846;25;871
76;Occitanie;46;1;05;276;Saint-Martin-Labouval;185;5;190
76;Occitanie;46;1;15;277;Saint-Martin-le-Redon;205;4;209
76;Occitanie;46;2;11;279;Saint-Maurice-en-Quercy;210;3;213
76;Occitanie;46;1;04;280;Saint-Médard;178;5;183
76;Occitanie;46;2;16;281;Saint-Médard-de-Presque;200;7;207
76;Occitanie;46;2;11;282;Saint-Médard-Nicourby;94;0;94
76;Occitanie;46;3;14;283;Saint-Michel-de-Bannières;316;8;324
76;Occitanie;46;2;06;284;Saint-Michel-Loubéjou;405;8;413
76;Occitanie;46;2;16;286;Saint-Paul-de-Vern;176;5;181
76;Occitanie;46;2;08;288;Saint-Perdoux;213;10;223
76;Occitanie;46;2;05;289;Saint-Pierre-Toirac;159;0;159
76;Occitanie;46;3;09;290;Saint-Projet;341;8;349
76;Occitanie;46;2;11;292;Saint-Simon;186;6;192
76;Occitanie;46;3;17;293;Saint-Sozy;483;12;495
76;Occitanie;46;2;05;294;Saint-Sulpice;146;3;149
76;Occitanie;46;2;16;295;Saint-Vincent-du-Pendit;212;4;216
76;Occitanie;46;1;12;296;Saint-Vincent-Rive-d'Olt;437;16;453
76;Occitanie;46;3;09;297;Salviac;1207;25;1232
76;Occitanie;46;2;05;299;Sauliac-sur-Célé;120;4;124
76;Occitanie;46;1;12;301;Sauzet;520;5;525
76;Occitanie;46;2;11;302;Sénaillac-Latronquière;135;2;137
76;Occitanie;46;3;05;303;Sénaillac-Lauzès;128;3;131
76;Occitanie;46;3;04;304;Séniergues;137;1;138
76;Occitanie;46;1;15;305;Sérignac;306;2;308
76;Occitanie;46;2;11;306;Sonac;86;3;89
76;Occitanie;46;1;15;307;Soturac;640;6;646
76;Occitanie;46;3;04;308;Soucirac;102;1;103
76;Occitanie;46;3;17;309;Souillac;3201;318;3519
76;Occitanie;46;3;05;310;Soulomès;126;2;128
76;Occitanie;46;2;06;311;Sousceyrac-en-Quercy;1331;20;1351
76;Occitanie;46;3;14;312;Strenquels;273;2;275
76;Occitanie;46;2;06;313;Tauriac;442;9;451
76;Occitanie;46;2;11;314;Terrou;174;40;214
76;Occitanie;46;2;06;315;Teyssieu;167;3;170
76;Occitanie;46;3;04;316;Thédirac;290;5;295
76;Occitanie;46;3;10;317;Thégra;481;13;494
76;Occitanie;46;2;11;318;Thémines;232;12;244
76;Occitanie;46;2;11;319;Théminettes;168;5;173
76;Occitanie;46;1;05;320;Tour-de-Faure;317;15;332
76;Occitanie;46;1;15;321;Touzac;370;8;378
76;Occitanie;46;1;03;322;Trespoux-Rassiels;809;31;840
76;Occitanie;46;3;04;323;Ussel;99;2;101
76;Occitanie;46;3;04;324;Uzech;214;4;218
76;Occitanie;46;1;13;328;Varaire;335;12;347
76;Occitanie;46;1;13;329;Vaylats;326;2;328
76;Occitanie;46;3;14;330;Vayrac;1303;25;1328
76;Occitanie;46;2;08;332;Viazac;334;5;339
76;Occitanie;46;1;13;333;Vidaillac;179;4;183
76;Occitanie;46;3;09;334;Le Vigan;1565;57;1622
76;Occitanie;46;1;12;335;Villesèque;395;16;411
76;Occitanie;46;1;15;336;Vire-sur-Lot;349;31;380
76;Occitanie;46;3;17;337;Mayrac;259;7;266
76;Occitanie;46;2;11;338;Bessonies;77;1;78
76;Occitanie;46;2;16;339;Saint-Jean-Lagineste;369;8;377
76;Occitanie;46;1;04;340;Saint-Pierre-Lafeuille;365;12;377
75;Nouvelle-Aquitaine;47;1;97;001;Agen;32602;862;33464
75;Nouvelle-Aquitaine;47;2;07;002;Agmé;105;4;109
75;Nouvelle-Aquitaine;47;2;19;003;Agnac;421;9;430
75;Nouvelle-Aquitaine;47;1;06;004;Aiguillon;4421;141;4562
75;Nouvelle-Aquitaine;47;2;19;005;Allemans-du-Dropt;487;5;492
75;Nouvelle-Aquitaine;47;3;12;006;Allez-et-Cazeneuve;593;13;606
75;Nouvelle-Aquitaine;47;4;08;007;Allons;164;6;170
75;Nouvelle-Aquitaine;47;4;11;008;Ambrus;110;4;114
75;Nouvelle-Aquitaine;47;4;05;009;Andiran;229;8;237
75;Nouvelle-Aquitaine;47;2;08;010;Antagnac;224;3;227
75;Nouvelle-Aquitaine;47;3;09;011;Anthé;199;7;206
75;Nouvelle-Aquitaine;47;4;08;012;Anzex;311;2;313
75;Nouvelle-Aquitaine;47;2;08;013;Argenton;324;11;335
75;Nouvelle-Aquitaine;47;2;19;014;Armillac;202;7;209
75;Nouvelle-Aquitaine;47;1;17;015;Astaffort;2031;39;2070
75;Nouvelle-Aquitaine;47;1;15;016;Aubiac;1154;25;1179
75;Nouvelle-Aquitaine;47;3;16;017;Auradou;415;9;424
75;Nouvelle-Aquitaine;47;2;07;018;Auriac-sur-Dropt;173;6;179
75;Nouvelle-Aquitaine;47;1;01;019;Bajamont;989;21;1010
75;Nouvelle-Aquitaine;47;2;07;020;Baleyssagues;184;8;192
75;Nouvelle-Aquitaine;47;4;11;021;Barbaste;1511;81;1592
75;Nouvelle-Aquitaine;47;1;06;022;Bazens;538;9;547
75;Nouvelle-Aquitaine;47;3;10;023;Beaugas;354;5;359
75;Nouvelle-Aquitaine;47;2;13;024;Beaupuy;1632;41;1673
75;Nouvelle-Aquitaine;47;1;16;025;Beauville;550;6;556
75;Nouvelle-Aquitaine;47;4;08;026;Beauziac;231;8;239
75;Nouvelle-Aquitaine;47;3;21;027;Bias;2997;45;3042
75;Nouvelle-Aquitaine;47;2;14;028;Birac-sur-Trec;850;18;868
75;Nouvelle-Aquitaine;47;3;09;029;Blanquefort-sur-Briolance;495;13;508
75;Nouvelle-Aquitaine;47;1;16;030;Blaymont;209;6;215
75;Nouvelle-Aquitaine;47;1;02;031;Boé;5631;94;5725
75;Nouvelle-Aquitaine;47;1;02;032;Bon-Encontre;6224;148;6372
75;Nouvelle-Aquitaine;47;3;10;033;Boudy-de-Beauregard;412;3;415
75;Nouvelle-Aquitaine;47;2;08;034;Bouglon;633;13;646
75;Nouvelle-Aquitaine;47;2;19;035;Bourgougnague;328;80;408
75;Nouvelle-Aquitaine;47;3;09;036;Bourlens;375;6;381
75;Nouvelle-Aquitaine;47;3;10;037;Bournel;253;4;257
75;Nouvelle-Aquitaine;47;1;06;038;Bourran;613;24;637
75;Nouvelle-Aquitaine;47;4;08;039;Boussès;36;0;36
75;Nouvelle-Aquitaine;47;1;15;040;Brax;2090;46;2136
75;Nouvelle-Aquitaine;47;4;11;041;Bruch;747;15;762
75;Nouvelle-Aquitaine;47;2;18;042;Brugnac;184;6;190
75;Nouvelle-Aquitaine;47;4;11;043;Buzet-sur-Baïse;1260;14;1274
75;Nouvelle-Aquitaine;47;3;19;044;Cahuzac;309;3;312
75;Nouvelle-Aquitaine;47;4;05;045;Calignac;472;5;477
75;Nouvelle-Aquitaine;47;2;08;046;Calonges;613;12;625
75;Nouvelle-Aquitaine;47;2;07;047;Cambes;183;5;188
75;Nouvelle-Aquitaine;47;3;10;048;Cancon;1339;19;1358
75;Nouvelle-Aquitaine;47;3;12;049;Casseneuil;2433;48;2481
75;Nouvelle-Aquitaine;47;1;16;050;Cassignas;129;2;131
75;Nouvelle-Aquitaine;47;1;17;051;Castelculier;2393;48;2441
75;Nouvelle-Aquitaine;47;4;08;052;Casteljaloux;4518;56;4574
75;Nouvelle-Aquitaine;47;1;16;053;Castella;375;7;382
75;Nouvelle-Aquitaine;47;2;18;054;Castelmoron-sur-Lot;1796;23;1819
75;Nouvelle-Aquitaine;47;3;10;055;Castelnaud-de-Gratecambe;516;7;523
75;Nouvelle-Aquitaine;47;2;07;056;Castelnau-sur-Gupie;894;32;926
75;Nouvelle-Aquitaine;47;3;19;057;Castillonnès;1370;20;1390
75;Nouvelle-Aquitaine;47;4;08;058;Caubeyres;257;1;258
75;Nouvelle-Aquitaine;47;2;07;059;Caubon-Saint-Sauveur;261;4;265
75;Nouvelle-Aquitaine;47;1;17;060;Caudecoste;1109;19;1128
75;Nouvelle-Aquitaine;47;2;14;061;Caumont-sur-Garonne;774;7;781
75;Nouvelle-Aquitaine;47;1;16;062;Cauzac;417;4;421
75;Nouvelle-Aquitaine;47;3;19;063;Cavarc;162;2;164
75;Nouvelle-Aquitaine;47;3;09;064;Cazideroque;238;7;245
75;Nouvelle-Aquitaine;47;2;18;065;Clairac;2594;198;2792
75;Nouvelle-Aquitaine;47;1;06;066;Clermont-Dessous;911;12;923
75;Nouvelle-Aquitaine;47;1;17;067;Clermont-Soubiran;393;8;401
75;Nouvelle-Aquitaine;47;2;13;068;Cocumont;1087;23;1110
75;Nouvelle-Aquitaine;47;1;15;069;Colayrac-Saint-Cirq;3113;49;3162
75;Nouvelle-Aquitaine;47;3;09;070;Condezaygues;850;23;873
75;Nouvelle-Aquitaine;47;2;18;071;Coulx;242;3;245
75;Nouvelle-Aquitaine;47;3;09;072;Courbiac;108;3;111
75;Nouvelle-Aquitaine;47;1;06;073;Cours;198;5;203
75;Nouvelle-Aquitaine;47;2;13;074;Couthures-sur-Garonne;360;6;366
75;Nouvelle-Aquitaine;47;1;16;075;La Croix-Blanche;1078;23;1101
75;Nouvelle-Aquitaine;47;1;17;076;Cuq;281;5;286
75;Nouvelle-Aquitaine;47;3;09;077;Cuzorn;851;18;869
75;Nouvelle-Aquitaine;47;4;11;078;Damazan;1357;46;1403
75;Nouvelle-Aquitaine;47;3;16;079;Dausse;517;18;535
75;Nouvelle-Aquitaine;47;3;10;080;Dévillac;133;3;136
75;Nouvelle-Aquitaine;47;3;12;081;Dolmayrac;716;15;731
75;Nouvelle-Aquitaine;47;1;16;082;Dondas;216;1;217
75;Nouvelle-Aquitaine;47;3;10;083;Doudrac;104;1;105
75;Nouvelle-Aquitaine;47;3;19;084;Douzains;270;6;276
75;Nouvelle-Aquitaine;47;4;08;085;Durance;297;3;300
75;Nouvelle-Aquitaine;47;2;07;086;Duras;1219;20;1239
75;Nouvelle-Aquitaine;47;1;16;087;Engayrac;163;9;172
75;Nouvelle-Aquitaine;47;2;07;088;Escassefort;614;9;623
75;Nouvelle-Aquitaine;47;2;07;089;Esclottes;150;2;152
75;Nouvelle-Aquitaine;47;4;05;090;Espiens;366;8;374
75;Nouvelle-Aquitaine;47;1;15;091;Estillac;2189;41;2230
75;Nouvelle-Aquitaine;47;1;17;092;Fals;392;6;398
75;Nouvelle-Aquitaine;47;4;08;093;Fargues-sur-Ourbise;347;9;356
75;Nouvelle-Aquitaine;47;2;14;094;Fauguerolles;810;15;825
75;Nouvelle-Aquitaine;47;2;18;095;Fauillet;863;19;882
75;Nouvelle-Aquitaine;47;3;19;096;Ferrensac;205;5;210
75;Nouvelle-Aquitaine;47;4;11;097;Feugarolles;1010;21;1031
75;Nouvelle-Aquitaine;47;4;05;098;Fieux;356;9;365
75;Nouvelle-Aquitaine;47;3;12;099;Fongrave;622;16;638
75;Nouvelle-Aquitaine;47;1;01;100;Foulayronnes;5449;219;5668
75;Nouvelle-Aquitaine;47;2;14;101;Fourques-sur-Garonne;1330;28;1358
75;Nouvelle-Aquitaine;47;4;05;102;Francescas;737;11;748
75;Nouvelle-Aquitaine;47;4;05;103;Fréchou;230;4;234
75;Nouvelle-Aquitaine;47;1;06;104;Frégimont;253;4;257
75;Nouvelle-Aquitaine;47;3;16;105;Frespech;282;5;287
75;Nouvelle-Aquitaine;47;3;09;106;Fumel;4755;99;4854
75;Nouvelle-Aquitaine;47;1;06;107;Galapian;308;6;314
75;Nouvelle-Aquitaine;47;2;13;108;Gaujac;246;7;253
75;Nouvelle-Aquitaine;47;3;10;109;Gavaudun;291;5;296
75;Nouvelle-Aquitaine;47;2;14;110;Gontaud-de-Nogaret;1651;28;1679
75;Nouvelle-Aquitaine;47;1;06;111;Granges-sur-Lot;589;17;606
75;Nouvelle-Aquitaine;47;2;18;112;Grateloup-Saint-Gayrand;422;13;435
75;Nouvelle-Aquitaine;47;1;17;113;Grayssas;141;3;144
75;Nouvelle-Aquitaine;47;2;08;114;Grézet-Cavagnan;396;1;397
75;Nouvelle-Aquitaine;47;2;08;115;Guérin;254;7;261
75;Nouvelle-Aquitaine;47;3;21;117;Hautefage-la-Tour;1014;16;1030
75;Nouvelle-Aquitaine;47;2;18;118;Hautesvignes;186;1;187
75;Nouvelle-Aquitaine;47;4;08;119;Houeillès;556;8;564
75;Nouvelle-Aquitaine;47;2;07;120;Jusix;102;3;105
75;Nouvelle-Aquitaine;47;2;08;121;Labastide-Castel-Amouroux;302;0;302
75;Nouvelle-Aquitaine;47;2;18;122;Labretonie;186;2;188
75;Nouvelle-Aquitaine;47;3;09;123;Lacapelle-Biron;418;5;423
75;Nouvelle-Aquitaine;47;3;10;124;Lacaussade;212;6;218
75;Nouvelle-Aquitaine;47;1;06;125;Lacépède;314;7;321
75;Nouvelle-Aquitaine;47;2;07;126;Lachapelle;95;1;96
75;Nouvelle-Aquitaine;47;2;18;127;Lafitte-sur-Lot;822;12;834
75;Nouvelle-Aquitaine;47;1;17;128;Lafox;1116;29;1145
75;Nouvelle-Aquitaine;47;1;06;129;Lagarrigue;278;6;284
75;Nouvelle-Aquitaine;47;2;08;130;Lagruère;327;5;332
75;Nouvelle-Aquitaine;47;2;07;131;Lagupie;699;15;714
75;Nouvelle-Aquitaine;47;3;19;132;Lalandusse;224;4;228
75;Nouvelle-Aquitaine;47;4;05;133;Lamontjoie;601;8;609
75;Nouvelle-Aquitaine;47;4;05;134;Lannes;366;9;375
75;Nouvelle-Aquitaine;47;2;18;135;Laparade;383;8;391
75;Nouvelle-Aquitaine;47;2;19;136;Laperche;136;2;138
75;Nouvelle-Aquitaine;47;1;15;137;Laplume;1344;32;1376
75;Nouvelle-Aquitaine;47;1;16;138;Laroque-Timbaut;1638;24;1662
75;Nouvelle-Aquitaine;47;4;05;139;Lasserre;88;1;89
75;Nouvelle-Aquitaine;47;1;06;140;Laugnac;687;15;702
75;Nouvelle-Aquitaine;47;3;10;141;Laussou;283;6;289
75;Nouvelle-Aquitaine;47;2;19;142;Lauzun;763;6;769
75;Nouvelle-Aquitaine;47;4;11;143;Lavardac;2263;59;2322
75;Nouvelle-Aquitaine;47;2;19;144;Lavergne;574;20;594
75;Nouvelle-Aquitaine;47;1;17;145;Layrac;3686;56;3742
75;Nouvelle-Aquitaine;47;3;20;146;Lédat;1410;29;1439
75;Nouvelle-Aquitaine;47;2;07;147;Lévignac-de-Guyenne;684;11;695
75;Nouvelle-Aquitaine;47;4;08;148;Leyritz-Moncassin;204;1;205
75;Nouvelle-Aquitaine;47;2;14;150;Longueville;367;6;373
75;Nouvelle-Aquitaine;47;2;07;151;Loubès-Bernac;423;3;426
75;Nouvelle-Aquitaine;47;3;19;152;Lougratte;403;10;413
75;Nouvelle-Aquitaine;47;1;06;154;Lusignan-Petit;372;4;376
75;Nouvelle-Aquitaine;47;1;06;155;Madaillan;651;16;667
75;Nouvelle-Aquitaine;47;2;13;156;Marcellus;856;8;864
75;Nouvelle-Aquitaine;47;2;98;157;Marmande;17421;587;18008
75;Nouvelle-Aquitaine;47;1;15;158;Marmont-Pachas;174;3;177
75;Nouvelle-Aquitaine;47;2;08;159;Le Mas-d'Agenais;1483;34;1517
75;Nouvelle-Aquitaine;47;3;09;160;Masquières;183;2;185
75;Nouvelle-Aquitaine;47;3;16;161;Massels;116;1;117
75;Nouvelle-Aquitaine;47;3;16;162;Massoulès;217;5;222
75;Nouvelle-Aquitaine;47;2;07;163;Mauvezin-sur-Gupie;607;8;615
75;Nouvelle-Aquitaine;47;3;10;164;Mazières-Naresse;112;3;115
75;Nouvelle-Aquitaine;47;2;13;165;Meilhan-sur-Garonne;1330;59;1389
75;Nouvelle-Aquitaine;47;4;05;167;Mézin;1469;26;1495
75;Nouvelle-Aquitaine;47;2;19;168;Miramont-de-Guyenne;3092;102;3194
75;Nouvelle-Aquitaine;47;1;15;169;Moirax;1177;54;1231
75;Nouvelle-Aquitaine;47;3;10;170;Monbahus;615;23;638
75;Nouvelle-Aquitaine;47;1;16;171;Monbalen;437;8;445
75;Nouvelle-Aquitaine;47;4;05;172;Moncaut;594;18;612
75;Nouvelle-Aquitaine;47;3;12;173;Monclar;882;11;893
75;Nouvelle-Aquitaine;47;4;05;174;Moncrabeau;736;17;753
75;Nouvelle-Aquitaine;47;3;10;175;Monflanquin;2329;54;2383
75;Nouvelle-Aquitaine;47;4;11;176;Mongaillard;174;12;186
75;Nouvelle-Aquitaine;47;4;11;177;Monheurt;191;4;195
75;Nouvelle-Aquitaine;47;3;10;178;Monségur;402;8;410
75;Nouvelle-Aquitaine;47;3;09;179;Monsempron-Libos;2033;28;2061
75;Nouvelle-Aquitaine;47;4;05;180;Montagnac-sur-Auvignon;631;14;645
75;Nouvelle-Aquitaine;47;3;10;181;Montagnac-sur-Lède;271;3;274
75;Nouvelle-Aquitaine;47;3;12;182;Montastruc;246;1;247
75;Nouvelle-Aquitaine;47;3;19;183;Montauriol;166;6;172
75;Nouvelle-Aquitaine;47;3;10;184;Montaut;260;4;264
75;Nouvelle-Aquitaine;47;3;09;185;Montayral;2652;68;2720
75;Nouvelle-Aquitaine;47;4;11;186;Montesquieu;773;12;785
75;Nouvelle-Aquitaine;47;2;07;187;Monteton;328;2;330
75;Nouvelle-Aquitaine;47;2;19;188;Montignac-de-Lauzun;291;4;295
75;Nouvelle-Aquitaine;47;2;07;189;Montignac-Toupinerie;148;0;148
75;Nouvelle-Aquitaine;47;1;06;190;Montpezat;549;45;594
75;Nouvelle-Aquitaine;47;2;13;191;Montpouillan;846;9;855
75;Nouvelle-Aquitaine;47;3;10;192;Monviel;78;1;79
75;Nouvelle-Aquitaine;47;3;10;193;Moulinet;199;4;203
75;Nouvelle-Aquitaine;47;2;07;194;Moustier;321;5;326
75;Nouvelle-Aquitaine;47;4;05;195;Nérac;6837;507;7344
75;Nouvelle-Aquitaine;47;1;06;196;Nicole;215;3;218
75;Nouvelle-Aquitaine;47;4;05;197;Nomdieu;254;2;256
75;Nouvelle-Aquitaine;47;3;10;198;Pailloles;335;6;341
75;Nouvelle-Aquitaine;47;2;07;199;Pardaillan;316;5;321
75;Nouvelle-Aquitaine;47;3;10;200;Parranquet;114;1;115
75;Nouvelle-Aquitaine;47;1;04;201;Le Passage;9400;170;9570
75;Nouvelle-Aquitaine;47;3;10;202;Paulhiac;309;7;316
75;Nouvelle-Aquitaine;47;3;16;203;Penne-d'Agenais;2341;50;2391
75;Nouvelle-Aquitaine;47;2;19;204;Peyrière;283;3;286
75;Nouvelle-Aquitaine;47;4;08;205;Pindères;201;8;209
75;Nouvelle-Aquitaine;47;3;12;206;Pinel-Hauterive;564;5;569
75;Nouvelle-Aquitaine;47;4;11;207;Pompiey;205;5;210
75;Nouvelle-Aquitaine;47;4;08;208;Pompogne;199;6;205
75;Nouvelle-Aquitaine;47;1;01;209;Pont-du-Casse;4141;118;4259
75;Nouvelle-Aquitaine;47;1;06;210;Port-Sainte-Marie;1846;30;1876
75;Nouvelle-Aquitaine;47;4;05;211;Poudenas;223;7;230
75;Nouvelle-Aquitaine;47;2;08;212;Poussignac;289;6;295
75;Nouvelle-Aquitaine;47;1;06;213;Prayssas;995;27;1022
75;Nouvelle-Aquitaine;47;4;11;214;Puch-d'Agenais;681;13;694
75;Nouvelle-Aquitaine;47;3;21;215;Pujols;3675;138;3813
75;Nouvelle-Aquitaine;47;2;07;216;Puymiclan;679;13;692
75;Nouvelle-Aquitaine;47;1;17;217;Puymirol;919;15;934
75;Nouvelle-Aquitaine;47;2;19;218;Puysserampion;240;4;244
75;Nouvelle-Aquitaine;47;3;10;219;Rayet;180;2;182
75;Nouvelle-Aquitaine;47;4;11;220;Razimet;298;5;303
75;Nouvelle-Aquitaine;47;4;05;221;Réaup-Lisse;606;18;624
75;Nouvelle-Aquitaine;47;4;08;222;La Réunion;486;9;495
75;Nouvelle-Aquitaine;47;3;10;223;Rives;203;7;210
75;Nouvelle-Aquitaine;47;2;08;224;Romestaing;161;6;167
75;Nouvelle-Aquitaine;47;1;15;225;Roquefort;2048;39;2087
75;Nouvelle-Aquitaine;47;2;19;226;Roumagne;528;9;537
75;Nouvelle-Aquitaine;47;2;08;227;Ruffiac;177;2;179
75;Nouvelle-Aquitaine;47;3;21;228;Saint-Antoine-de-Ficalba;717;10;727
75;Nouvelle-Aquitaine;47;2;07;229;Saint-Astier;223;5;228
75;Nouvelle-Aquitaine;47;3;10;230;Saint-Aubin;395;9;404
75;Nouvelle-Aquitaine;47;2;07;231;Saint-Avit;175;2;177
75;Nouvelle-Aquitaine;47;2;07;232;Saint-Barthélemy-d'Agenais;520;3;523
75;Nouvelle-Aquitaine;47;2;13;233;Sainte-Bazeille;3160;98;3258
75;Nouvelle-Aquitaine;47;1;17;234;Saint-Caprais-de-Lerm;663;20;683
75;Nouvelle-Aquitaine;47;2;19;235;Saint-Colomb-de-Lauzun;471;4;475
75;Nouvelle-Aquitaine;47;2;07;236;Sainte-Colombe-de-Duras;106;1;107
75;Nouvelle-Aquitaine;47;3;21;237;Sainte-Colombe-de-Villeneuve;502;11;513
75;Nouvelle-Aquitaine;47;1;15;238;Sainte-Colombe-en-Bruilhois;1586;53;1639
75;Nouvelle-Aquitaine;47;3;12;239;Saint-Étienne-de-Fougères;850;13;863
75;Nouvelle-Aquitaine;47;3;10;240;Saint-Étienne-de-Villeréal;279;10;289
75;Nouvelle-Aquitaine;47;3;10;241;Saint-Eutrope-de-Born;678;18;696
75;Nouvelle-Aquitaine;47;3;09;242;Saint-Front-sur-Lémance;518;13;531
75;Nouvelle-Aquitaine;47;2;08;244;Sainte-Gemme-Martaillac;387;5;392
75;Nouvelle-Aquitaine;47;2;07;245;Saint-Géraud;93;2;95
75;Nouvelle-Aquitaine;47;1;15;246;Saint-Hilaire-de-Lusignan;1491;39;1530
75;Nouvelle-Aquitaine;47;2;07;247;Saint-Jean-de-Duras;248;10;258
75;Nouvelle-Aquitaine;47;1;17;248;Saint-Jean-de-Thurac;571;7;578
75;Nouvelle-Aquitaine;47;4;11;249;Saint-Laurent;523;4;527
75;Nouvelle-Aquitaine;47;4;11;250;Saint-Léger;123;4;127
75;Nouvelle-Aquitaine;47;4;11;251;Saint-Léon;320;5;325
75;Nouvelle-Aquitaine;47;3;12;252;Sainte-Livrade-sur-Lot;6456;175;6631
75;Nouvelle-Aquitaine;47;2;08;253;Sainte-Marthe;645;5;650
75;Nouvelle-Aquitaine;47;4;08;254;Saint-Martin-Curton;308;8;316
75;Nouvelle-Aquitaine;47;1;16;255;Saint-Martin-de-Beauville;174;3;177
75;Nouvelle-Aquitaine;47;3;10;256;Saint-Martin-de-Villeréal;102;4;106
75;Nouvelle-Aquitaine;47;2;07;257;Saint-Martin-Petit;613;8;621
75;Nouvelle-Aquitaine;47;4;05;258;Sainte-Maure-de-Peyriac;312;10;322
75;Nouvelle-Aquitaine;47;3;10;259;Saint-Maurice-de-Lestapel;103;4;107
75;Nouvelle-Aquitaine;47;1;16;260;Saint-Maurin;415;5;420
75;Nouvelle-Aquitaine;47;1;17;262;Saint-Nicolas-de-la-Balerme;423;4;427
75;Nouvelle-Aquitaine;47;2;14;263;Saint-Pardoux-du-Breuil;608;15;623
75;Nouvelle-Aquitaine;47;2;19;264;Saint-Pardoux-Isaac;1105;19;1124
75;Nouvelle-Aquitaine;47;3;12;265;Saint-Pastour;377;8;385
75;Nouvelle-Aquitaine;47;4;05;266;Saint-Pé-Saint-Simon;198;2;200
75;Nouvelle-Aquitaine;47;4;11;267;Saint-Pierre-de-Buzet;295;2;297
75;Nouvelle-Aquitaine;47;1;17;269;Saint-Pierre-de-Clairac;844;19;863
75;Nouvelle-Aquitaine;47;2;07;271;Saint-Pierre-sur-Dropt;358;3;361
75;Nouvelle-Aquitaine;47;3;19;272;Saint-Quentin-du-Dropt;194;7;201
75;Nouvelle-Aquitaine;47;1;16;273;Saint-Robert;187;6;193
75;Nouvelle-Aquitaine;47;1;17;274;Saint-Romain-le-Noble;396;6;402
75;Nouvelle-Aquitaine;47;1;06;275;Saint-Salvy;201;1;202
75;Nouvelle-Aquitaine;47;1;06;276;Saint-Sardos;299;7;306
75;Nouvelle-Aquitaine;47;2;13;277;Saint-Sauveur-de-Meilhan;337;1;338
75;Nouvelle-Aquitaine;47;2;07;278;Saint-Sernin;475;9;484
75;Nouvelle-Aquitaine;47;1;17;279;Saint-Sixte;353;6;359
75;Nouvelle-Aquitaine;47;3;16;280;Saint-Sylvestre-sur-Lot;2324;53;2377
75;Nouvelle-Aquitaine;47;1;17;281;Saint-Urcisse;249;1;250
75;Nouvelle-Aquitaine;47;4;05;282;Saint-Vincent-de-Lamontjoie;233;7;240
75;Nouvelle-Aquitaine;47;3;09;283;Saint-Vite;1163;30;1193
75;Nouvelle-Aquitaine;47;3;10;284;Salles;293;7;300
75;Nouvelle-Aquitaine;47;2;14;285;Samazan;895;17;912
75;Nouvelle-Aquitaine;47;4;08;286;Sauméjan;106;0;106
75;Nouvelle-Aquitaine;47;4;05;287;Saumont;266;3;269
75;Nouvelle-Aquitaine;47;1;17;288;Sauvagnas;524;14;538
75;Nouvelle-Aquitaine;47;1;16;289;La Sauvetat-de-Savères;524;11;535
75;Nouvelle-Aquitaine;47;2;07;290;La Sauvetat-du-Dropt;549;6;555
75;Nouvelle-Aquitaine;47;3;10;291;La Sauvetat-sur-Lède;630;16;646
75;Nouvelle-Aquitaine;47;3;09;292;Sauveterre-la-Lémance;576;6;582
75;Nouvelle-Aquitaine;47;1;17;293;Sauveterre-Saint-Denis;387;18;405
75;Nouvelle-Aquitaine;47;2;07;294;Savignac-de-Duras;219;1;220
75;Nouvelle-Aquitaine;47;3;10;295;Savignac-sur-Leyze;304;6;310
75;Nouvelle-Aquitaine;47;2;19;296;Ségalas;155;2;157
75;Nouvelle-Aquitaine;47;3;06;297;Sembas;141;3;144
75;Nouvelle-Aquitaine;47;2;08;298;Sénestis;213;3;216
75;Nouvelle-Aquitaine;47;3;19;299;Sérignac-Péboudou;172;5;177
75;Nouvelle-Aquitaine;47;1;15;300;Sérignac-sur-Garonne;1172;20;1192
75;Nouvelle-Aquitaine;47;2;07;301;Seyches;1062;11;1073
75;Nouvelle-Aquitaine;47;4;05;302;Sos;651;7;658
75;Nouvelle-Aquitaine;47;2;07;303;Soumensac;226;9;235
75;Nouvelle-Aquitaine;47;2;14;304;Taillebourg;61;2;63
75;Nouvelle-Aquitaine;47;1;16;305;Tayrac;386;6;392
75;Nouvelle-Aquitaine;47;3;12;306;Le Temple-sur-Lot;1048;19;1067
75;Nouvelle-Aquitaine;47;3;09;307;Thézac;200;5;205
75;Nouvelle-Aquitaine;47;4;11;308;Thouars-sur-Garonne;222;3;225
75;Nouvelle-Aquitaine;47;3;12;309;Tombebœuf;456;4;460
75;Nouvelle-Aquitaine;47;2;18;310;Tonneins;9130;225;9355
75;Nouvelle-Aquitaine;47;3;10;311;Tourliac;133;8;141
75;Nouvelle-Aquitaine;47;3;09;312;Tournon-d'Agenais;761;13;774
75;Nouvelle-Aquitaine;47;3;12;313;Tourtrès;138;1;139
75;Nouvelle-Aquitaine;47;3;16;314;Trémons;395;10;405
75;Nouvelle-Aquitaine;47;3;09;315;Trentels;896;26;922
75;Nouvelle-Aquitaine;47;2;18;316;Varès;671;8;679
75;Nouvelle-Aquitaine;47;2;18;317;Verteuil-d'Agenais;569;5;574
75;Nouvelle-Aquitaine;47;4;11;318;Vianne;995;15;1010
75;Nouvelle-Aquitaine;47;3;12;319;Villebramar;107;3;110
75;Nouvelle-Aquitaine;47;4;08;320;Villefranche-du-Queyran;389;1;390
75;Nouvelle-Aquitaine;47;2;07;321;Villeneuve-de-Duras;315;5;320
75;Nouvelle-Aquitaine;47;3;99;323;Villeneuve-sur-Lot;21742;683;22425
75;Nouvelle-Aquitaine;47;3;10;324;Villeréal;1283;32;1315
75;Nouvelle-Aquitaine;47;2;08;325;Villeton;459;6;465
75;Nouvelle-Aquitaine;47;2;14;326;Virazeil;1677;34;1711
75;Nouvelle-Aquitaine;47;4;11;327;Xaintrailles;398;11;409
75;Nouvelle-Aquitaine;47;3;09;328;Saint-Georges;550;19;569
76;Occitanie;48;2;01;001;Albaret-le-Comtal;176;4;180
76;Occitanie;48;2;12;002;Albaret-Sainte-Marie;561;21;582
76;Occitanie;48;2;06;003;Allenc;253;5;258
76;Occitanie;48;2;13;004;Altier;213;10;223
76;Occitanie;48;2;08;005;Antrenas;330;8;338
76;Occitanie;48;2;01;007;Arzenc-d'Apcher;50;0;50
76;Occitanie;48;2;06;008;Arzenc-de-Randon;193;9;202
76;Occitanie;48;2;01;009;Peyre en Aubrac;2291;82;2373
76;Occitanie;48;2;07;010;Auroux;372;6;378
76;Occitanie;48;2;01;012;Les Monts-Verts;354;12;366
76;Occitanie;48;2;06;013;Badaroux;984;41;1025
76;Occitanie;48;2;13;015;Pied-de-Borne;178;12;190
76;Occitanie;48;2;03;016;Balsièges;558;18;576
76;Occitanie;48;2;02;017;Banassac-Canilhac;1067;36;1103
76;Occitanie;48;2;03;018;Barjac;769;18;787
76;Occitanie;48;1;04;019;Barre-des-Cévennes;203;9;212
76;Occitanie;48;1;04;020;Bassurels;65;0;65
76;Occitanie;48;2;13;021;La Bastide-Puylaurent;154;3;157
76;Occitanie;48;2;01;025;Les Bessons;426;25;451
76;Occitanie;48;2;12;026;Blavignac;265;1;266
76;Occitanie;48;2;13;027;Mont Lozère et Goulet;1039;49;1088
76;Occitanie;48;1;13;028;Les Bondons;144;10;154
76;Occitanie;48;2;06;029;Le Born;148;0;148
76;Occitanie;48;2;13;030;Brenoux;387;8;395
76;Occitanie;48;2;01;031;Brion;76;3;79
76;Occitanie;48;2;01;032;Le Buisson;222;6;228
76;Occitanie;48;2;02;034;La Canourgue;2122;98;2220
76;Occitanie;48;1;04;036;Cassagnas;127;2;129
76;Occitanie;48;2;06;037;Chadenet;120;2;122
76;Occitanie;48;2;06;038;Bel-Air-Val-d'Ance;543;7;550
76;Occitanie;48;2;02;039;Chanac;1467;33;1500
76;Occitanie;48;2;07;041;Chastanier;77;0;77
76;Occitanie;48;2;11;042;Chastel-Nouvel;900;35;935
76;Occitanie;48;2;06;043;Châteauneuf-de-Randon;527;8;535
76;Occitanie;48;2;01;044;Chauchailles;86;2;88
76;Occitanie;48;2;06;045;Chaudeyrac;292;11;303
76;Occitanie;48;2;11;046;Chaulhac;67;2;69
76;Occitanie;48;2;07;048;Cheylard-l'Évêque;63;3;66
76;Occitanie;48;1;13;050;Bédouès-Cocurès;451;15;466
76;Occitanie;48;1;04;051;Le Collet-de-Dèze;691;50;741
76;Occitanie;48;2;13;053;Cubières;189;8;197
76;Occitanie;48;2;13;054;Cubiérettes;50;5;55
76;Occitanie;48;2;03;055;Cultures;183;4;187
76;Occitanie;48;2;03;056;Esclanèdes;405;10;415
76;Occitanie;48;2;01;058;La Fage-Montivernoux;155;5;160
76;Occitanie;48;2;01;059;La Fage-Saint-Julien;307;5;312
76;Occitanie;48;1;05;061;Florac Trois Rivières;2067;43;2110
76;Occitanie;48;2;11;063;Fontans;226;3;229
76;Occitanie;48;2;01;064;Fournels;369;9;378
76;Occitanie;48;1;04;065;Fraissinet-de-Fourques;80;0;80
76;Occitanie;48;1;04;067;Gabriac;100;2;102
76;Occitanie;48;2;03;068;Gabrias;158;6;164
76;Occitanie;48;1;05;069;Gatuzières;53;0;53
76;Occitanie;48;2;06;070;Grandrieu;751;15;766
76;Occitanie;48;2;01;071;Grandvals;66;1;67
76;Occitanie;48;2;03;072;Grèzes;233;6;239
76;Occitanie;48;2;01;073;Les Hermaux;95;4;99
76;Occitanie;48;1;05;074;Hures-la-Parade;231;11;242
76;Occitanie;48;1;05;075;Ispagnac;897;27;924
76;Occitanie;48;2;11;077;Julianges;47;2;49
76;Occitanie;48;2;11;079;Lajo;114;3;117
76;Occitanie;48;2;07;080;Langogne;2887;193;3080
76;Occitanie;48;2;13;081;Lanuéjols;316;10;326
76;Occitanie;48;2;06;082;Laubert;99;3;102
76;Occitanie;48;2;11;083;Les Laubies;152;4;156
76;Occitanie;48;2;02;085;Laval-du-Tarn;94;4;98
76;Occitanie;48;2;07;086;Luc;209;5;214
76;Occitanie;48;2;01;087;Prinsuéjols-Malbouzon;265;10;275
76;Occitanie;48;1;02;088;La Malène;136;5;141
76;Occitanie;48;2;11;089;Le Malzieu-Forain;493;11;504
76;Occitanie;48;2;11;090;Le Malzieu-Ville;728;14;742
76;Occitanie;48;2;01;091;Marchastel;50;3;53
76;Occitanie;48;2;08;092;Marvejols;4684;244;4928
76;Occitanie;48;1;02;094;Massegros Causses Gorges;960;27;987
76;Occitanie;48;2;99;095;Mende;12318;829;13147
76;Occitanie;48;1;05;096;Meyrueis;807;119;926
76;Occitanie;48;1;04;097;Moissac-Vallée-Française;216;9;225
76;Occitanie;48;1;04;098;Molezon;96;4;100
76;Occitanie;48;2;03;099;Bourgs sur Colagne;2092;48;2140
76;Occitanie;48;2;06;100;Montbel;117;3;120
76;Occitanie;48;2;03;103;Montrodat;1193;71;1264
76;Occitanie;48;2;01;104;Nasbinals;557;32;589
76;Occitanie;48;2;07;105;Naussac-Fontanes;369;18;387
76;Occitanie;48;2;01;106;Noalhac;96;7;103
76;Occitanie;48;2;03;107;Palhers;179;7;186
76;Occitanie;48;2;06;108;La Panouse;76;2;78
76;Occitanie;48;2;11;110;Paulhac-en-Margeride;101;5;106
76;Occitanie;48;2;06;111;Pelouse;237;8;245
76;Occitanie;48;2;06;112;Pierrefiche;164;5;169
76;Occitanie;48;1;04;115;Le Pompidou;159;7;166
76;Occitanie;48;1;13;116;Pont de Montvert - Sud Mont Lozère;562;24;586
76;Occitanie;48;2;13;117;Pourcharesses;121;2;123
76;Occitanie;48;2;13;119;Prévenchères;250;13;263
76;Occitanie;48;2;12;121;Prunières;239;10;249
76;Occitanie;48;2;01;123;Recoules-d'Aubrac;172;6;178
76;Occitanie;48;2;08;124;Recoules-de-Fumas;104;0;104
76;Occitanie;48;2;08;126;Lachamp-Ribennes;358;12;370
76;Occitanie;48;2;11;127;Monts-de-Randon;1291;21;1312
76;Occitanie;48;2;12;128;Rimeize;593;21;614
76;Occitanie;48;2;07;129;Rocles;229;6;235
76;Occitanie;48;1;04;130;Rousses;124;1;125
76;Occitanie;48;1;05;131;Le Rozier;133;7;140
76;Occitanie;48;2;11;132;Saint-Alban-sur-Limagnole;1379;33;1412
76;Occitanie;48;2;13;135;Saint-André-Capcèze;182;0;182
76;Occitanie;48;1;04;136;Saint-André-de-Lancize;150;2;152
76;Occitanie;48;2;13;137;Saint-Bauzile;624;25;649
76;Occitanie;48;2;03;138;Saint-Bonnet-de-Chirac;67;2;69
76;Occitanie;48;2;07;139;Saint Bonnet-Laval;251;2;253
76;Occitanie;48;2;12;140;Saint-Chély-d'Apcher;4211;589;4800
76;Occitanie;48;1;05;141;Mas-Saint-Chély;107;6;113
76;Occitanie;48;1;04;144;Sainte-Croix-Vallée-Française;269;9;278
76;Occitanie;48;2;11;145;Saint-Denis-en-Margeride;156;7;163
76;Occitanie;48;1;05;146;Gorges du Tarn Causses;909;33;942
76;Occitanie;48;2;13;147;Saint-Étienne-du-Valdonnez;643;51;694
76;Occitanie;48;1;04;148;Saint-Étienne-Vallée-Française;505;27;532
76;Occitanie;48;2;11;149;Sainte-Eulalie;36;2;38
76;Occitanie;48;2;07;150;Saint-Flour-de-Mercoire;188;14;202
76;Occitanie;48;2;06;151;Saint-Frézal-d'Albuges;63;3;66
76;Occitanie;48;1;04;152;Ventalon en Cévennes;267;5;272
76;Occitanie;48;2;11;153;Saint-Gal;88;5;93
76;Occitanie;48;1;04;155;Saint-Germain-de-Calberte;465;6;471
76;Occitanie;48;2;03;156;Saint-Germain-du-Teil;870;23;893
76;Occitanie;48;2;06;157;Sainte-Hélène;107;4;111
76;Occitanie;48;1;04;158;Saint-Hilaire-de-Lavit;104;4;108
76;Occitanie;48;2;06;160;Saint-Jean-la-Fouillouse;156;7;163
76;Occitanie;48;2;01;161;Saint-Juéry;69;2;71
76;Occitanie;48;1;04;163;Saint-Julien-des-Points;114;3;117
76;Occitanie;48;2;01;165;Saint-Laurent-de-Muret;186;10;196
76;Occitanie;48;1;04;166;Cans et Cévennes;289;11;300
76;Occitanie;48;2;01;167;Saint-Laurent-de-Veyrès;37;1;38
76;Occitanie;48;2;08;168;Saint-Léger-de-Peyre;190;5;195
76;Occitanie;48;2;11;169;Saint-Léger-du-Malzieu;210;11;221
76;Occitanie;48;1;04;170;Saint-Martin-de-Boubaux;198;5;203
76;Occitanie;48;1;04;171;Saint-Martin-de-Lansuscle;191;2;193
76;Occitanie;48;1;04;173;Saint-Michel-de-Dèze;230;3;233
76;Occitanie;48;2;06;174;Saint-Paul-le-Froid;139;3;142
76;Occitanie;48;2;01;175;Saint-Pierre-de-Nogaret;176;10;186
76;Occitanie;48;1;05;176;Saint-Pierre-des-Tripiers;90;4;94
76;Occitanie;48;2;12;177;Saint-Pierre-le-Vieux;322;9;331
76;Occitanie;48;1;04;178;Saint-Privat-de-Vallongue;222;6;228
76;Occitanie;48;2;11;179;Saint-Privat-du-Fau;113;2;115
76;Occitanie;48;2;02;181;Saint-Saturnin;63;4;67
76;Occitanie;48;2;06;182;Saint-Sauveur-de-Ginestoux;58;2;60
76;Occitanie;48;2;03;185;Les Salelles;165;5;170
76;Occitanie;48;2;01;187;Les Salces;101;1;102
76;Occitanie;48;2;11;188;Serverette;244;5;249
76;Occitanie;48;2;01;190;Termes;215;8;223
76;Occitanie;48;2;02;191;La Tieule;94;3;97
76;Occitanie;48;2;01;192;Trélans;92;2;94
76;Occitanie;48;1;04;193;Vebron;214;1;215
76;Occitanie;48;1;13;194;Vialas;424;48;472
76;Occitanie;48;2;13;198;Villefort;548;12;560
52;Pays de la Loire;49;3;15;002;Allonnes;2975;53;3028
52;Pays de la Loire;49;3;14;003;Tuffalun;1752;37;1789
52;Pays de la Loire;49;1;98;007;Angers;155850;3080;158930
52;Pays de la Loire;49;4;20;008;Angrie;931;25;956
52;Pays de la Loire;49;3;14;009;Antoigné;460;4;464
52;Pays de la Loire;49;4;20;010;Armaillé;319;5;324
52;Pays de la Loire;49;3;19;011;Artannes-sur-Thouet;428;18;446
52;Pays de la Loire;49;1;11;012;Aubigné-sur-Layon;368;11;379
52;Pays de la Loire;49;1;04;015;Avrillé;14443;357;14800
52;Pays de la Loire;49;1;21;017;Baracé;604;6;610
52;Pays de la Loire;49;3;08;018;Baugé-en-Anjou;11829;261;12090
52;Pays de la Loire;49;1;03;020;Beaucouzé;5439;107;5546
52;Pays de la Loire;49;3;08;021;Beaufort-en-Anjou;7229;154;7383
52;Pays de la Loire;49;1;11;022;Beaulieu-sur-Layon;1368;29;1397
52;Pays de la Loire;49;2;09;023;Beaupréau-en-Mauges;23419;716;24135
52;Pays de la Loire;49;4;10;026;Bécon-les-Granits;2789;90;2879
52;Pays de la Loire;49;2;09;027;Bégrolles-en-Mauges;2107;42;2149
52;Pays de la Loire;49;1;03;028;Béhuard;125;6;131
52;Pays de la Loire;49;1;17;029;Blaison-Saint-Sulpice;1293;28;1321
52;Pays de la Loire;49;3;15;030;Blou;975;32;1007
52;Pays de la Loire;49;1;02;035;Bouchemaine;6774;141;6915
52;Pays de la Loire;49;4;20;036;Bouillé-Ménard;751;20;771
52;Pays de la Loire;49;4;20;038;Bourg-l'Évêque;240;5;245
52;Pays de la Loire;49;3;15;041;Brain-sur-Allonnes;2039;35;2074
52;Pays de la Loire;49;3;15;045;La Breille-les-Pins;600;14;614
52;Pays de la Loire;49;1;05;048;Briollay;3084;41;3125
52;Pays de la Loire;49;1;86;050;Brissac Loire Aubance;10851;274;11125
52;Pays de la Loire;49;3;14;053;Brossay;350;4;354
52;Pays de la Loire;49;4;20;054;Candé;2824;62;2886
52;Pays de la Loire;49;1;05;055;Cantenay-Épinard;2317;35;2352
52;Pays de la Loire;49;4;20;056;Carbay;263;6;269
52;Pays de la Loire;49;2;13;057;Cernusson;337;6;343
52;Pays de la Loire;49;2;13;058;Les Cerqueux;877;9;886
52;Pays de la Loire;49;3;14;060;Bellevigne-les-Châteaux;3482;80;3562
52;Pays de la Loire;49;4;20;061;Challain-la-Potherie;797;19;816
52;Pays de la Loire;49;1;10;063;Chalonnes-sur-Loire;6518;175;6693
52;Pays de la Loire;49;4;21;064;Chambellay;397;12;409
52;Pays de la Loire;49;4;21;067;Chenillé-Champteussé;342;8;350
52;Pays de la Loire;49;1;10;068;Champtocé-sur-Loire;1864;31;1895
52;Pays de la Loire;49;2;16;069;Orée d'Anjou;16429;277;16706
52;Pays de la Loire;49;2;13;070;Chanteloup-les-Bois;694;10;704
52;Pays de la Loire;49;1;06;076;La Chapelle-Saint-Laud;763;7;770
52;Pays de la Loire;49;4;21;080;Les Hauts-d'Anjou;8759;185;8944
52;Pays de la Loire;49;1;10;082;Chaudefonds-sur-Layon;941;17;958
52;Pays de la Loire;49;1;11;086;Terranjou;3994;84;4078
52;Pays de la Loire;49;4;20;089;Chazé-sur-Argos;1053;28;1081
52;Pays de la Loire;49;1;21;090;Cheffes;974;12;986
52;Pays de la Loire;49;2;11;092;Chemillé-en-Anjou;20828;604;21432
52;Pays de la Loire;49;2;99;099;Cholet;54037;1942;55979
52;Pays de la Loire;49;3;14;100;Cizay-la-Madeleine;469;17;486
52;Pays de la Loire;49;2;13;102;Cléré-sur-Layon;337;5;342
52;Pays de la Loire;49;1;06;107;Cornillé-les-Caves;467;16;483
52;Pays de la Loire;49;2;13;109;Coron;1580;30;1610
52;Pays de la Loire;49;1;06;110;Corzé;1886;32;1918
52;Pays de la Loire;49;3;14;112;Le Coudray-Macouard;947;28;975
52;Pays de la Loire;49;3;14;113;Courchamps;519;9;528
52;Pays de la Loire;49;3;15;114;Courléon;145;4;149
52;Pays de la Loire;49;1;10;120;Denée;1384;23;1407
52;Pays de la Loire;49;3;14;121;Dénezé-sous-Doué;480;9;489
52;Pays de la Loire;49;3;19;123;Distré;1732;55;1787
52;Pays de la Loire;49;3;14;125;Doué-en-Anjou;11119;257;11376
52;Pays de la Loire;49;1;21;127;Durtal;3358;75;3433
52;Pays de la Loire;49;1;05;129;Écouflant;4394;58;4452
52;Pays de la Loire;49;1;05;130;Écuillé;667;7;674
52;Pays de la Loire;49;3;14;131;Épieds;734;7;741
52;Pays de la Loire;49;1;21;132;Étriché;1547;17;1564
52;Pays de la Loire;49;1;05;135;Feneu;2192;38;2230
52;Pays de la Loire;49;3;08;138;Les Bois d'Anjou;2601;58;2659
52;Pays de la Loire;49;3;19;140;Fontevraud-l'Abbaye;1528;25;1553
52;Pays de la Loire;49;4;21;155;Grez-Neuville;1432;40;1472
52;Pays de la Loire;49;1;10;160;Ingrandes-Le Fresne sur Loire;2665;58;2723
52;Pays de la Loire;49;4;21;161;La Jaille-Yvon;334;6;340
52;Pays de la Loire;49;1;06;163;Jarzé Villages;2752;28;2780
52;Pays de la Loire;49;1;17;167;Les Garennes sur Loire;4567;111;4678
52;Pays de la Loire;49;4;21;170;Juvardeil;807;12;819
52;Pays de la Loire;49;3;15;171;La Lande-Chasles;123;0;123
52;Pays de la Loire;49;1;06;174;Huillé-Lézigné;1315;21;1336
52;Pays de la Loire;49;4;21;176;Le Lion-d'Angers;5023;76;5099
52;Pays de la Loire;49;4;20;178;Loiré;876;21;897
52;Pays de la Loire;49;3;15;180;Longué-Jumelles;6831;121;6952
52;Pays de la Loire;49;3;14;182;Louresse-Rochemenier;880;16;896
52;Pays de la Loire;49;4;10;183;Val d'Erdre-Auxence;4903;84;4987
52;Pays de la Loire;49;1;06;188;Marcé;837;15;852
52;Pays de la Loire;49;2;13;192;Maulévrier;3203;78;3281
52;Pays de la Loire;49;2;18;193;Le May-sur-Èvre;3820;90;3910
52;Pays de la Loire;49;3;08;194;Mazé-Milon;5925;105;6030
52;Pays de la Loire;49;2;13;195;Mazières-en-Mauges;1256;29;1285
52;Pays de la Loire;49;1;89;200;Longuenée-en-Anjou;6306;171;6477
52;Pays de la Loire;49;3;07;201;La Ménitré;2049;35;2084
52;Pays de la Loire;49;4;21;205;Miré;973;11;984
52;Pays de la Loire;49;1;21;209;Montigné-lès-Rairies;440;3;443
52;Pays de la Loire;49;2;13;211;Montilliers;1215;30;1245
52;Pays de la Loire;49;1;04;214;Montreuil-Juigné;7632;150;7782
52;Pays de la Loire;49;3;14;215;Montreuil-Bellay;3726;250;3976
52;Pays de la Loire;49;1;06;216;Montreuil-sur-Loir;590;6;596
52;Pays de la Loire;49;4;21;217;Montreuil-sur-Maine;775;10;785
52;Pays de la Loire;49;2;09;218;Montrevault-sur-Èvre;15668;317;15985
52;Pays de la Loire;49;3;19;219;Montsoreau;431;6;437
52;Pays de la Loire;49;1;21;220;Morannes sur Sarthe-Daumeray;3666;56;3722
52;Pays de la Loire;49;3;15;221;Mouliherne;820;23;843
52;Pays de la Loire;49;1;11;222;Mozé-sur-Louet;2013;45;2058
52;Pays de la Loire;49;1;17;223;Mûrs-Erigné;5660;101;5761
52;Pays de la Loire;49;3;15;224;Neuillé;991;10;1001
52;Pays de la Loire;49;3;08;228;Noyant-Villages;5546;167;5713
52;Pays de la Loire;49;2;13;231;Nuaillé;1454;37;1491
52;Pays de la Loire;49;3;19;235;Parnay;424;15;439
52;Pays de la Loire;49;2;13;236;Passavant-sur-Layon;125;5;130
52;Pays de la Loire;49;3;08;237;La Pellerine;132;2;134
52;Pays de la Loire;49;2;13;240;La Plaine;997;31;1028
52;Pays de la Loire;49;1;07;241;Le Plessis-Grammoire;2552;60;2612
52;Pays de la Loire;49;2;16;244;Mauges-sur-Loire;17924;475;18399
52;Pays de la Loire;49;1;17;246;Les Ponts-de-Cé;12819;541;13360
52;Pays de la Loire;49;1;10;247;La Possonnière;2447;42;2489
52;Pays de la Loire;49;4;20;248;Ombrée d'Anjou;8970;251;9221
52;Pays de la Loire;49;3;14;253;Le Puy-Notre-Dame;1186;21;1207
52;Pays de la Loire;49;1;21;257;Les Rairies;1028;16;1044
52;Pays de la Loire;49;1;10;259;Rochefort-sur-Loire;2323;59;2382
52;Pays de la Loire;49;2;18;260;La Romagne;1947;86;2033
52;Pays de la Loire;49;3;85;261;Gennes-Val-de-Loire;8570;169;8739
52;Pays de la Loire;49;3;19;262;Rou-Marson;652;9;661
52;Pays de la Loire;49;4;10;266;Saint-Augustin-des-Bois;1227;29;1256
52;Pays de la Loire;49;1;06;267;Saint-Barthélemy-d'Anjou;9210;228;9438
52;Pays de la Loire;49;2;18;269;Saint-Christophe-du-Bois;2794;60;2854
52;Pays de la Loire;49;1;03;271;Saint-Clément-de-la-Place;2098;28;2126
52;Pays de la Loire;49;3;15;272;Saint-Clément-des-Levées;1086;20;1106
52;Pays de la Loire;49;1;02;278;Sainte-Gemmes-sur-Loire;3456;254;3710
52;Pays de la Loire;49;1;10;283;Saint-Georges-sur-Loire;3665;39;3704
52;Pays de la Loire;49;1;10;284;Saint-Germain-des-Prés;1406;23;1429
52;Pays de la Loire;49;1;17;288;Saint-Jean-de-la-Croix;226;6;232
52;Pays de la Loire;49;3;14;291;Saint-Just-sur-Dive;376;5;381
52;Pays de la Loire;49;1;11;292;Val-du-Layon;3411;48;3459
52;Pays de la Loire;49;1;03;294;Saint-Lambert-la-Potherie;2924;30;2954
52;Pays de la Loire;49;1;03;298;Saint-Léger-de-Linières;3694;63;3757
52;Pays de la Loire;49;2;18;299;Saint-Léger-sous-Cholet;3018;70;3088
52;Pays de la Loire;49;2;18;301;Sèvremoine;25162;553;25715
52;Pays de la Loire;49;3;14;302;Saint-Macaire-du-Bois;451;5;456
52;Pays de la Loire;49;1;03;306;Saint-Martin-du-Fouilloux;1661;36;1697
52;Pays de la Loire;49;1;07;307;Loire-Authion;15902;575;16477
52;Pays de la Loire;49;1;17;308;Saint-Melaine-sur-Aubance;2127;54;2181
52;Pays de la Loire;49;2;13;310;Saint-Paul-du-Bois;597;19;616
52;Pays de la Loire;49;3;15;311;Saint-Philbert-du-Peuple;1323;28;1351
52;Pays de la Loire;49;4;10;321;Saint-Sigismond;387;8;395
52;Pays de la Loire;49;1;06;323;Verrières-en-Anjou;7520;297;7817
52;Pays de la Loire;49;1;07;326;Sarrigné;812;19;831
52;Pays de la Loire;49;3;19;328;Saumur;26467;982;27449
52;Pays de la Loire;49;1;03;329;Savennières;1336;50;1386
52;Pays de la Loire;49;4;21;330;Sceaux-d'Anjou;1180;18;1198
52;Pays de la Loire;49;4;20;331;Segré-en-Anjou Bleu;17462;833;18295
52;Pays de la Loire;49;2;18;332;La Séguinière;4192;112;4304
52;Pays de la Loire;49;1;06;333;Seiches-sur-le-Loir;2912;60;2972
52;Pays de la Loire;49;1;06;334;Sermaise;332;5;337
52;Pays de la Loire;49;2;13;336;Somloire;883;16;899
52;Pays de la Loire;49;1;17;338;Soulaines-sur-Aubance;1428;28;1456
52;Pays de la Loire;49;1;05;339;Soulaire-et-Bourg;1492;39;1531
52;Pays de la Loire;49;3;19;341;Souzay-Champigny;748;23;771
52;Pays de la Loire;49;2;13;343;La Tessoualle;3189;73;3262
52;Pays de la Loire;49;4;21;344;Thorigné-d'Anjou;1235;25;1260
52;Pays de la Loire;49;1;11;345;Bellevigne-en-Layon;5751;115;5866
52;Pays de la Loire;49;1;21;347;Tiercé;4432;73;4505
52;Pays de la Loire;49;2;13;352;Toutlemonde;1322;33;1355
52;Pays de la Loire;49;1;07;353;Trélazé;14961;168;15129
52;Pays de la Loire;49;2;13;355;Trémentines;3088;53;3141
52;Pays de la Loire;49;3;19;358;Turquant;571;14;585
52;Pays de la Loire;49;3;14;359;Les Ulmes;577;15;592
52;Pays de la Loire;49;3;15;361;Varennes-sur-Loire;1829;37;1866
52;Pays de la Loire;49;3;19;362;Varrains;1218;50;1268
52;Pays de la Loire;49;3;14;364;Vaudelnay;1131;22;1153
52;Pays de la Loire;49;4;87;367;Erdre-en-Anjou;5739;84;5823
52;Pays de la Loire;49;3;15;368;Vernantes;1993;39;2032
52;Pays de la Loire;49;3;15;369;Vernoil-le-Fourrier;1270;21;1291
52;Pays de la Loire;49;3;19;370;Verrie;480;7;487
52;Pays de la Loire;49;2;13;371;Vezins;1727;29;1756
52;Pays de la Loire;49;2;13;373;Lys-Haut-Layon;7789;177;7966
52;Pays de la Loire;49;3;15;374;Villebernier;1437;32;1469
52;Pays de la Loire;49;1;06;377;Rives-du-Loir-en-Anjou;5651;94;5745
52;Pays de la Loire;49;3;15;378;Vivy;2537;35;2572
52;Pays de la Loire;49;2;13;381;Yzernay;1813;30;1843
28;Normandie;50;4;22;002;Agneaux;4153;439;4592
28;Normandie;50;3;01;003;Agon-Coutainville;2796;95;2891
28;Normandie;50;4;18;004;Airel;549;3;552
28;Normandie;50;4;18;006;Amigny;154;5;159
28;Normandie;50;1;03;008;Anctoville-sur-Boscq;443;18;461
28;Normandie;50;2;26;013;Anneville-en-Saire;386;9;395
28;Normandie;50;3;20;015;Annoville;651;13;664
28;Normandie;50;3;05;016;Appeville;182;2;184
28;Normandie;50;1;19;019;Aucey-la-Plaine;419;6;425
28;Normandie;50;2;05;021;Audouville-la-Hubert;75;1;76
28;Normandie;50;2;26;022;Aumeville-Lestre;112;3;115
28;Normandie;50;4;05;023;Auvers;676;10;686
28;Normandie;50;3;01;024;Auxais;170;3;173
28;Normandie;50;1;84;025;Avranches;10264;555;10819
28;Normandie;50;2;25;026;Azeville;80;1;81
28;Normandie;50;1;02;027;Bacilly;956;27;983
28;Normandie;50;3;20;028;La Baleine;101;3;104
28;Normandie;50;1;16;029;Barenton;1175;65;1240
28;Normandie;50;2;26;030;Barfleur;559;8;567
28;Normandie;50;2;17;031;Barneville-Carteret;2239;56;2295
28;Normandie;50;4;23;032;La Barre-de-Semilly;1035;40;1075
28;Normandie;50;2;17;033;Baubigny;141;4;145
28;Normandie;50;4;23;034;Baudre;544;18;562
28;Normandie;50;3;05;036;Baupte;429;8;437
28;Normandie;50;1;03;038;Beauchamps;426;11;437
28;Normandie;50;4;09;039;Beaucoudray;126;4;130
28;Normandie;50;1;16;040;Beauficel;123;6;129
28;Normandie;50;2;14;041;La Hague;11173;336;11509
28;Normandie;50;1;19;042;Beauvoir;433;5;438
28;Normandie;50;3;20;044;Belval;321;2;323
28;Normandie;50;2;17;045;Benoîtville;608;23;631
28;Normandie;50;4;18;046;Bérigny;427;6;433
28;Normandie;50;4;27;048;Beslon;556;9;565
28;Normandie;50;2;04;049;Besneville;660;19;679
28;Normandie;50;4;09;050;Beuvrigny;138;0;138
28;Normandie;50;2;05;052;Beuzeville-la-Bastille;143;2;145
28;Normandie;50;4;09;054;Biéville;191;4;195
28;Normandie;50;2;04;055;Biniville;113;2;115
28;Normandie;50;3;01;058;Blainville-sur-Mer;1620;45;1665
28;Normandie;50;2;05;059;Blosville;324;1;325
28;Normandie;50;4;27;060;La Bloutière;436;8;444
28;Normandie;50;1;27;062;Boisyvon;116;0;116
28;Normandie;50;2;04;064;La Bonneville;178;7;185
28;Normandie;50;1;02;066;Jullouville;2367;79;2446
28;Normandie;50;4;27;069;Bourguenolles;345;12;357
28;Normandie;50;2;05;070;Boutteville;74;5;79
28;Normandie;50;3;10;072;Brainville;212;6;218
28;Normandie;50;1;15;074;Brécey;2139;146;2285
28;Normandie;50;1;03;076;Bréhal;3455;87;3542
28;Normandie;50;2;24;077;Bretteville;1037;44;1081
28;Normandie;50;3;11;078;Bretteville-sur-Ay;408;7;415
28;Normandie;50;2;04;079;Breuville;409;9;418
28;Normandie;50;1;03;081;Bréville-sur-Mer;771;29;800
28;Normandie;50;2;04;082;Bricquebec-en-Cotentin;5826;150;5976
28;Normandie;50;2;17;083;Bricquebosq;600;7;607
28;Normandie;50;3;10;084;Bricqueville-la-Blouette;544;18;562
28;Normandie;50;1;03;085;Bricqueville-sur-Mer;1223;41;1264
28;Normandie;50;2;26;086;Brillevast;324;5;329
28;Normandie;50;2;25;087;Brix;2155;53;2208
28;Normandie;50;1;16;088;Brouains;135;2;137
28;Normandie;50;1;21;090;Buais-Les-Monts;611;10;621
28;Normandie;50;3;10;092;Cambernon;704;16;720
28;Normandie;50;3;20;093;Cametours;419;5;424
28;Normandie;50;3;10;094;Camprond;411;9;420
28;Normandie;50;4;23;095;Canisy;1766;57;1823
28;Normandie;50;2;26;096;Canteloup;209;8;217
28;Normandie;50;2;11;097;Canville-la-Rocque;121;2;123
28;Normandie;50;4;23;098;Carantilly;622;15;637
28;Normandie;50;4;83;099;Carentan-les-Marais;10052;181;10233
28;Normandie;50;2;26;101;Carneville;235;6;241
28;Normandie;50;1;02;102;Carolles;748;16;764
28;Normandie;50;2;04;105;Catteville;97;5;102
28;Normandie;50;4;18;106;Cavigny;268;2;270
28;Normandie;50;1;19;108;Céaux;414;12;426
28;Normandie;50;1;03;109;Cérences;1779;39;1818
28;Normandie;50;4;18;110;Cerisy-la-Forêt;1036;19;1055
28;Normandie;50;3;20;111;Cerisy-la-Salle;1004;16;1020
28;Normandie;50;1;15;112;La Chaise-Baudouin;465;7;472
28;Normandie;50;1;03;115;Le Grippon;383;11;394
28;Normandie;50;1;02;117;Champeaux;351;12;363
28;Normandie;50;4;27;118;Champrepus;328;6;334
28;Normandie;50;1;03;120;Chanteloup;359;4;363
28;Normandie;50;1;27;121;La Chapelle-Cécelin;244;4;248
28;Normandie;50;1;15;124;La Chapelle-Urée;165;3;168
28;Normandie;50;1;02;126;Chavoy;133;7;140
28;Normandie;50;2;98;129;Cherbourg-en-Cotentin;78549;2363;80912
28;Normandie;50;4;27;130;Chérencé-le-Héron;427;6;433
28;Normandie;50;2;26;135;Clitourps;226;3;229
28;Normandie;50;4;27;137;La Colombe;627;14;641
28;Normandie;50;2;04;138;Colomby;550;10;560
28;Normandie;50;4;09;139;Condé-sur-Vire;4044;161;4205
28;Normandie;50;2;26;142;Vicq-sur-Mer;1054;13;1067
28;Normandie;50;1;03;143;Coudeville-sur-Mer;859;34;893
28;Normandie;50;1;27;144;Coulouvray-Boisbenâtre;540;5;545
28;Normandie;50;3;10;145;Courcy;592;13;605
28;Normandie;50;1;19;146;Courtils;235;2;237
28;Normandie;50;3;10;147;Coutances;8408;1173;9581
28;Normandie;50;4;18;148;Couvains;544;4;548
28;Normandie;50;2;08;149;Couville;1182;18;1200
28;Normandie;50;2;26;150;Crasville;228;3;231
28;Normandie;50;3;11;151;Créances;2093;29;2122
28;Normandie;50;1;15;152;Les Cresnays;225;3;228
28;Normandie;50;1;19;155;Crollon;298;13;311
28;Normandie;50;2;04;156;Crosville-sur-Douve;66;0;66
28;Normandie;50;1;15;158;Cuves;280;9;289
28;Normandie;50;4;23;159;Dangy;682;15;697
28;Normandie;50;4;18;161;Le Dézert;599;9;608
28;Normandie;50;2;24;162;Digosville;1598;44;1642
28;Normandie;50;4;09;164;Domjean;1006;26;1032
28;Normandie;50;1;13;165;Donville-les-Bains;3109;74;3183
28;Normandie;50;3;11;166;Doville;327;15;342
28;Normandie;50;1;02;167;Dragey-Ronthon;805;21;826
28;Normandie;50;1;19;168;Ducey-Les Chéris;2799;61;2860
28;Normandie;50;2;25;169;Écausseville;103;1;104
28;Normandie;50;2;25;172;Émondeville;350;8;358
28;Normandie;50;1;03;174;Équilly;196;9;205
28;Normandie;50;2;25;175;Éroudeville;196;8;204
28;Normandie;50;2;04;176;L'Étang-Bertrand;346;14;360
28;Normandie;50;2;04;177;Étienville;372;6;378
28;Normandie;50;2;26;178;Fermanville;1263;24;1287
28;Normandie;50;3;01;181;Feugères;330;8;338
28;Normandie;50;3;11;182;La Feuillie;287;8;295
28;Normandie;50;2;17;183;Fierville-les-Mines;346;6;352
28;Normandie;50;2;17;184;Flamanville;1766;22;1788
28;Normandie;50;4;27;185;Fleury;1045;24;1069
28;Normandie;50;2;25;186;Flottemanville;218;8;226
28;Normandie;50;1;03;188;Folligny;1084;26;1110
28;Normandie;50;2;25;190;Fontenay-sur-Mer;171;3;174
28;Normandie;50;4;09;192;Fourneaux;130;0;130
28;Normandie;50;1;16;193;Le Fresne-Poret;218;3;221
28;Normandie;50;2;25;194;Fresville;370;8;378
28;Normandie;50;1;16;195;Gathemo;254;2;256
28;Normandie;50;2;26;196;Gatteville-le-Phare;488;20;508
28;Normandie;50;3;20;197;Gavray-sur-Sienne;1956;25;1981
28;Normandie;50;3;01;198;Geffosses;471;11;482
28;Normandie;50;1;02;199;Genêts;447;4;451
28;Normandie;50;1;16;200;Ger;807;8;815
28;Normandie;50;1;15;205;La Godefroy;279;7;286
28;Normandie;50;2;04;207;Golleville;175;2;177
28;Normandie;50;3;01;208;Gonfreville;157;1;158
28;Normandie;50;2;26;209;Gonneville-Le Theil;1511;44;1555
28;Normandie;50;3;01;210;Gorges;342;8;350
28;Normandie;50;4;09;214;Gouvets;275;6;281
28;Normandie;50;3;01;215;Gouville-sur-Mer;3229;88;3317
28;Normandie;50;4;18;216;Graignes-Mesnil-Angot;805;91;896
28;Normandie;50;1;15;217;Le Grand-Celland;601;11;612
28;Normandie;50;1;13;218;Granville;12513;674;13187
28;Normandie;50;3;10;219;Gratot;667;12;679
28;Normandie;50;3;20;221;Grimesnil;59;2;61
28;Normandie;50;2;17;222;Grosville;785;21;806
28;Normandie;50;4;27;225;Le Guislain;143;1;144
28;Normandie;50;2;25;227;Le Ham;310;5;315
28;Normandie;50;3;20;228;Hambye;1105;32;1137
28;Normandie;50;1;21;229;Hamelin;87;1;88
28;Normandie;50;2;08;230;Hardinvast;883;34;917
28;Normandie;50;3;20;231;Hauteville-sur-Mer;686;23;709
28;Normandie;50;3;01;232;Hauteville-la-Guichard;473;18;491
28;Normandie;50;2;04;233;Hautteville-Bocage;159;5;164
28;Normandie;50;4;27;234;La Haye-Bellefond;77;0;77
28;Normandie;50;2;17;235;La Haye-d'Ectot;271;5;276
28;Normandie;50;3;11;236;La Haye;3971;118;4089
28;Normandie;50;1;03;237;La Haye-Pesnel;1258;25;1283
28;Normandie;50;2;17;238;Héauville;457;6;463
28;Normandie;50;4;22;239;Thèreval;1788;45;1833
28;Normandie;50;2;17;240;Helleville;547;8;555
28;Normandie;50;2;25;241;Hémevez;181;5;186
28;Normandie;50;3;10;243;Heugueville-sur-Sienne;499;16;515
28;Normandie;50;2;05;246;Hiesville;70;1;71
28;Normandie;50;1;03;247;Hocquigny;188;5;193
28;Normandie;50;2;25;251;Huberville;365;10;375
28;Normandie;50;1;03;252;Hudimesnil;908;16;924
28;Normandie;50;1;19;253;Huisnes-sur-Mer;170;7;177
28;Normandie;50;1;15;256;Isigny-le-Buat;3221;102;3323
28;Normandie;50;2;25;258;Joganville;112;3;115
28;Normandie;50;1;19;259;Juilley;641;26;667
28;Normandie;50;1;15;260;Juvigny les Vallées;1689;41;1730
28;Normandie;50;4;09;261;Lamberville;169;2;171
28;Normandie;50;4;27;262;La Lande-d'Airou;530;6;536
28;Normandie;50;1;21;263;Lapenty;364;10;374
28;Normandie;50;3;11;265;Laulne;196;2;198
28;Normandie;50;3;20;266;Lengronne;413;10;423
28;Normandie;50;3;11;267;Lessay;2236;55;2291
28;Normandie;50;2;25;268;Lestre;249;5;254
28;Normandie;50;2;05;269;Liesville-sur-Douve;206;6;212
28;Normandie;50;2;25;270;Lieusaint;399;12;411
28;Normandie;50;1;15;271;Lingeard;86;1;87
28;Normandie;50;3;20;272;Lingreville;1019;19;1038
28;Normandie;50;3;11;273;Montsenelle;1412;20;1432
28;Normandie;50;1;21;274;Les Loges-Marchis;1012;153;1165
28;Normandie;50;1;15;275;Les Loges-sur-Brécey;125;7;132
28;Normandie;50;1;02;276;Lolif;583;19;602
28;Normandie;50;1;03;277;Longueville;590;15;605
28;Normandie;50;1;03;278;Le Loreur;283;6;289
28;Normandie;50;4;22;279;Le Lorey;600;15;615
28;Normandie;50;1;03;281;La Lucerne-d'Outremer;772;19;791
28;Normandie;50;1;03;282;Le Luot;298;10;308
28;Normandie;50;4;23;283;La Luzerne;74;1;75
28;Normandie;50;2;04;285;Magneville;313;4;317
28;Normandie;50;1;02;288;Marcey-les-Grèves;1294;29;1323
28;Normandie;50;3;01;289;Marchésieux;720;12;732
28;Normandie;50;1;19;290;Marcilly;324;7;331
28;Normandie;50;4;27;291;Margueray;121;4;125
28;Normandie;50;4;22;292;Marigny-Le-Lozon;2687;58;2745
28;Normandie;50;2;08;294;Martinvast;1305;38;1343
28;Normandie;50;4;27;295;Maupertuis;143;2;145
28;Normandie;50;2;26;296;Maupertus-sur-Mer;220;9;229
28;Normandie;50;4;18;297;La Meauffe;1019;30;1049
28;Normandie;50;4;05;298;Méautis;646;13;659
28;Normandie;50;2;17;299;Le Mesnil;220;7;227
28;Normandie;50;1;15;300;Le Mesnil-Adelée;164;7;171
28;Normandie;50;4;22;302;Le Mesnil-Amey;286;7;293
28;Normandie;50;1;03;304;Le Mesnil-Aubert;195;7;202
28;Normandie;50;2;24;305;Le Mesnil-au-Val;733;18;751
28;Normandie;50;4;22;310;Le Mesnil-Eury;170;4;174
28;Normandie;50;3;20;311;Le Mesnil-Garnier;226;8;234
28;Normandie;50;1;15;312;Le Mesnil-Gilbert;134;4;138
28;Normandie;50;1;21;315;Le Mesnillard;248;8;256
28;Normandie;50;1;19;317;Le Mesnil-Ozenne;272;3;275
28;Normandie;50;4;18;321;Le Mesnil-Rouxelin;499;21;520
28;Normandie;50;4;18;324;Le Mesnil-Véneron;112;2;114
28;Normandie;50;3;20;326;Le Mesnil-Villeman;235;1;236
28;Normandie;50;1;03;327;La Meurdraquière;186;6;192
28;Normandie;50;3;11;328;Millières;776;14;790
28;Normandie;50;2;17;332;Les Moitiers-d'Allonne;711;15;726
28;Normandie;50;4;27;334;Montabot;276;3;279
28;Normandie;50;2;25;335;Montaigu-la-Brisette;501;9;510
28;Normandie;50;3;20;336;Montaigu-les-Bois;227;3;230
28;Normandie;50;4;27;338;Montbray;299;4;303
28;Normandie;50;3;01;340;Montcuit;189;4;193
28;Normandie;50;2;25;341;Montebourg;2106;104;2210
28;Normandie;50;2;26;342;Montfarville;802;27;829
28;Normandie;50;3;10;345;Monthuchon;691;20;711
28;Normandie;50;1;21;347;Montjoie-Saint-Martin;234;4;238
28;Normandie;50;3;20;349;Montmartin-sur-Mer;1374;35;1409
28;Normandie;50;3;20;350;Montpinchon;519;9;528
28;Normandie;50;4;09;351;Montrabot;92;2;94
28;Normandie;50;4;22;352;Montreuil-sur-Lozon;334;7;341
28;Normandie;50;1;19;353;Le Mont-Saint-Michel;29;0;29
28;Normandie;50;4;18;356;Moon-sur-Elle;804;20;824
28;Normandie;50;4;27;357;Morigny;72;1;73
28;Normandie;50;1;16;359;Mortain-Bocage;2929;265;3194
28;Normandie;50;2;04;360;Morville;276;12;288
28;Normandie;50;1;03;361;La Mouche;241;5;246
28;Normandie;50;1;21;362;Moulines;285;5;290
28;Normandie;50;4;09;363;Moyon Villages;1451;35;1486
28;Normandie;50;3;01;364;Muneville-le-Bingard;707;8;715
28;Normandie;50;1;03;365;Muneville-sur-Mer;489;10;499
28;Normandie;50;3;01;368;Nay;68;2;70
28;Normandie;50;2;04;369;Négreville;819;25;844
28;Normandie;50;2;04;370;Néhou;614;4;618
28;Normandie;50;1;16;371;Le Neufbourg;407;12;419
28;Normandie;50;3;11;372;Neufmesnil;180;3;183
28;Normandie;50;2;05;373;Neuville-au-Plain;89;4;93
28;Normandie;50;2;04;374;Neuville-en-Beaumont;27;1;28
28;Normandie;50;3;10;376;Nicorps;388;13;401
28;Normandie;50;3;20;378;Notre-Dame-de-Cenilly;634;9;643
28;Normandie;50;1;15;379;Notre-Dame-de-Livoye;159;3;162
28;Normandie;50;2;08;382;Nouainville;633;19;652
28;Normandie;50;2;26;384;Octeville-l'Avenel;221;3;224
28;Normandie;50;2;04;387;Orglandes;360;6;366
28;Normandie;50;3;10;388;Orval sur Sienne;1147;38;1185
28;Normandie;50;3;20;389;Ouville;443;12;455
28;Normandie;50;2;25;390;Ozeville;154;3;157
28;Normandie;50;1;21;391;Grandparigny;2643;92;2735
28;Normandie;50;4;27;393;Percy-en-Normandie;2600;106;2706
28;Normandie;50;3;01;394;Périers;2256;31;2287
28;Normandie;50;2;26;395;La Pernelle;271;4;275
28;Normandie;50;1;16;397;Perriers-en-Beauficel;210;6;216
28;Normandie;50;4;09;398;Le Perron;201;2;203
28;Normandie;50;1;15;399;Le Petit-Celland;178;4;182
28;Normandie;50;2;05;400;Picauville;3263;37;3300
28;Normandie;50;2;17;401;Pierreville;739;13;752
28;Normandie;50;2;17;402;Les Pieux;3220;88;3308
28;Normandie;50;3;11;403;Pirou;1432;37;1469
28;Normandie;50;3;11;405;Le Plessis-Lastelle;239;8;247
28;Normandie;50;1;19;407;Poilley;929;37;966
28;Normandie;50;1;19;408;Pontaubault;569;13;582
28;Normandie;50;4;18;409;Pont-Hébert;1924;210;2134
28;Normandie;50;1;19;410;Pontorson;4318;78;4396
28;Normandie;50;1;02;411;Ponts;678;15;693
28;Normandie;50;2;17;412;Port-Bail-sur-Mer;2556;68;2624
28;Normandie;50;1;19;413;Précey;574;6;580
28;Normandie;50;2;26;417;Quettehou;1779;30;1809
28;Normandie;50;3;20;419;Quettreville-sur-Sienne;3199;65;3264
28;Normandie;50;4;23;420;Quibou;865;23;888
28;Normandie;50;2;25;421;Quinéville;267;6;273
28;Normandie;50;3;01;422;Raids;193;0;193
28;Normandie;50;4;18;423;Rampan;201;6;207
28;Normandie;50;2;04;425;Rauville-la-Bigot;1116;26;1142
28;Normandie;50;2;04;426;Rauville-la-Place;370;6;376
28;Normandie;50;1;15;428;Reffuveille;513;4;517
28;Normandie;50;3;10;429;Regnéville-sur-Mer;741;32;773
28;Normandie;50;2;04;430;Reigneville-Bocage;39;3;42
28;Normandie;50;4;22;431;Remilly Les Marais;1072;12;1084
28;Normandie;50;2;26;433;Réville;1002;22;1024
28;Normandie;50;2;04;435;Rocheville;597;15;612
28;Normandie;50;1;16;436;Romagny Fontenay;1278;43;1321
28;Normandie;50;3;20;437;Roncey;799;10;809
28;Normandie;50;2;17;442;Le Rozel;250;6;256
28;Normandie;50;1;19;443;Sacey;516;10;526
28;Normandie;50;4;09;444;Saint-Amand-Villages;2500;57;2557
28;Normandie;50;4;05;445;Saint-André-de-Bohon;353;13;366
28;Normandie;50;4;18;446;Saint-André-de-l'Épine;544;13;557
28;Normandie;50;1;03;447;Saint-Aubin-des-Préaux;458;13;471
28;Normandie;50;1;21;448;Saint-Aubin-de-Terregatte;661;17;678
28;Normandie;50;1;16;450;Saint-Barthélemy;333;7;340
28;Normandie;50;1;15;451;Saint-Brice;127;2;129
28;Normandie;50;1;21;452;Saint-Brice-de-Landelles;664;22;686
28;Normandie;50;4;27;453;Sainte-Cécile;785;18;803
28;Normandie;50;2;17;454;Saint-Christophe-du-Foc;423;9;432
28;Normandie;50;4;18;455;Saint-Clair-sur-l'Elle;961;20;981
28;Normandie;50;1;16;456;Saint-Clément-Rancoudray;548;9;557
28;Normandie;50;2;04;457;Sainte-Colombe;196;5;201
28;Normandie;50;2;25;461;Saint-Cyr;198;9;207
28;Normandie;50;1;16;462;Saint-Cyr-du-Bailleul;369;8;377
28;Normandie;50;3;20;463;Saint-Denis-le-Gast;525;10;535
28;Normandie;50;3;20;464;Saint-Denis-le-Vêtu;632;5;637
28;Normandie;50;2;25;467;Saint-Floxel;494;13;507
28;Normandie;50;4;18;468;Saint-Fromond;770;15;785
28;Normandie;50;2;26;469;Sainte-Geneviève;313;7;320
28;Normandie;50;2;17;471;Saint-Georges-de-la-Rivière;284;11;295
28;Normandie;50;1;15;472;Saint-Georges-de-Livoye;204;10;214
28;Normandie;50;4;18;473;Saint-Georges-d'Elle;390;7;397
28;Normandie;50;1;16;474;Saint-Georges-de-Rouelley;545;11;556
28;Normandie;50;4;18;475;Saint-Georges-Montcocq;955;46;1001
28;Normandie;50;4;18;476;Saint-Germain-d'Elle;225;1;226
28;Normandie;50;2;25;478;Saint-Germain-de-Tournebut;426;7;433
28;Normandie;50;2;05;479;Saint-Germain-de-Varreville;110;4;114
28;Normandie;50;2;17;480;Saint-Germain-le-Gaillard;757;23;780
28;Normandie;50;3;11;481;Saint-Germain-sur-Ay;900;18;918
28;Normandie;50;3;01;482;Saint-Germain-sur-Sèves;162;3;165
28;Normandie;50;4;22;483;Saint-Gilles;955;28;983
28;Normandie;50;1;21;484;Saint-Hilaire-du-Harcouët;5850;332;6182
28;Normandie;50;2;04;486;Saint-Jacques-de-Néhou;619;9;628
28;Normandie;50;1;21;487;Saint-James;4907;109;5016
28;Normandie;50;4;18;488;Saint-Jean-de-Daye;638;5;643
28;Normandie;50;1;02;489;Saint-Jean-de-la-Haize;531;14;545
28;Normandie;50;2;17;490;Saint-Jean-de-la-Rivière;354;9;363
28;Normandie;50;4;18;491;Saint-Jean-de-Savigny;447;6;453
28;Normandie;50;4;09;492;Saint-Jean-d'Elle;2498;55;2553
28;Normandie;50;1;03;493;Saint-Jean-des-Champs;1443;37;1480
28;Normandie;50;1;15;495;Saint-Jean-du-Corail-des-Bois;75;5;80
28;Normandie;50;1;02;496;Saint-Jean-le-Thomas;384;8;392
28;Normandie;50;2;25;498;Saint-Joseph;798;26;824
28;Normandie;50;1;15;499;Saint-Laurent-de-Cuves;481;7;488
28;Normandie;50;1;21;500;Saint-Laurent-de-Terregatte;654;12;666
28;Normandie;50;4;99;502;Saint-Lô;19050;913;19963
28;Normandie;50;4;09;504;Saint-Louet-sur-Vire;206;1;207
28;Normandie;50;1;15;505;Saint-Loup;679;35;714
28;Normandie;50;3;01;506;Saint-Malo-de-la-Lande;482;4;486
28;Normandie;50;2;25;507;Saint-Marcouf;344;7;351
28;Normandie;50;2;05;509;Sainte-Marie-du-Mont;712;18;730
28;Normandie;50;3;01;510;Saint-Martin-d'Aubigny;602;4;606
28;Normandie;50;2;25;511;Saint-Martin-d'Audouville;128;4;132
28;Normandie;50;4;23;512;Saint-Martin-de-Bonfossé;526;9;535
28;Normandie;50;3;20;513;Saint-Martin-de-Cenilly;176;3;179
28;Normandie;50;1;16;514;Chaulieu;307;1;308
28;Normandie;50;2;05;517;Saint-Martin-de-Varreville;172;5;177
28;Normandie;50;1;27;518;Saint-Martin-le-Bouillant;327;4;331
28;Normandie;50;2;08;519;Saint-Martin-le-Gréard;567;8;575
28;Normandie;50;1;27;521;Saint-Maur-des-Bois;154;4;158
28;Normandie;50;2;17;522;Saint-Maurice-en-Cotentin;255;7;262
28;Normandie;50;2;05;523;Sainte-Mère-Église;3076;51;3127
28;Normandie;50;1;15;525;Saint-Michel-de-Montjoie;328;1;329
28;Normandie;50;3;11;528;Saint-Nicolas-de-Pierrepont;305;12;317
28;Normandie;50;1;15;529;Saint-Nicolas-des-Bois;81;2;83
28;Normandie;50;1;19;531;Saint-Ovin;767;35;802
28;Normandie;50;1;13;532;Saint-Pair-sur-Mer;4078;149;4227
28;Normandie;50;3;11;533;Saint-Patrice-de-Claids;178;3;181
28;Normandie;50;1;02;535;Le Parc;921;26;947
28;Normandie;50;2;17;536;Saint-Pierre-d'Arthéglise;158;0;158
28;Normandie;50;3;10;537;Saint-Pierre-de-Coutances;414;19;433
28;Normandie;50;4;18;538;Saint-Pierre-de-Semilly;456;8;464
28;Normandie;50;2;26;539;Saint-Pierre-Église;1810;25;1835
28;Normandie;50;1;02;540;Saint-Pierre-Langers;620;18;638
28;Normandie;50;1;03;541;Saint-Planchers;1399;47;1446
28;Normandie;50;1;27;542;Saint-Pois;490;7;497
28;Normandie;50;1;19;543;Saint-Quentin-sur-le-Homme;1345;32;1377
28;Normandie;50;4;23;546;Bourgvallées;3247;68;3315
28;Normandie;50;3;11;548;Saint-Sauveur-de-Pierrepont;121;3;124
28;Normandie;50;1;03;549;Saint-Sauveur-la-Pommeraye;402;6;408
28;Normandie;50;3;01;550;Saint-Sauveur-Villages;3601;148;3749
28;Normandie;50;2;04;551;Saint-Sauveur-le-Vicomte;2088;40;2128
28;Normandie;50;3;01;552;Saint-Sébastien-de-Raids;331;6;337
28;Normandie;50;1;21;553;Saint-Senier-de-Beuvron;346;2;348
28;Normandie;50;1;15;554;Saint-Senier-sous-Avranches;1420;59;1479
28;Normandie;50;4;23;556;Sainte-Suzanne-sur-Vire;696;10;706
28;Normandie;50;2;26;562;Saint-Vaast-la-Hougue;1712;30;1742
28;Normandie;50;4;09;563;Saint-Vigor-des-Monts;279;8;287
28;Normandie;50;4;05;564;Terre-et-Marais;1322;29;1351
28;Normandie;50;1;02;565;Sartilly-Baie-Bocage;2815;58;2873
28;Normandie;50;2;25;567;Saussemesnil;880;22;902
28;Normandie;50;3;10;568;Saussey;462;15;477
28;Normandie;50;3;20;569;Savigny;450;8;458
28;Normandie;50;1;21;570;Savigny-le-Vieux;426;7;433
28;Normandie;50;2;05;571;Sébeville;34;1;35
28;Normandie;50;2;17;572;Sénoville;189;7;196
28;Normandie;50;1;19;574;Servon;271;11;282
28;Normandie;50;2;08;575;Sideville;769;13;782
28;Normandie;50;2;17;576;Siouville-Hague;952;31;983
28;Normandie;50;2;17;577;Sortosville-en-Beaumont;311;8;319
28;Normandie;50;2;25;578;Sortosville;79;1;80
28;Normandie;50;2;04;579;Sottevast;1421;29;1450
28;Normandie;50;2;17;580;Sotteville;465;9;474
28;Normandie;50;1;16;582;Sourdeval;3156;64;3220
28;Normandie;50;1;03;584;Subligny;407;6;413
28;Normandie;50;2;17;585;Surtainville;1154;27;1181
28;Normandie;50;2;04;587;Taillepied;17;1;18
28;Normandie;50;2;25;588;Tamerville;678;22;700
28;Normandie;50;1;19;589;Tanis;289;12;301
28;Normandie;50;1;27;590;Le Tanu;406;5;411
28;Normandie;50;1;16;591;Le Teilleul;1674;27;1701
28;Normandie;50;4;09;592;Tessy-Bocage;2277;44;2321
28;Normandie;50;2;26;593;Teurthéville-Bocage;588;8;596
28;Normandie;50;2;08;594;Teurthéville-Hague;1041;23;1064
28;Normandie;50;2;26;596;Théville;338;12;350
28;Normandie;50;1;15;597;Tirepied-sur-Sée;953;23;976
28;Normandie;50;2;26;598;Tocqueville;270;3;273
28;Normandie;50;2;08;599;Tollevast;1569;44;1613
28;Normandie;50;4;09;601;Torigny-les-Villes;4397;55;4452
28;Normandie;50;3;10;603;Tourville-sur-Sienne;778;24;802
28;Normandie;50;2;17;604;Tréauville;755;13;768
28;Normandie;50;4;18;606;Tribehou;520;5;525
28;Normandie;50;4;27;607;La Trinité;391;6;397
28;Normandie;50;2;05;609;Turqueville;127;3;130
28;Normandie;50;2;25;610;Urville;209;6;215
28;Normandie;50;1;02;612;Vains;745;86;831
28;Normandie;50;2;26;613;Valcanville;402;9;411
28;Normandie;50;2;25;615;Valognes;6822;266;7088
28;Normandie;50;1;19;616;Le Val-Saint-Père;1971;71;2042
28;Normandie;50;3;11;617;Varenguebec;331;2;333
28;Normandie;50;2;26;618;Varouville;244;11;255
28;Normandie;50;2;26;619;Le Vast;326;10;336
28;Normandie;50;2;25;621;Vaudreville;72;0;72
28;Normandie;50;3;10;624;La Vendelée;479;24;503
28;Normandie;50;3;20;626;Ver;377;8;385
28;Normandie;50;1;15;628;Vernix;155;4;159
28;Normandie;50;3;11;629;Vesly;737;4;741
28;Normandie;50;2;26;633;Le Vicel;119;3;122
28;Normandie;50;2;26;634;Videcosville;84;1;85
28;Normandie;50;4;27;637;Villebaudon;316;3;319
28;Normandie;50;4;27;639;Villedieu-les-Poêles-Rouffigny;3852;67;3919
28;Normandie;50;4;18;641;Villiers-Fossard;657;15;672
28;Normandie;50;2;08;643;Virandeville;783;24;807
28;Normandie;50;1;13;647;Yquelon;1135;43;1178
28;Normandie;50;2;25;648;Yvetot-Bocage;1182;31;1213
44;Grand Est;51;4;23;001;Ablancourt;166;1;167
44;Grand Est;51;2;06;002;Saint-Martin-d'Ablois;1407;23;1430
44;Grand Est;51;1;04;003;Aigny;276;5;281
44;Grand Est;51;2;22;004;Allemanche-Launay-et-Soyer;117;4;121
44;Grand Est;51;2;21;005;Allemant;175;3;178
44;Grand Est;51;4;20;006;Alliancelles;147;4;151
44;Grand Est;51;2;07;007;Ambonnay;957;25;982
44;Grand Est;51;4;20;008;Ambrières;218;6;224
44;Grand Est;51;2;22;009;Anglure;834;11;845
44;Grand Est;51;2;22;010;Angluzelles-et-Courcelles;139;4;143
44;Grand Est;51;3;06;012;Anthenay;71;0;71
44;Grand Est;51;3;06;013;Aougny;99;5;104
44;Grand Est;51;3;09;014;Arcis-le-Ponsart;298;6;304
44;Grand Est;51;1;01;015;Argers;112;1;113
44;Grand Est;51;4;20;016;Arrigny;238;4;242
44;Grand Est;51;4;23;017;Arzillières-Neuville;325;6;331
44;Grand Est;51;2;22;018;Athis;900;20;920
44;Grand Est;51;3;10;019;Aubérive;253;8;261
44;Grand Est;51;3;09;020;Aubilly;53;3;56
44;Grand Est;51;4;23;022;Aulnay-l'Aître;188;5;193
44;Grand Est;51;1;04;023;Aulnay-sur-Marne;266;6;272
44;Grand Est;51;3;02;025;Auménancourt;1074;10;1084
44;Grand Est;51;1;01;027;Auve;302;21;323
44;Grand Est;51;2;07;028;Avenay-Val-d'Or;1031;12;1043
44;Grand Est;51;2;08;029;Avize;1754;160;1914
44;Grand Est;51;2;07;030;Aÿ-Champagne;5309;86;5395
44;Grand Est;51;1;10;031;Baconnes;266;10;276
44;Grand Est;51;2;22;032;Bagneux;427;5;432
44;Grand Est;51;2;06;033;Le Baizil;251;3;254
44;Grand Est;51;2;06;034;Bannay;20;0;20
44;Grand Est;51;2;22;035;Bannes;253;3;256
44;Grand Est;51;2;21;036;Barbonne-Fayel;507;7;514
44;Grand Est;51;3;09;037;Baslieux-lès-Fismes;338;2;340
44;Grand Est;51;2;06;038;Baslieux-sous-Châtillon;183;6;189
44;Grand Est;51;4;20;039;Bassu;95;5;100
44;Grand Est;51;4;20;040;Bassuet;250;3;253
44;Grand Est;51;2;22;041;Baudement;103;4;107
44;Grand Est;51;2;06;042;Baye;386;8;394
44;Grand Est;51;3;02;043;Bazancourt;2352;28;2380
44;Grand Est;51;3;10;044;Beaumont-sur-Vesle;796;16;812
44;Grand Est;51;2;06;045;Beaunay;104;0;104
44;Grand Est;51;3;02;046;Beine-Nauroy;995;15;1010
44;Grand Est;51;1;01;047;Belval-en-Argonne;44;3;47
44;Grand Est;51;2;06;048;Belval-sous-Châtillon;161;0;161
44;Grand Est;51;2;22;049;Bergères-lès-Vertus;576;4;580
44;Grand Est;51;2;21;050;Bergères-sous-Montmirail;135;2;137
44;Grand Est;51;3;02;051;Berméricourt;221;2;223
44;Grand Est;51;3;02;052;Berru;596;4;600
44;Grand Est;51;1;01;053;Berzieux;76;7;83
44;Grand Est;51;3;10;054;Bétheniville;1281;14;1295
44;Grand Est;51;3;15;055;Bétheny;7069;108;7177
44;Grand Est;51;2;21;056;Bethon;255;3;258
44;Grand Est;51;4;20;057;Bettancourt-la-Longue;76;2;78
44;Grand Est;51;3;14;058;Bezannes;2978;70;3048
44;Grand Est;51;4;23;059;Bignicourt-sur-Marne;361;6;367
44;Grand Est;51;4;20;060;Bignicourt-sur-Saulx;171;3;174
44;Grand Est;51;3;10;061;Billy-le-Grand;119;2;121
44;Grand Est;51;1;01;062;Binarville;95;3;98
44;Grand Est;51;2;06;063;Binson-et-Orquigny;164;2;166
44;Grand Est;51;4;23;065;Blacy;632;13;645
44;Grand Est;51;4;23;066;Blaise-sous-Arzillières;330;3;333
44;Grand Est;51;4;20;068;Blesme;202;2;204
44;Grand Est;51;3;06;069;Bligny;118;1;119
44;Grand Est;51;2;21;070;Boissy-le-Repos;227;0;227
44;Grand Est;51;2;21;071;Bouchy-Saint-Genest;194;7;201
44;Grand Est;51;3;09;072;Bouilly;220;3;223
44;Grand Est;51;3;09;073;Bouleuse;223;3;226
44;Grand Est;51;3;02;074;Boult-sur-Suippe;1773;27;1800
44;Grand Est;51;3;02;075;Bourgogne-Fresne;1422;33;1455
44;Grand Est;51;2;06;076;Boursault;441;9;450
44;Grand Est;51;3;09;077;Bouvancourt;182;4;186
44;Grand Est;51;1;10;078;Bouy;575;14;589
44;Grand Est;51;2;07;079;Bouzy;867;23;890
44;Grand Est;51;4;20;080;Brandonvillers;190;1;191
44;Grand Est;51;3;09;081;Branscourt;320;5;325
44;Grand Est;51;1;01;082;Braux-Sainte-Cohière;93;6;99
44;Grand Est;51;1;01;083;Braux-Saint-Remy;81;3;84
44;Grand Est;51;4;23;084;Bréban;78;1;79
44;Grand Est;51;2;06;085;Le Breuil;378;3;381
44;Grand Est;51;3;09;086;Breuil-sur-Vesle;334;11;345
44;Grand Est;51;1;05;087;Breuvery-sur-Coole;217;8;225
44;Grand Est;51;3;02;088;Brimont;448;7;455
44;Grand Est;51;3;06;089;Brouillet;72;4;76
44;Grand Est;51;2;22;090;Broussy-le-Grand;312;12;324
44;Grand Est;51;2;21;091;Broussy-le-Petit;134;7;141
44;Grand Est;51;2;21;092;Broyes;357;4;361
44;Grand Est;51;2;08;093;Brugny-Vaudancourt;445;14;459
44;Grand Est;51;4;20;094;Brusson;177;7;184
44;Grand Est;51;4;20;095;Le Buisson;94;3;97
44;Grand Est;51;1;01;097;Bussy-le-Château;175;4;179
44;Grand Est;51;4;20;098;Bussy-le-Repos;136;4;140
44;Grand Est;51;1;05;099;Bussy-Lettrée;322;9;331
44;Grand Est;51;2;06;100;La Caure;107;2;109
44;Grand Est;51;3;02;101;Caurel;689;8;697
44;Grand Est;51;3;02;102;Cauroy-lès-Hermonville;469;10;479
44;Grand Est;51;2;22;103;La Celle-sous-Chantemerle;140;1;141
44;Grand Est;51;1;01;104;Cernay-en-Dormois;138;4;142
44;Grand Est;51;3;18;105;Cernay-lès-Reims;1438;25;1463
44;Grand Est;51;1;05;106;Cernon;125;5;130
44;Grand Est;51;2;22;107;Chaintrix-Bierges;336;3;339
44;Grand Est;51;1;97;108;Châlons-en-Champagne;44379;1246;45625
44;Grand Est;51;3;09;109;Châlons-sur-Vesle;188;2;190
44;Grand Est;51;2;22;110;Chaltrait;55;1;56
44;Grand Est;51;3;06;111;Chambrecy;147;8;155
44;Grand Est;51;3;09;112;Chamery;430;6;436
44;Grand Est;51;2;06;113;Champaubert;122;2;124
44;Grand Est;51;3;14;115;Champfleury;568;3;571
44;Grand Est;51;2;21;116;Champguyon;279;4;283
44;Grand Est;51;1;04;117;Champigneul-Champagne;319;8;327
44;Grand Est;51;3;14;118;Champigny;1573;25;1598
44;Grand Est;51;2;07;119;Champillon;512;7;519
44;Grand Est;51;2;06;120;Champlat-et-Boujacourt;155;0;155
44;Grand Est;51;2;06;121;Champvoisy;250;3;253
44;Grand Est;51;4;20;122;Changy;117;5;122
44;Grand Est;51;2;21;124;Chantemerle;47;3;50
44;Grand Est;51;4;23;125;Chapelaine;51;1;52
44;Grand Est;51;1;01;126;La Chapelle-Felcourt;47;3;50
44;Grand Est;51;2;22;127;La Chapelle-Lasson;87;2;89
44;Grand Est;51;2;06;128;La Chapelle-sous-Orbais;54;2;56
44;Grand Est;51;2;21;129;Charleville;249;9;258
44;Grand Est;51;4;20;130;Charmont;231;5;236
44;Grand Est;51;1;01;132;Les Charmontois;117;0;117
44;Grand Est;51;1;01;133;Le Châtelier;63;0;63
44;Grand Est;51;4;23;134;Châtelraould-Saint-Louvent;245;8;253
44;Grand Est;51;4;20;135;Châtillon-sur-Broué;78;0;78
44;Grand Est;51;2;06;136;Châtillon-sur-Marne;638;16;654
44;Grand Est;51;2;21;137;Châtillon-sur-Morin;223;3;226
44;Grand Est;51;1;01;138;Châtrices;35;2;37
44;Grand Est;51;1;01;139;Chaudefontaine;316;13;329
44;Grand Est;51;3;06;140;Chaumuzy;390;2;392
44;Grand Est;51;4;23;141;La Chaussée-sur-Marne;778;15;793
44;Grand Est;51;2;08;142;Chavot-Courcourt;333;11;344
44;Grand Est;51;1;01;143;Le Chemin;56;0;56
44;Grand Est;51;4;20;144;Cheminon;604;10;614
44;Grand Est;51;3;09;145;Chenay;225;6;231
44;Grand Est;51;1;05;146;Cheniers;105;4;109
44;Grand Est;51;1;01;147;La Cheppe;330;13;343
44;Grand Est;51;1;05;148;Cheppes-la-Prairie;157;2;159
44;Grand Est;51;1;05;149;Chepy;440;13;453
44;Grand Est;51;1;04;150;Cherville;82;1;83
44;Grand Est;51;2;21;151;Chichey;174;3;177
44;Grand Est;51;3;10;152;Chigny-les-Roses;540;13;553
44;Grand Est;51;2;08;153;Chouilly;1022;31;1053
44;Grand Est;51;2;22;154;Clamanges;213;3;216
44;Grand Est;51;2;22;155;Clesles;612;10;622
44;Grand Est;51;4;20;156;Cloyes-sur-Marne;124;1;125
44;Grand Est;51;2;06;157;Coizard-Joches;72;1;73
44;Grand Est;51;2;22;158;Val-des-Marais;567;11;578
44;Grand Est;51;1;03;160;Compertrix;1376;46;1422
44;Grand Est;51;1;04;161;Condé-sur-Marne;768;14;782
44;Grand Est;51;2;22;162;Conflans-sur-Seine;636;7;643
44;Grand Est;51;2;06;163;Congy;268;2;270
44;Grand Est;51;2;22;164;Connantray-Vaurefroy;148;3;151
44;Grand Est;51;2;22;165;Connantre;1036;30;1066
44;Grand Est;51;1;01;166;Contault;68;2;70
44;Grand Est;51;4;23;167;Coole;148;3;151
44;Grand Est;51;1;03;168;Coolus;220;8;228
44;Grand Est;51;4;23;169;Corbeil;95;5;100
44;Grand Est;51;2;21;170;Corfélix;111;2;113
44;Grand Est;51;3;02;171;Cormicy;1487;26;1513
44;Grand Est;51;3;18;172;Cormontreuil;6458;92;6550
44;Grand Est;51;2;06;173;Cormoyeux;124;1;125
44;Grand Est;51;2;06;174;Corribert;62;0;62
44;Grand Est;51;2;21;175;Corrobert;210;7;217
44;Grand Est;51;2;22;176;Corroy;151;7;158
44;Grand Est;51;3;09;177;Coulommes-la-Montagne;205;4;209
44;Grand Est;51;1;05;178;Coupetz;80;2;82
44;Grand Est;51;1;05;179;Coupéville;164;0;164
44;Grand Est;51;3;09;181;Courcelles-Sapicourt;395;11;406
44;Grand Est;51;2;22;182;Courcemain;93;3;96
44;Grand Est;51;3;02;183;Courcy;1210;19;1229
44;Grand Est;51;4;23;184;Courdemanges;392;13;405
44;Grand Est;51;2;21;185;Courgivaux;299;1;300
44;Grand Est;51;2;06;186;Courjeonnet;47;0;47
44;Grand Est;51;3;09;187;Courlandon;283;4;287
44;Grand Est;51;3;09;188;Courmas;213;8;221
44;Grand Est;51;3;09;190;Courtagnon;68;0;68
44;Grand Est;51;1;01;191;Courtémont;60;1;61
44;Grand Est;51;2;06;192;Courthiézy;347;5;352
44;Grand Est;51;1;01;193;Courtisols;2382;91;2473
44;Grand Est;51;3;09;194;Courville;460;6;466
44;Grand Est;51;4;23;195;Couvrot;823;23;846
44;Grand Est;51;2;08;196;Cramant;880;13;893
44;Grand Est;51;1;01;197;La Croix-en-Champagne;79;2;81
44;Grand Est;51;3;09;198;Crugny;668;6;674
44;Grand Est;51;2;06;199;Cuchery;408;6;414
44;Grand Est;51;2;08;200;Cuis;369;12;381
44;Grand Est;51;3;06;201;Cuisles;126;4;130
44;Grand Est;51;2;07;202;Cumières;749;12;761
44;Grand Est;51;1;01;203;Cuperly;223;2;225
44;Grand Est;51;2;06;204;Damery;1377;25;1402
44;Grand Est;51;1;10;205;Dampierre-au-Temple;272;4;276
44;Grand Est;51;1;01;206;Dampierre-le-Château;113;2;115
44;Grand Est;51;1;05;208;Dampierre-sur-Moivre;110;2;112
44;Grand Est;51;2;07;210;Dizy;1496;34;1530
44;Grand Est;51;1;01;211;Dommartin-Dampierre;68;0;68
44;Grand Est;51;1;05;212;Dommartin-Lettrée;155;1;156
44;Grand Est;51;1;01;213;Dommartin-sous-Hans;60;2;62
44;Grand Est;51;1;01;214;Dommartin-Varimont;138;8;146
44;Grand Est;51;4;20;215;Dompremy;127;3;130
44;Grand Est;51;3;10;216;Dontrien;263;4;267
44;Grand Est;51;2;06;217;Dormans;2918;43;2961
44;Grand Est;51;4;20;218;Val-de-Vière;130;1;131
44;Grand Est;51;4;20;219;Drosnay;223;1;224
44;Grand Est;51;4;23;220;Drouilly;140;1;141
44;Grand Est;51;1;01;222;Éclaires;95;3;98
44;Grand Est;51;4;20;223;Écollemont;56;1;57
44;Grand Est;51;4;20;224;Écriennes;170;2;172
44;Grand Est;51;3;09;225;Écueil;305;2;307
44;Grand Est;51;2;22;226;Écury-le-Repos;55;1;56
44;Grand Est;51;1;05;227;Écury-sur-Coole;488;21;509
44;Grand Est;51;1;01;228;Élise-Daucourt;84;0;84
44;Grand Est;51;1;01;229;Épense;120;6;126
44;Grand Est;51;2;98;230;Épernay;22433;468;22901
44;Grand Est;51;1;05;231;L'Épine;654;15;669
44;Grand Est;51;3;10;232;Époye;415;6;421
44;Grand Est;51;2;21;233;Escardes;69;3;72
44;Grand Est;51;2;22;234;Esclavolles-Lurey;618;11;629
44;Grand Est;51;2;21;235;Les Essarts-lès-Sézanne;246;10;256
44;Grand Est;51;2;21;236;Les Essarts-le-Vicomte;139;3;142
44;Grand Est;51;2;21;237;Esternay;1820;30;1850
44;Grand Est;51;2;06;238;Étoges;490;8;498
44;Grand Est;51;2;22;239;Étréchy;105;1;106
44;Grand Est;51;4;20;240;Étrepy;127;3;130
44;Grand Est;51;2;22;241;Euvy;81;1;82
44;Grand Est;51;1;03;242;Fagnières;4843;108;4951
44;Grand Est;51;2;22;243;Faux-Fresnay;308;8;316
44;Grand Est;51;1;05;244;Faux-Vésigneul;241;8;249
44;Grand Est;51;3;09;245;Faverolles-et-Coëmy;573;10;583
44;Grand Est;51;4;20;246;Favresse;222;6;228
44;Grand Est;51;2;06;247;Fèrebrianges;143;3;146
44;Grand Est;51;2;22;248;Fère-Champenoise;2162;41;2203
44;Grand Est;51;2;06;249;Festigny;389;5;394
44;Grand Est;51;3;09;250;Fismes;5589;51;5640
44;Grand Est;51;2;08;251;Flavigny;170;5;175
44;Grand Est;51;2;06;252;Fleury-la-Rivière;518;8;526
44;Grand Est;51;1;01;253;Florent-en-Argonne;228;5;233
44;Grand Est;51;2;21;254;Fontaine-Denis-Nuisy;232;2;234
44;Grand Est;51;1;01;255;Fontaine-en-Dormois;13;0;13
44;Grand Est;51;2;07;256;Fontaine-sur-Ay;340;8;348
44;Grand Est;51;2;21;258;La Forestière;209;13;222
44;Grand Est;51;1;05;259;Francheville;196;7;203
44;Grand Est;51;1;05;260;Le Fresne;76;3;79
44;Grand Est;51;4;23;262;Frignicourt;1816;33;1849
44;Grand Est;51;2;21;263;Fromentières;380;7;387
44;Grand Est;51;2;21;264;Le Gault-Soigny;512;15;527
44;Grand Est;51;2;21;265;Gaye;590;12;602
44;Grand Est;51;2;07;266;Germaine;530;16;546
44;Grand Est;51;3;09;267;Germigny;176;2;178
44;Grand Est;51;2;22;268;Germinon;178;4;182
44;Grand Est;51;4;20;269;Giffaumont-Champaubert;274;1;275
44;Grand Est;51;4;20;270;Gigny-Bussy;237;5;242
44;Grand Est;51;1;01;272;Givry-en-Argonne;456;5;461
44;Grand Est;51;2;22;273;Givry-lès-Loisy;70;4;74
44;Grand Est;51;1;01;274;Gizaucourt;117;3;120
44;Grand Est;51;4;23;275;Glannes;188;3;191
44;Grand Est;51;2;22;276;Gourgançon;145;7;152
44;Grand Est;51;4;20;277;Sainte-Marie-du-Lac-Nuisement;272;2;274
44;Grand Est;51;1;04;278;Les Grandes-Loges;275;5;280
44;Grand Est;51;2;22;279;Granges-sur-Aube;184;4;188
44;Grand Est;51;1;01;280;Gratreuil;25;0;25
44;Grand Est;51;2;08;281;Grauves;619;11;630
44;Grand Est;51;3;09;282;Gueux;1796;45;1841
44;Grand Est;51;1;01;283;Hans;147;6;153
44;Grand Est;51;4;20;284;Haussignémont;304;1;305
44;Grand Est;51;1;05;285;Haussimont;139;5;144
44;Grand Est;51;4;20;286;Hauteville;237;8;245
44;Grand Est;51;2;07;287;Hautvillers;675;15;690
44;Grand Est;51;4;20;288;Heiltz-le-Hutier;238;8;246
44;Grand Est;51;4;20;289;Heiltz-le-Maurupt;435;9;444
44;Grand Est;51;4;20;290;Heiltz-l'Évêque;288;6;294
44;Grand Est;51;3;02;291;Hermonville;1391;31;1422
44;Grand Est;51;1;01;292;Herpont;127;4;131
44;Grand Est;51;3;02;293;Heutrégiville;478;7;485
44;Grand Est;51;3;09;294;Hourges;78;1;79
44;Grand Est;51;4;23;295;Huiron;304;2;306
44;Grand Est;51;4;23;296;Humbauville;78;1;79
44;Grand Est;51;2;06;298;Igny-Comblizy;428;3;431
44;Grand Est;51;3;02;299;Isles-sur-Suippe;928;15;943
44;Grand Est;51;4;20;300;Isle-sur-Marne;95;2;97
44;Grand Est;51;1;04;301;Isse;109;8;117
44;Grand Est;51;2;08;302;Les Istres-et-Bury;95;1;96
44;Grand Est;51;1;04;303;Jâlons;552;10;562
44;Grand Est;51;2;21;304;Janvilliers;171;4;175
44;Grand Est;51;3;09;305;Janvry;126;2;128
44;Grand Est;51;2;21;306;Joiselle;103;3;106
44;Grand Est;51;1;01;307;Jonchery-sur-Suippe;222;3;225
44;Grand Est;51;3;09;308;Jonchery-sur-Vesle;1857;53;1910
44;Grand Est;51;3;06;309;Jonquery;113;4;117
44;Grand Est;51;3;09;310;Jouy-lès-Reims;227;2;229
44;Grand Est;51;4;20;311;Jussecourt-Minecourt;208;2;210
44;Grand Est;51;1;04;312;Juvigny;938;29;967
44;Grand Est;51;2;21;313;Lachy;323;5;328
44;Grand Est;51;3;06;314;Lagery;225;3;228
44;Grand Est;51;4;20;315;Landricourt;146;2;148
44;Grand Est;51;4;20;316;Larzicourt;273;5;278
44;Grand Est;51;1;01;317;Laval-sur-Tourbe;54;0;54
44;Grand Est;51;3;02;318;Lavannes;571;16;587
44;Grand Est;51;1;05;319;Lenharrée;100;3;103
44;Grand Est;51;2;06;320;Leuvrigny;310;8;318
44;Grand Est;51;3;06;321;Lhéry;81;3;84
44;Grand Est;51;4;23;322;Lignon;124;1;125
44;Grand Est;51;2;21;323;Linthelles;105;6;111
44;Grand Est;51;2;21;324;Linthes;114;0;114
44;Grand Est;51;4;20;325;Lisse-en-Champagne;113;2;115
44;Grand Est;51;1;10;326;Livry-Louvercy;1091;14;1105
44;Grand Est;51;2;22;327;Loisy-en-Brie;180;2;182
44;Grand Est;51;4;23;328;Loisy-sur-Marne;1104;24;1128
44;Grand Est;51;3;02;329;Loivre;1348;18;1366
44;Grand Est;51;3;10;333;Ludes;674;7;681
44;Grand Est;51;4;20;334;Luxémont-et-Villotte;472;11;483
44;Grand Est;51;1;01;336;Maffrécourt;58;1;59
44;Grand Est;51;3;09;337;Magneux;271;3;274
44;Grand Est;51;3;10;338;Mailly-Champagne;640;16;656
44;Grand Est;51;1;05;339;Mairy-sur-Marne;557;15;572
44;Grand Est;51;4;23;340;Maisons-en-Champagne;539;14;553
44;Grand Est;51;1;01;341;Malmy;34;2;36
44;Grand Est;51;2;08;342;Mancy;246;7;253
44;Grand Est;51;2;22;343;Marcilly-sur-Seine;628;21;649
44;Grand Est;51;2;07;344;Mardeuil;1480;20;1500
44;Grand Est;51;2;06;345;Mareuil-en-Brie;284;2;286
44;Grand Est;51;2;06;346;Mareuil-le-Port;1157;18;1175
44;Grand Est;51;3;06;348;Marfaux;116;1;117
44;Grand Est;51;4;23;349;Margerie-Hancourt;173;4;177
44;Grand Est;51;2;06;350;Margny;125;5;130
44;Grand Est;51;2;22;351;Marigny;108;1;109
44;Grand Est;51;4;23;352;Marolles;876;18;894
44;Grand Est;51;2;22;353;Marsangis;47;1;48
44;Grand Est;51;1;05;354;Marson;283;9;292
44;Grand Est;51;1;01;355;Massiges;52;0;52
44;Grand Est;51;4;20;356;Matignicourt-Goncourt;151;5;156
44;Grand Est;51;1;04;357;Matougues;612;13;625
44;Grand Est;51;4;20;358;Maurupt-le-Montois;584;10;594
44;Grand Est;51;2;21;359;Mécringes;207;3;210
44;Grand Est;51;2;21;360;Le Meix-Saint-Epoing;294;2;296
44;Grand Est;51;4;23;361;Le Meix-Tiercelin;167;1;168
44;Grand Est;51;3;02;362;Merfy;603;19;622
44;Grand Est;51;4;20;363;Merlaut;254;7;261
44;Grand Est;51;3;09;364;Méry-Prémecy;66;1;67
44;Grand Est;51;3;09;365;Les Mesneux;876;21;897
44;Grand Est;51;2;22;367;Le Mesnil-sur-Oger;1055;36;1091
44;Grand Est;51;1;01;368;Minaucourt-le-Mesnil-lès-Hurlus;50;3;53
44;Grand Est;51;2;21;369;Mœurs-Verdey;314;14;328
44;Grand Est;51;1;01;370;Moiremont;193;10;203
44;Grand Est;51;1;05;371;Moivre;62;1;63
44;Grand Est;51;1;05;372;Moncetz-Longevas;528;9;537
44;Grand Est;51;4;20;373;Moncetz-l'Abbaye;92;4;96
44;Grand Est;51;2;21;374;Mondement-Montgivroux;26;0;26
44;Grand Est;51;3;10;375;Montbré;319;5;324
44;Grand Est;51;2;21;376;Montgenost;151;3;154
44;Grand Est;51;1;05;377;Montépreux;47;0;47
44;Grand Est;51;2;08;378;Monthelon;348;5;353
44;Grand Est;51;3;09;379;Montigny-sur-Vesle;510;8;518
44;Grand Est;51;2;21;380;Montmirail;3571;49;3620
44;Grand Est;51;2;06;381;Montmort-Lucy;613;11;624
44;Grand Est;51;3;09;382;Mont-sur-Courville;119;4;123
44;Grand Est;51;2;08;384;Morangis;408;7;415
44;Grand Est;51;2;21;386;Morsains;136;3;139
44;Grand Est;51;2;22;387;Moslins;297;3;300
44;Grand Est;51;1;10;388;Mourmelon-le-Grand;5150;49;5199
44;Grand Est;51;1;10;389;Mourmelon-le-Petit;813;8;821
44;Grand Est;51;2;08;390;Moussy;783;10;793
44;Grand Est;51;3;09;391;Muizon;2119;65;2184
44;Grand Est;51;2;07;392;Mutigny;189;5;194
44;Grand Est;51;2;07;393;Nanteuil-la-Forêt;293;7;300
44;Grand Est;51;2;21;395;Nesle-la-Reposte;98;1;99
44;Grand Est;51;2;06;396;Nesle-le-Repons;143;3;146
44;Grand Est;51;1;01;397;La Neuville-aux-Bois;139;2;141
44;Grand Est;51;2;06;398;La Neuville-aux-Larris;185;2;187
44;Grand Est;51;1;01;399;La Neuville-au-Pont;544;9;553
44;Grand Est;51;2;21;402;Neuvy;266;7;273
44;Grand Est;51;3;02;403;Nogent-l'Abbesse;524;5;529
44;Grand Est;51;1;01;404;Noirlieu;107;4;111
44;Grand Est;51;4;20;406;Norrois;152;1;153
44;Grand Est;51;2;21;407;La Noue;420;5;425
44;Grand Est;51;1;05;409;Nuisement-sur-Coole;367;10;377
44;Grand Est;51;2;06;410;Œuilly;652;10;662
44;Grand Est;51;2;22;412;Ognes;60;2;62
44;Grand Est;51;2;08;413;Oiry;871;18;889
44;Grand Est;51;3;06;414;Olizy;150;5;155
44;Grand Est;51;1;05;415;Omey;205;0;205
44;Grand Est;51;2;06;416;Orbais-l'Abbaye;550;3;553
44;Grand Est;51;4;20;417;Orconte;378;5;383
44;Grand Est;51;3;09;418;Ormes;446;3;449
44;Grand Est;51;4;20;419;Outines;129;2;131
44;Grand Est;51;4;20;420;Outrepont;82;0;82
44;Grand Est;51;2;21;421;Oyes;99;3;102
44;Grand Est;51;3;09;422;Pargny-lès-Reims;475;10;485
44;Grand Est;51;4;20;423;Pargny-sur-Saulx;1766;14;1780
44;Grand Est;51;1;01;424;Passavant-en-Argonne;207;1;208
44;Grand Est;51;2;06;425;Passy-Grigny;383;14;397
44;Grand Est;51;2;21;426;Péas;66;3;69
44;Grand Est;51;3;10;428;Les Petites-Loges;495;7;502
44;Grand Est;51;3;09;429;Pévy;205;3;208
44;Grand Est;51;2;22;430;Pierre-Morains;86;2;88
44;Grand Est;51;2;08;431;Pierry;1198;19;1217
44;Grand Est;51;2;22;432;Pleurs;836;19;855
44;Grand Est;51;4;20;433;Plichancourt;256;3;259
44;Grand Est;51;2;08;434;Plivot;740;21;761
44;Grand Est;51;2;22;435;Pocancy;178;2;180
44;Grand Est;51;1;05;436;Pogny;924;18;942
44;Grand Est;51;3;06;437;Poilly;95;0;95
44;Grand Est;51;1;01;438;Poix;69;1;70
44;Grand Est;51;3;02;439;Pomacle;465;8;473
44;Grand Est;51;3;10;440;Pontfaverger-Moronvilliers;1745;17;1762
44;Grand Est;51;4;20;441;Ponthion;106;1;107
44;Grand Est;51;4;20;442;Possesse;137;0;137
44;Grand Est;51;2;22;443;Potangis;121;3;124
44;Grand Est;51;3;02;444;Pouillon;506;8;514
44;Grand Est;51;3;06;445;Pourcy;202;1;203
44;Grand Est;51;4;23;446;Pringy;434;8;442
44;Grand Est;51;3;10;447;Prosnes;486;13;499
44;Grand Est;51;3;09;448;Prouilly;555;10;565
44;Grand Est;51;3;18;449;Prunay;1028;16;1044
44;Grand Est;51;3;18;450;Puisieulx;426;8;434
44;Grand Est;51;2;21;451;Queudes;90;5;95
44;Grand Est;51;1;01;452;Rapsécourt;33;0;33
44;Grand Est;51;1;04;453;Recy;1033;30;1063
44;Grand Est;51;3;99;454;Reims;181194;2920;184114
44;Grand Est;51;4;20;455;Reims-la-Brûlée;223;3;226
44;Grand Est;51;1;01;456;Remicourt;60;1;61
44;Grand Est;51;2;06;457;Reuil;280;18;298
44;Grand Est;51;2;21;458;Reuves;63;0;63
44;Grand Est;51;2;21;459;Réveillon;110;1;111
44;Grand Est;51;2;21;460;Rieux;195;5;200
44;Grand Est;51;3;10;461;Rilly-la-Montagne;1020;22;1042
44;Grand Est;51;4;23;463;Les Rivières-Henruel;168;4;172
44;Grand Est;51;3;09;464;Romain;309;17;326
44;Grand Est;51;2;06;465;Romery;163;2;165
44;Grand Est;51;3;06;466;Romigny;217;5;222
44;Grand Est;51;3;09;468;Rosnay;363;10;373
44;Grand Est;51;2;22;469;Rouffy;111;5;116
44;Grand Est;51;1;01;470;Rouvroy-Ripont;4;0;4
44;Grand Est;51;3;09;471;Sacy;376;3;379
44;Grand Est;51;4;20;472;Saint-Amand-sur-Fion;1033;17;1050
44;Grand Est;51;2;21;473;Saint-Bon;104;6;110
44;Grand Est;51;3;15;474;Saint-Brice-Courcelles;3417;40;3457
44;Grand Est;51;4;23;475;Saint-Chéron;61;1;62
44;Grand Est;51;1;05;476;Saint-Étienne-au-Temple;819;13;832
44;Grand Est;51;3;02;477;Saint-Étienne-sur-Suippe;330;4;334
44;Grand Est;51;4;20;478;Saint-Eulien;424;12;436
44;Grand Est;51;3;09;479;Saint-Euphraise-et-Clairizet;242;5;247
44;Grand Est;51;2;06;480;Sainte-Gemme;138;3;141
44;Grand Est;51;1;05;482;Saint-Germain-la-Ville;681;13;694
44;Grand Est;51;1;04;483;Saint-Gibrien;536;7;543
44;Grand Est;51;3;09;484;Saint-Gilles;279;4;283
44;Grand Est;51;1;10;485;Saint-Hilaire-au-Temple;346;6;352
44;Grand Est;51;1;01;486;Saint-Hilaire-le-Grand;373;4;377
44;Grand Est;51;3;10;487;Saint-Hilaire-le-Petit;342;6;348
44;Grand Est;51;2;07;488;Saint-Imoges;317;34;351
44;Grand Est;51;4;20;489;Saint-Jean-devant-Possesse;32;3;35
44;Grand Est;51;1;05;490;Saint-Jean-sur-Moivre;203;2;205
44;Grand Est;51;1;01;491;Saint-Jean-sur-Tourbe;89;3;92
44;Grand Est;51;2;22;492;Saint-Just-Sauvage;1426;38;1464
44;Grand Est;51;3;18;493;Saint-Léonard;109;3;112
44;Grand Est;51;2;21;495;Saint-Loup;78;0;78
44;Grand Est;51;4;20;496;Saint-Lumier-en-Champagne;268;5;273
44;Grand Est;51;4;20;497;Saint-Lumier-la-Populeuse;44;0;44
44;Grand Est;51;1;01;498;Saint-Mard-sur-Auve;63;1;64
44;Grand Est;51;2;22;499;Saint-Mard-lès-Rouffy;161;7;168
44;Grand Est;51;1;01;500;Saint-Mard-sur-le-Mont;118;0;118
44;Grand Est;51;1;01;501;Sainte-Marie-à-Py;195;8;203
44;Grand Est;51;1;05;502;Saint-Martin-aux-Champs;114;0;114
44;Grand Est;51;3;10;503;Saint-Martin-l'Heureux;85;1;86
44;Grand Est;51;1;04;504;Saint-Martin-sur-le-Pré;804;31;835
44;Grand Est;51;3;10;505;Saint-Masmes;486;4;490
44;Grand Est;51;1;05;506;Saint-Memmie;5474;78;5552
44;Grand Est;51;1;01;507;Sainte-Menehould;4165;116;4281
44;Grand Est;51;4;23;508;Saint-Ouen-Domprot;204;6;210
44;Grand Est;51;1;04;509;Saint-Pierre;307;8;315
44;Grand Est;51;4;20;510;Saint-Quentin-les-Marais;129;0;129
44;Grand Est;51;2;22;511;Saint-Quentin-le-Verger;119;2;121
44;Grand Est;51;1;05;512;Saint-Quentin-sur-Coole;102;2;104
44;Grand Est;51;4;20;513;Saint-Remy-en-Bouzemont-Saint-Genest-et-Isson;525;6;531
44;Grand Est;51;2;21;514;Saint-Remy-sous-Broyes;106;2;108
44;Grand Est;51;1;01;515;Saint-Remy-sur-Bussy;338;8;346
44;Grand Est;51;2;22;516;Saint-Saturnin;51;0;51
44;Grand Est;51;3;10;517;Saint-Souplet-sur-Py;120;4;124
44;Grand Est;51;3;02;518;Saint-Thierry;616;24;640
44;Grand Est;51;1;01;519;Saint-Thomas-en-Argonne;39;2;41
44;Grand Est;51;4;23;520;Saint-Utin;77;1;78
44;Grand Est;51;4;20;521;Saint-Vrain;226;3;229
44;Grand Est;51;4;20;522;Sapignicourt;419;4;423
44;Grand Est;51;3;06;523;Sarcy;269;4;273
44;Grand Est;51;2;22;524;Saron-sur-Aube;304;6;310
44;Grand Est;51;1;05;525;Sarry;2037;86;2123
44;Grand Est;51;2;21;526;Saudoy;386;10;396
44;Grand Est;51;3;09;527;Savigny-sur-Ardres;272;4;276
44;Grand Est;51;4;20;528;Scrupt;130;0;130
44;Grand Est;51;3;10;529;Selles;417;1;418
44;Grand Est;51;3;10;530;Sept-Saulx;671;12;683
44;Grand Est;51;4;20;531;Sermaize-les-Bains;1789;32;1821
44;Grand Est;51;3;09;532;Sermiers;568;14;582
44;Grand Est;51;1;01;533;Servon-Melzicourt;106;0;106
44;Grand Est;51;3;09;534;Serzy-et-Prin;207;4;211
44;Grand Est;51;2;21;535;Sézanne;4772;108;4880
44;Grand Est;51;3;18;536;Sillery;1796;39;1835
44;Grand Est;51;1;01;537;Sivry-Ante;179;4;183
44;Grand Est;51;1;05;538;Sogny-aux-Moulins;111;0;111
44;Grand Est;51;4;20;539;Sogny-en-l'Angle;71;0;71
44;Grand Est;51;2;21;542;Soizy-aux-Bois;190;0;190
44;Grand Est;51;1;01;543;Somme-Bionne;71;7;78
44;Grand Est;51;1;01;544;Sommepy-Tahure;639;19;658
44;Grand Est;51;1;05;545;Sommesous;502;16;518
44;Grand Est;51;1;01;546;Somme-Suippe;506;147;653
44;Grand Est;51;1;01;547;Somme-Tourbe;140;2;142
44;Grand Est;51;1;01;548;Somme-Vesle;363;262;625
44;Grand Est;51;1;01;549;Somme-Yèvre;121;3;124
44;Grand Est;51;4;23;550;Sompuis;270;11;281
44;Grand Est;51;4;23;551;Somsois;199;6;205
44;Grand Est;51;4;23;552;Songy;265;4;269
44;Grand Est;51;1;01;553;Souain-Perthes-lès-Hurlus;240;5;245
44;Grand Est;51;1;05;555;Soudé;166;0;166
44;Grand Est;51;1;05;556;Soudron;292;5;297
44;Grand Est;51;4;23;557;Soulanges;466;9;475
44;Grand Est;51;2;22;558;Soulières;141;3;144
44;Grand Est;51;1;01;559;Suippes;3864;49;3913
44;Grand Est;51;2;06;560;Suizy-le-Franc;109;3;112
44;Grand Est;51;3;18;562;Taissy;2183;36;2219
44;Grand Est;51;2;06;563;Talus-Saint-Prix;106;2;108
44;Grand Est;51;2;07;564;Val de Livre;607;16;623
44;Grand Est;51;2;22;565;Thaas;102;0;102
44;Grand Est;51;1;04;566;Thibie;295;2;297
44;Grand Est;51;4;20;567;Thiéblemont-Farémont;527;6;533
44;Grand Est;51;3;02;568;Thil;301;6;307
44;Grand Est;51;3;09;569;Thillois;508;70;578
44;Grand Est;51;2;21;570;Le Thoult-Trosnay;105;2;107
44;Grand Est;51;3;10;571;Val-de-Vesle;916;10;926
44;Grand Est;51;1;01;572;Tilloy-et-Bellay;233;11;244
44;Grand Est;51;3;14;573;Tinqueux;10294;139;10433
44;Grand Est;51;1;05;574;Togny-aux-Bœufs;138;2;140
44;Grand Est;51;2;07;576;Tours-sur-Marne;1384;13;1397
44;Grand Est;51;3;06;577;Tramery;151;3;154
44;Grand Est;51;2;22;578;Trécon;87;1;88
44;Grand Est;51;2;21;579;Tréfols;177;3;180
44;Grand Est;51;3;10;580;Trépail;436;5;441
44;Grand Est;51;3;09;581;Treslon;246;1;247
44;Grand Est;51;3;09;582;Trigny;542;9;551
44;Grand Est;51;4;20;583;Trois-Fontaines-l'Abbaye;190;5;195
44;Grand Est;51;3;18;584;Trois-Puits;147;2;149
44;Grand Est;51;2;06;585;Troissy;794;62;856
44;Grand Est;51;3;09;586;Unchair;177;5;182
44;Grand Est;51;1;10;587;Vadenay;232;5;237
44;Grand Est;51;1;01;588;Valmy;303;5;308
44;Grand Est;51;4;20;589;Vanault-le-Châtel;174;1;175
44;Grand Est;51;4;20;590;Vanault-les-Dames;366;9;375
44;Grand Est;51;3;09;591;Vandeuil;176;3;179
44;Grand Est;51;2;06;592;Vandières;298;6;304
44;Grand Est;51;1;05;594;Vassimont-et-Chapelaine;65;1;66
44;Grand Est;51;1;05;595;Vatry;155;2;157
44;Grand Est;51;2;21;596;Vauchamps;367;10;377
44;Grand Est;51;2;06;597;Vauciennes;336;7;343
44;Grand Est;51;4;20;598;Vauclerc;485;21;506
44;Grand Est;51;3;10;599;Vaudemange;323;5;328
44;Grand Est;51;3;10;600;Vaudesincourt;98;1;99
44;Grand Est;51;4;20;601;Vavray-le-Grand;158;3;161
44;Grand Est;51;4;20;602;Vavray-le-Petit;65;0;65
44;Grand Est;51;2;22;603;Vélye;205;2;207
44;Grand Est;51;3;09;604;Ventelay;258;3;261
44;Grand Est;51;2;06;605;Venteuil;528;10;538
44;Grand Est;51;2;21;607;Verdon;206;2;208
44;Grand Est;51;4;20;608;Vernancourt;86;5;91
44;Grand Est;51;2;06;609;Verneuil;846;20;866
44;Grand Est;51;1;01;610;Verrières;391;6;397
44;Grand Est;51;2;22;611;Vert-Toulon;286;4;290
44;Grand Est;51;2;22;612;Blancs-Coteaux;3332;176;3508
44;Grand Est;51;3;10;613;Verzenay;1047;8;1055
44;Grand Est;51;3;10;614;Verzy;961;23;984
44;Grand Est;51;1;05;616;Vésigneul-sur-Marne;233;3;236
44;Grand Est;51;1;04;617;La Veuve;605;11;616
44;Grand Est;51;2;21;618;Le Vézier;190;3;193
44;Grand Est;51;1;01;619;Le Vieil-Dampierre;113;3;116
44;Grand Est;51;1;01;620;Vienne-la-Ville;173;7;180
44;Grand Est;51;1;01;621;Vienne-le-Château;517;10;527
44;Grand Est;51;3;09;622;Ville-Dommange;401;9;410
44;Grand Est;51;3;10;623;Ville-en-Selve;281;46;327
44;Grand Est;51;3;06;624;Ville-en-Tardenois;648;6;654
44;Grand Est;51;2;21;625;Villeneuve-la-Lionne;283;3;286
44;Grand Est;51;2;21;626;La Villeneuve-lès-Charleville;118;4;122
44;Grand Est;51;2;22;627;Villeneuve-Renneville-Chevigny;323;11;334
44;Grand Est;51;2;21;628;Villeneuve-Saint-Vistre-et-Villevotte;122;5;127
44;Grand Est;51;3;10;629;Villers-Allerand;912;23;935
44;Grand Est;51;2;22;630;Villers-aux-Bois;330;5;335
44;Grand Est;51;3;14;631;Villers-aux-Nœuds;246;6;252
44;Grand Est;51;1;01;632;Villers-en-Argonne;237;6;243
44;Grand Est;51;3;02;633;Villers-Franqueux;296;15;311
44;Grand Est;51;1;04;634;Villers-le-Château;264;8;272
44;Grand Est;51;4;20;635;Villers-le-Sec;110;1;111
44;Grand Est;51;3;10;636;Villers-Marmery;501;12;513
44;Grand Est;51;2;06;637;Villers-sous-Châtillon;212;3;215
44;Grand Est;51;2;22;638;Villeseneux;207;6;213
44;Grand Est;51;2;06;639;La Ville-sous-Orbais;43;1;44
44;Grand Est;51;1;01;640;Ville-sur-Tourbe;213;1;214
44;Grand Est;51;2;06;641;Villevenard;203;5;208
44;Grand Est;51;2;22;642;Villiers-aux-Corneilles;111;4;115
44;Grand Est;51;2;08;643;Vinay;549;5;554
44;Grand Est;51;2;06;644;Vincelles;308;10;318
44;Grand Est;51;2;21;645;Vindey;110;2;112
44;Grand Est;51;1;01;646;Virginy;82;3;85
44;Grand Est;51;4;20;647;Vitry-en-Perthois;830;24;854
44;Grand Est;51;1;05;648;Vitry-la-Ville;382;9;391
44;Grand Est;51;4;23;649;Vitry-le-François;11376;251;11627
44;Grand Est;51;1;01;650;Voilemont;46;1;47
44;Grand Est;51;2;22;652;Vouarces;58;0;58
44;Grand Est;51;4;20;654;Vouillers;258;2;260
44;Grand Est;51;2;22;655;Vouzy;291;5;296
44;Grand Est;51;1;04;656;Vraux;454;18;472
44;Grand Est;51;3;09;657;Vrigny;247;0;247
44;Grand Est;51;4;20;658;Vroil;104;0;104
44;Grand Est;51;1;01;659;Wargemoulin-Hurlus;47;1;48
44;Grand Est;51;3;02;660;Warmeriville;2591;28;2619
44;Grand Est;51;3;02;662;Witry-lès-Reims;4971;74;5045
44;Grand Est;51;2;07;663;Magenta;1697;15;1712
44;Grand Est;52;1;11;001;Ageville;312;8;320
44;Grand Est;52;2;02;002;Aigremont;23;0;23
44;Grand Est;52;1;12;003;Aillianville;150;2;152
44;Grand Est;52;3;12;004;Aingoulaincourt;13;0;13
44;Grand Est;52;1;04;005;Aizanville;34;4;38
44;Grand Est;52;3;13;006;Allichamps;355;4;359
44;Grand Est;52;3;09;007;Ambonville;87;2;89
44;Grand Est;52;1;01;008;Andelot-Blancheville;867;10;877
44;Grand Est;52;2;11;009;Andilly-en-Bassigny;105;1;106
44;Grand Est;52;1;01;011;Annéville-la-Prairie;91;0;91
44;Grand Est;52;3;12;012;Annonville;30;2;32
44;Grand Est;52;2;03;013;Anrosey;124;2;126
44;Grand Est;52;2;16;014;Aprey;187;5;192
44;Grand Est;52;2;03;015;Arbigny-sous-Varennes;86;0;86
44;Grand Est;52;2;16;016;Arbot;68;2;70
44;Grand Est;52;1;04;017;Arc-en-Barrois;729;14;743
44;Grand Est;52;3;09;019;Arnancourt;90;4;94
44;Grand Est;52;3;17;021;Attancourt;267;4;271
44;Grand Est;52;1;04;022;Aubepierre-sur-Aube;185;3;188
44;Grand Est;52;2;16;023;Auberive;155;5;160
44;Grand Est;52;1;12;025;Audeloncourt;87;2;89
44;Grand Est;52;2;16;027;Aujeurres;73;2;75
44;Grand Est;52;2;16;028;Aulnoy-sur-Aube;54;0;54
44;Grand Est;52;3;09;029;Autigny-le-Grand;138;4;142
44;Grand Est;52;3;09;030;Autigny-le-Petit;56;4;60
44;Grand Est;52;1;04;031;Autreville-sur-la-Renne;371;9;380
44;Grand Est;52;2;02;033;Avrecourt;108;4;112
44;Grand Est;52;3;17;034;Bailly-aux-Forges;143;5;148
44;Grand Est;52;2;16;035;Baissey;186;3;189
44;Grand Est;52;2;11;037;Bannes;370;3;373
44;Grand Est;52;1;12;038;Bassoncourt;64;0;64
44;Grand Est;52;3;09;039;Baudrecourt;89;0;89
44;Grand Est;52;2;16;040;Bay-sur-Aube;54;1;55
44;Grand Est;52;2;10;042;Beauchemin;107;1;108
44;Grand Est;52;2;03;043;Belmont;58;2;60
44;Grand Est;52;3;01;044;Roches-Bettaincourt;553;11;564
44;Grand Est;52;3;15;045;Bettancourt-la-Ferrée;1792;39;1831
44;Grand Est;52;3;09;047;Beurville;103;0;103
44;Grand Est;52;1;11;050;Biesles;1340;31;1371
44;Grand Est;52;2;03;051;Bize;85;4;89
44;Grand Est;52;1;04;053;Blaisy;73;1;74
44;Grand Est;52;3;09;055;Blécourt;115;2;117
44;Grand Est;52;1;04;056;Blessonville;187;6;193
44;Grand Est;52;3;09;057;Blumeray;104;4;108
44;Grand Est;52;1;01;058;Bologne;1851;27;1878
44;Grand Est;52;2;11;059;Bonnecourt;141;0;141
44;Grand Est;52;2;02;060;Bourbonne-les-Bains;1977;53;2030
44;Grand Est;52;1;01;061;Bourdons-sur-Rognon;291;2;293
44;Grand Est;52;2;16;062;Bourg;160;4;164
44;Grand Est;52;1;12;063;Bourg-Sainte-Marie;99;1;100
44;Grand Est;52;1;12;064;Bourmont-entre-Meuse-et-Mouzon;781;34;815
44;Grand Est;52;3;09;065;Bouzancourt;65;1;66
44;Grand Est;52;3;09;066;Brachay;63;3;66
44;Grand Est;52;1;12;067;Brainville-sur-Meuse;75;0;75
44;Grand Est;52;1;04;069;Braux-le-Châtel;144;1;145
44;Grand Est;52;2;16;070;Brennes;123;3;126
44;Grand Est;52;1;05;072;Brethenay;379;10;389
44;Grand Est;52;1;12;074;Breuvannes-en-Bassigny;673;20;693
44;Grand Est;52;1;01;075;Briaucourt;177;6;183
44;Grand Est;52;1;04;076;Bricon;448;14;462
44;Grand Est;52;3;17;079;Brousseval;659;10;669
44;Grand Est;52;1;04;082;Bugnières;155;5;160
44;Grand Est;52;2;03;083;Champsevraine;737;14;751
44;Grand Est;52;1;12;084;Busson;42;0;42
44;Grand Est;52;1;02;085;Buxières-lès-Clefmont;26;2;28
44;Grand Est;52;1;06;087;Buxières-lès-Villiers;197;20;217
44;Grand Est;52;3;17;088;Ceffonds;645;21;666
44;Grand Est;52;2;02;089;Celles-en-Bassigny;76;0;76
44;Grand Est;52;2;03;090;Celsoy;102;1;103
44;Grand Est;52;3;01;091;Cerisières;85;7;92
44;Grand Est;52;2;16;092;Chalancey;105;2;107
44;Grand Est;52;2;03;093;Chalindrey;2429;42;2471
44;Grand Est;52;2;16;094;Vals-des-Tilles;178;2;180
44;Grand Est;52;1;12;095;Chalvraines;190;2;192
44;Grand Est;52;1;12;097;Chambroncourt;49;1;50
44;Grand Est;52;3;08;099;Chamouilley;798;10;808
44;Grand Est;52;1;12;101;Champigneulles-en-Bassigny;41;1;42
44;Grand Est;52;2;10;102;Champigny-lès-Langres;422;13;435
44;Grand Est;52;2;03;103;Champigny-sous-Varennes;113;2;115
44;Grand Est;52;3;15;104;Chancenay;1045;23;1068
44;Grand Est;52;2;11;105;Changey;300;11;311
44;Grand Est;52;2;10;106;Chanoy;122;2;124
44;Grand Est;52;1;01;107;Chantraines;226;5;231
44;Grand Est;52;2;11;108;Charmes;146;4;150
44;Grand Est;52;3;09;109;Charmes-en-l'Angle;7;0;7
44;Grand Est;52;3;09;110;Charmes-la-Grande;153;6;159
44;Grand Est;52;2;16;113;Chassigny;261;2;263
44;Grand Est;52;1;04;114;Châteauvillain;1579;17;1596
44;Grand Est;52;2;10;115;Chatenay-Mâcheron;99;2;101
44;Grand Est;52;2;10;116;Chatenay-Vaudin;49;2;51
44;Grand Est;52;3;09;118;Chatonrupt-Sommermont;279;6;285
44;Grand Est;52;2;03;119;Chaudenay;345;9;354
44;Grand Est;52;2;02;120;Chauffourt;189;7;196
44;Grand Est;52;1;98;121;Chaumont;21847;1195;23042
44;Grand Est;52;1;12;122;Chaumont-la-Ville;116;1;117
44;Grand Est;52;3;08;123;Chevillon;1297;21;1318
44;Grand Est;52;2;03;124;Chézeaux;76;0;76
44;Grand Est;52;1;06;125;Chamarandes-Choignes;1042;172;1214
44;Grand Est;52;2;16;126;Choilley-Dardenay;159;4;163
44;Grand Est;52;1;02;127;Choiseul;78;4;82
44;Grand Est;52;1;01;128;Cirey-lès-Mareilles;145;3;148
44;Grand Est;52;3;09;129;Cirey-sur-Blaise;121;1;122
44;Grand Est;52;1;04;130;Cirfontaines-en-Azois;189;1;190
44;Grand Est;52;3;12;131;Cirfontaines-en-Ornois;74;1;75
44;Grand Est;52;1;02;132;Clefmont;168;3;171
44;Grand Est;52;1;12;133;Clinchamp;71;0;71
44;Grand Est;52;2;16;134;Cohons;223;1;224
44;Grand Est;52;2;03;135;Coiffy-le-Bas;88;0;88
44;Grand Est;52;2;02;136;Coiffy-le-Haut;111;0;111
44;Grand Est;52;2;16;137;Colmier-le-Bas;22;0;22
44;Grand Est;52;2;16;138;Colmier-le-Haut;63;1;64
44;Grand Est;52;1;04;140;Colombey les Deux Églises;706;22;728
44;Grand Est;52;1;05;141;Condes;298;6;304
44;Grand Est;52;1;01;142;Consigny;72;1;73
44;Grand Est;52;2;16;145;Coublanc;118;5;123
44;Grand Est;52;1;04;146;Coupray;155;3;158
44;Grand Est;52;2;16;147;Courcelles-en-Montagne;89;0;89
44;Grand Est;52;3;09;149;Courcelles-sur-Blaise;93;2;95
44;Grand Est;52;1;04;151;Cour-l'Évêque;148;2;150
44;Grand Est;52;2;03;155;Culmont;513;12;525
44;Grand Est;52;3;08;156;Curel;407;7;414
44;Grand Est;52;1;04;157;Curmont;12;1;13
44;Grand Est;52;2;16;158;Cusey;282;4;286
44;Grand Est;52;1;11;159;Cuves;26;1;27
44;Grand Est;52;1;01;160;Daillancourt;64;2;66
44;Grand Est;52;1;02;161;Daillecourt;72;0;72
44;Grand Est;52;2;02;162;Dammartin-sur-Meuse;197;2;199
44;Grand Est;52;2;11;163;Dampierre;384;4;388
44;Grand Est;52;2;02;164;Damrémont;197;5;202
44;Grand Est;52;1;04;165;Dancevoir;194;5;199
44;Grand Est;52;1;01;167;Darmannes;262;3;265
44;Grand Est;52;1;04;168;Dinteville;60;3;63
44;Grand Est;52;3;08;169;Domblain;78;2;80
44;Grand Est;52;2;16;170;Dommarien;166;7;173
44;Grand Est;52;3;17;171;Dommartin-le-Franc;243;3;246
44;Grand Est;52;3;09;172;Dommartin-le-Saint-Père;280;7;287
44;Grand Est;52;3;01;173;Domremy-Landéville;77;2;79
44;Grand Est;52;1;12;174;Doncourt-sur-Meuse;37;1;38
44;Grand Est;52;3;09;175;Donjeux;390;4;394
44;Grand Est;52;3;01;177;Doulaincourt-Saucourt;790;34;824
44;Grand Est;52;3;09;178;Doulevant-le-Château;362;10;372
44;Grand Est;52;3;17;179;Doulevant-le-Petit;20;2;22
44;Grand Est;52;3;12;181;Échenay;91;2;93
44;Grand Est;52;3;13;182;Éclaron-Braucourt-Sainte-Livière;2017;46;2063
44;Grand Est;52;1;01;183;Ecot-la-Combe;39;1;40
44;Grand Est;52;3;12;184;Effincourt;59;5;64
44;Grand Est;52;2;02;185;Enfonvelle;61;1;62
44;Grand Est;52;3;12;187;Épizon;159;4;163
44;Grand Est;52;2;16;189;Le Val-d'Esnoms;400;11;411
44;Grand Est;52;1;11;190;Esnouveaux;286;5;291
44;Grand Est;52;1;05;193;Euffigneix;302;13;315
44;Grand Est;52;3;08;194;Eurville-Bienville;2033;33;2066
44;Grand Est;52;2;03;195;Farincourt;37;0;37
44;Grand Est;52;2;10;196;Faverolles;96;4;100
44;Grand Est;52;2;03;197;Fayl-Billot;1298;96;1394
44;Grand Est;52;3;08;198;Fays;70;3;73
44;Grand Est;52;3;09;199;Ferrière-et-Lafolie;50;2;52
44;Grand Est;52;2;16;200;Flagey;77;5;82
44;Grand Est;52;3;09;201;Flammerécourt;69;0;69
44;Grand Est;52;3;08;203;Fontaines-sur-Marne;146;2;148
44;Grand Est;52;1;11;204;Forcey;63;4;67
44;Grand Est;52;1;07;205;Foulain;687;17;704
44;Grand Est;52;3;17;206;Frampas;154;4;158
44;Grand Est;52;2;02;207;Frécourt;99;4;103
44;Grand Est;52;2;02;208;Fresnes-sur-Apance;146;2;148
44;Grand Est;52;1;01;211;Froncles;1449;23;1472
44;Grand Est;52;3;09;212;Fronville;308;3;311
44;Grand Est;52;2;03;213;Genevrières;131;6;137
44;Grand Est;52;1;01;214;La Genevroye;31;1;32
44;Grand Est;52;2;16;216;Germaines;47;1;48
44;Grand Est;52;1;12;217;Germainvilliers;87;4;91
44;Grand Est;52;3;12;218;Germay;48;0;48
44;Grand Est;52;3;12;219;Germisay;18;0;18
44;Grand Est;52;1;04;220;Giey-sur-Aujon;142;1;143
44;Grand Est;52;1;04;221;Gillancourt;118;4;122
44;Grand Est;52;3;12;222;Gillaumé;35;0;35
44;Grand Est;52;2;03;223;Gilley;65;3;68
44;Grand Est;52;1;12;227;Graffigny-Chemin;215;10;225
44;Grand Est;52;2;03;228;Grandchamp;78;1;79
44;Grand Est;52;2;03;229;Grenant;151;2;153
44;Grand Est;52;3;09;230;Gudmont-Villiers;281;5;286
44;Grand Est;52;3;09;231;Guindrecourt-aux-Ormes;91;2;93
44;Grand Est;52;1;01;232;Guindrecourt-sur-Blaise;62;0;62
44;Grand Est;52;2;03;233;Guyonvelle;104;2;106
44;Grand Est;52;1;12;234;Hâcourt;41;0;41
44;Grand Est;52;3;13;235;Hallignicourt;260;4;264
44;Grand Est;52;1;12;237;Harréville-les-Chanteurs;278;10;288
44;Grand Est;52;2;03;240;Heuilley-le-Grand;193;7;200
44;Grand Est;52;2;03;242;Haute-Amance;962;16;978
44;Grand Est;52;1;12;243;Huilliécourt;120;1;121
44;Grand Est;52;3;13;244;Humbécourt;761;10;771
44;Grand Est;52;1;12;245;Humberville;62;5;67
44;Grand Est;52;2;10;246;Humes-Jorquenay;579;12;591
44;Grand Est;52;1;12;247;Illoud;207;8;215
44;Grand Est;52;1;02;248;Is-en-Bassigny;545;17;562
44;Grand Est;52;2;16;249;Isômes;147;6;153
44;Grand Est;52;3;09;250;Joinville;3015;68;3083
44;Grand Est;52;1;05;251;Jonchery;995;35;1030
44;Grand Est;52;1;04;253;Juzennecourt;212;3;215
44;Grand Est;52;1;04;254;Lachapelle-en-Blaisy;85;3;88
44;Grand Est;52;1;12;256;Lafauche;75;4;79
44;Grand Est;52;2;03;257;Laferté-sur-Amance;105;2;107
44;Grand Est;52;1;04;258;Laferté-sur-Aube;311;2;313
44;Grand Est;52;1;01;260;Lamancine;123;3;126
44;Grand Est;52;2;02;264;Laneuvelle;61;2;63
44;Grand Est;52;3;08;265;Bayard-sur-Marne;1298;28;1326
44;Grand Est;52;3;17;266;Laneuville-à-Rémy;66;0;66
44;Grand Est;52;3;13;267;Laneuville-au-Pont;216;3;219
44;Grand Est;52;2;10;269;Langres;7668;396;8064
44;Grand Est;52;1;11;271;Lanques-sur-Rognon;197;6;203
44;Grand Est;52;1;04;272;Lanty-sur-Aube;114;2;116
44;Grand Est;52;2;02;273;Larivière-Arnoncourt;121;1;122
44;Grand Est;52;1;04;274;Latrecey-Ormoy-sur-Aube;291;9;300
44;Grand Est;52;2;02;275;Lavernoy;69;0;69
44;Grand Est;52;1;06;276;Laville-aux-Bois;223;7;230
44;Grand Est;52;2;02;277;Lavilleneuve;59;1;60
44;Grand Est;52;1;04;278;Lavilleneuve-au-Roi;71;0;71
44;Grand Est;52;2;10;280;Lecey;199;3;202
44;Grand Est;52;1;04;282;Leffonds;340;5;345
44;Grand Est;52;3;09;284;Leschères-sur-le-Blaiseron;94;1;95
44;Grand Est;52;2;16;285;Leuchey;78;2;80
44;Grand Est;52;1;12;286;Leurville;77;0;77
44;Grand Est;52;1;12;287;Levécourt;88;1;89
44;Grand Est;52;3;12;288;Lezéville;121;0;121
44;Grand Est;52;1;12;289;Liffol-le-Petit;315;8;323
44;Grand Est;52;2;03;290;Les Loges;132;2;134
44;Grand Est;52;1;12;291;Longchamp;62;0;62
44;Grand Est;52;2;16;292;Longeau-Percey;722;18;740
44;Grand Est;52;3;13;294;Louvemont;696;13;709
44;Grand Est;52;1;11;295;Louvières;94;0;94
44;Grand Est;52;1;07;297;Luzy-sur-Marne;273;11;284
44;Grand Est;52;2;16;298;Maâtz;73;1;74
44;Grand Est;52;3;08;300;Magneux;163;2;165
44;Grand Est;52;1;12;301;Maisoncelles;61;1;62
44;Grand Est;52;3;08;302;Maizières;189;3;192
44;Grand Est;52;2;03;303;Maizières-sur-Amance;95;1;96
44;Grand Est;52;1;12;304;Malaincourt-sur-Meuse;52;1;53
44;Grand Est;52;1;11;305;Mandres-la-Côte;553;5;558
44;Grand Est;52;1;12;306;Manois;444;9;453
44;Grand Est;52;2;10;307;Marac;214;4;218
44;Grand Est;52;1;04;308;Maranville;403;4;407
44;Grand Est;52;1;01;310;Marbéville;99;2;101
44;Grand Est;52;2;02;311;Marcilly-en-Bassigny;224;4;228
44;Grand Est;52;2;10;312;Mardor;53;3;56
44;Grand Est;52;1;01;313;Mareilles;143;1;144
44;Grand Est;52;1;11;315;Marnay-sur-Marne;336;1;337
44;Grand Est;52;3;09;316;Mathons;69;2;71
44;Grand Est;52;2;02;318;Melay;245;6;251
44;Grand Est;52;1;12;319;Mennouveaux;71;0;71
44;Grand Est;52;1;12;320;Merrey;94;3;97
44;Grand Est;52;3;09;321;Mertrud;179;7;186
44;Grand Est;52;1;01;322;Meures;132;4;136
44;Grand Est;52;1;12;325;Millières;117;5;122
44;Grand Est;52;1;01;326;Mirbel;43;0;43
44;Grand Est;52;3;13;327;Moëslains;444;10;454
44;Grand Est;52;2;02;328;Montcharvot;32;1;33
44;Grand Est;52;1;04;330;Montheries;68;2;70
44;Grand Est;52;3;17;331;La Porte du Der;2282;65;2347
44;Grand Est;52;2;02;332;Val-de-Meuse;1832;54;1886
44;Grand Est;52;1;01;335;Montot-sur-Rognon;120;1;121
44;Grand Est;52;3;17;336;Montreuil-sur-Blaise;147;3;150
44;Grand Est;52;3;12;337;Montreuil-sur-Thonnance;59;0;59
44;Grand Est;52;3;17;341;Morancourt;131;2;133
44;Grand Est;52;1;12;342;Morionvilliers;27;1;28
44;Grand Est;52;2;16;344;Mouilleron;31;1;32
44;Grand Est;52;3;09;346;Mussey-sur-Marne;381;6;387
44;Grand Est;52;3;08;347;Narcy;237;5;242
44;Grand Est;52;2;11;348;Neuilly-l'Évêque;580;19;599
44;Grand Est;52;1;07;349;Neuilly-sur-Suize;307;9;316
44;Grand Est;52;2;02;350;Neuvelle-lès-Voisey;68;0;68
44;Grand Est;52;1;11;352;Ninville;68;4;72
44;Grand Est;52;1;11;353;Nogent;3591;61;3652
44;Grand Est;52;2;03;354;Noidant-Chatenoy;84;0;84
44;Grand Est;52;2;16;355;Noidant-le-Rocheux;151;4;155
44;Grand Est;52;3;09;356;Nomécourt;108;4;112
44;Grand Est;52;3;12;357;Noncourt-sur-le-Rongeant;177;2;179
44;Grand Est;52;1;02;358;Noyers;90;0;90
44;Grand Est;52;3;09;359;Nully;150;3;153
44;Grand Est;52;2;16;360;Occey;165;3;168
44;Grand Est;52;2;11;362;Orbigny-au-Mont;136;2;138
44;Grand Est;52;2;11;363;Orbigny-au-Val;98;7;105
44;Grand Est;52;2;16;364;Orcevaux;102;3;105
44;Grand Est;52;1;04;365;Orges;345;3;348
44;Grand Est;52;2;10;366;Ormancey;77;1;78
44;Grand Est;52;1;01;367;Ormoy-lès-Sexfontaines;41;1;42
44;Grand Est;52;1;12;369;Orquevaux;70;0;70
44;Grand Est;52;3;08;370;Osne-le-Val;255;5;260
44;Grand Est;52;1;01;371;Oudincourt;139;2;141
44;Grand Est;52;1;12;372;Outremécourt;84;6;90
44;Grand Est;52;1;12;373;Ozières;33;1;34
44;Grand Est;52;2;03;374;Le Pailly;276;5;281
44;Grand Est;52;2;03;375;Palaiseul;55;0;55
44;Grand Est;52;3;12;376;Pansey;106;3;109
44;Grand Est;52;2;02;377;Parnoy-en-Bassigny;288;8;296
44;Grand Est;52;3;12;378;Paroy-sur-Saulx;46;2;48
44;Grand Est;52;2;10;380;Peigney;382;4;386
44;Grand Est;52;2;10;383;Perrancey-les-Vieux-Moulins;292;7;299
44;Grand Est;52;2;16;384;Perrogney-les-Fontaines;112;0;112
44;Grand Est;52;1;02;385;Perrusse;30;2;32
44;Grand Est;52;3;13;386;Perthes;515;4;519
44;Grand Est;52;2;03;388;Pierremont-sur-Amance;149;2;151
44;Grand Est;52;2;03;390;Pisseloup;56;1;57
44;Grand Est;52;3;17;391;Planrupt;306;8;314
44;Grand Est;52;2;11;392;Plesnoy;115;2;117
44;Grand Est;52;2;16;393;Poinsenot;55;0;55
44;Grand Est;52;2;03;394;Poinson-lès-Fayl;213;9;222
44;Grand Est;52;2;16;395;Poinson-lès-Grancey;55;0;55
44;Grand Est;52;1;11;396;Poinson-lès-Nogent;140;3;143
44;Grand Est;52;2;11;397;Poiseul;71;1;72
44;Grand Est;52;3;12;398;Poissons;632;14;646
44;Grand Est;52;1;04;399;Pont-la-Ville;105;7;112
44;Grand Est;52;2;02;400;Le Châtelet-sur-Meuse;155;0;155
44;Grand Est;52;1;11;401;Poulangy;367;12;379
44;Grand Est;52;2;16;403;Praslay;78;1;79
44;Grand Est;52;2;16;405;Le Montsaugeonnais;1188;22;1210
44;Grand Est;52;2;03;406;Pressigny;198;5;203
44;Grand Est;52;1;12;407;Prez-sous-Lafauche;281;7;288
44;Grand Est;52;3;17;411;Rives Dervoises;1329;47;1376
44;Grand Est;52;3;17;413;Rachecourt-Suzémont;106;2;108
44;Grand Est;52;3;08;414;Rachecourt-sur-Marne;770;12;782
44;Grand Est;52;2;02;415;Rançonnières;115;0;115
44;Grand Est;52;1;02;416;Rangecourt;63;1;64
44;Grand Est;52;1;04;419;Rennepont;131;5;136
44;Grand Est;52;1;01;420;Reynel;126;1;127
44;Grand Est;52;1;05;421;Riaucourt;477;9;486
44;Grand Est;52;1;04;422;Richebourg;262;5;267
44;Grand Est;52;1;01;423;Rimaucourt;671;8;679
44;Grand Est;52;2;03;424;Rivières-le-Bois;69;0;69
44;Grand Est;52;2;16;425;Rivière-les-Fosses;196;4;200
44;Grand Est;52;1;04;426;Rizaucourt-Buchey;128;1;129
44;Grand Est;52;1;01;428;Rochefort-sur-la-Côte;64;1;65
44;Grand Est;52;3;08;429;Roches-sur-Marne;556;3;559
44;Grand Est;52;2;16;431;Rochetaillée;168;2;170
44;Grand Est;52;2;11;432;Rolampont;1413;30;1443
44;Grand Est;52;1;12;433;Romain-sur-Meuse;91;1;92
44;Grand Est;52;3;01;436;Rouécourt;49;1;50
44;Grand Est;52;2;16;437;Rouelles;25;0;25
44;Grand Est;52;2;03;438;Rougeux;104;2;106
44;Grand Est;52;2;16;439;Rouvres-sur-Aube;76;1;77
44;Grand Est;52;3;09;440;Rouvroy-sur-Marne;375;7;382
44;Grand Est;52;3;09;442;Rupt;343;10;353
44;Grand Est;52;3;12;443;Sailly;33;0;33
44;Grand Est;52;1;12;444;Saint-Blin;352;10;362
44;Grand Est;52;2;03;445;Saint-Broingt-le-Bois;69;2;71
44;Grand Est;52;2;16;446;Saint-Broingt-les-Fosses;233;4;237
44;Grand Est;52;2;10;447;Saint-Ciergues;183;2;185
44;Grand Est;52;3;99;448;Saint-Dizier;22928;499;23427
44;Grand Est;52;2;10;449;Saints-Geosmes;1116;32;1148
44;Grand Est;52;2;16;450;Saint-Loup-sur-Aujon;129;4;133
44;Grand Est;52;2;10;452;Saint-Martin-lès-Langres;109;0;109
44;Grand Est;52;2;10;453;Saint-Maurice;132;1;133
44;Grand Est;52;1;12;455;Saint-Thiébault;236;6;242
44;Grand Est;52;3;09;456;Saint-Urbain-Maconcourt;638;10;648
44;Grand Est;52;2;03;457;Saint-Vallier-sur-Marne;172;3;175
44;Grand Est;52;1;11;459;Sarcey;113;1;114
44;Grand Est;52;2;02;461;Sarrey;380;10;390
44;Grand Est;52;3;12;463;Saudron;45;2;47
44;Grand Est;52;2;03;464;Saulles;48;2;50
44;Grand Est;52;2;02;465;Saulxures;130;0;130
44;Grand Est;52;2;03;467;Savigny;59;2;61
44;Grand Est;52;1;12;468;Semilly;110;4;114
44;Grand Est;52;1;07;469;Semoutiers-Montsaon;741;16;757
44;Grand Est;52;2;02;470;Serqueux;369;13;382
44;Grand Est;52;1;01;472;Sexfontaines;141;0;141
44;Grand Est;52;1;01;473;Signéville;90;1;91
44;Grand Est;52;1;04;474;Silvarouvres;36;0;36
44;Grand Est;52;3;08;475;Sommancourt;60;6;66
44;Grand Est;52;1;12;476;Sommerécourt;81;3;84
44;Grand Est;52;3;17;479;Sommevoire;664;18;682
44;Grand Est;52;1;01;480;Soncourt-sur-Marne;362;8;370
44;Grand Est;52;1;12;482;Soulaucourt-sur-Mouzon;97;2;99
44;Grand Est;52;2;03;483;Soyers;68;1;69
44;Grand Est;52;3;09;484;Suzannecourt;360;15;375
44;Grand Est;52;2;16;486;Ternat;64;0;64
44;Grand Est;52;3;17;487;Thilleux;70;3;73
44;Grand Est;52;1;11;488;Thivet;271;0;271
44;Grand Est;52;1;12;489;Thol-lès-Millières;35;1;36
44;Grand Est;52;3;09;490;Thonnance-lès-Joinville;682;21;703
44;Grand Est;52;3;12;491;Thonnance-les-Moulins;116;5;121
44;Grand Est;52;2;03;492;Torcenay;554;14;568
44;Grand Est;52;2;03;493;Tornay;30;0;30
44;Grand Est;52;1;05;494;Treix;221;9;230
44;Grand Est;52;3;09;495;Trémilly;85;1;86
44;Grand Est;52;3;08;497;Troisfontaines-la-Ville;433;9;442
44;Grand Est;52;2;16;499;Vaillant;43;0;43
44;Grand Est;52;3;13;500;Valcourt;622;9;631
44;Grand Est;52;3;08;502;Valleret;65;0;65
44;Grand Est;52;2;03;503;Valleroy;25;0;25
44;Grand Est;52;2;03;504;Varennes-sur-Amance;261;4;265
44;Grand Est;52;1;12;505;Vaudrecourt;35;0;35
44;Grand Est;52;1;04;506;Vaudrémont;96;3;99
44;Grand Est;52;2;16;507;Vauxbons;56;0;56
44;Grand Est;52;3;17;510;Vaux-sur-Blaise;372;7;379
44;Grand Est;52;3;09;511;Vaux-sur-Saint-Urbain;56;2;58
44;Grand Est;52;3;09;512;Vecqueville;512;15;527
44;Grand Est;52;2;03;513;Velles;62;1;63
44;Grand Est;52;1;07;514;Verbiesles;342;11;353
44;Grand Est;52;2;16;515;Verseilles-le-Bas;103;4;107
44;Grand Est;52;2;16;516;Verseilles-le-Haut;49;4;53
44;Grand Est;52;1;12;517;Vesaignes-sous-Lafauche;134;1;135
44;Grand Est;52;1;11;518;Vesaignes-sur-Marne;101;2;103
44;Grand Est;52;2;16;519;Vesvres-sous-Chalancey;46;0;46
44;Grand Est;52;2;02;520;Vicq;149;7;156
44;Grand Est;52;1;01;522;Viéville;339;10;349
44;Grand Est;52;1;01;523;Vignes-la-Côte;67;4;71
44;Grand Est;52;1;01;524;Vignory;233;0;233
44;Grand Est;52;1;04;525;Villars-en-Azois;69;1;70
44;Grand Est;52;2;16;526;Villars-Santenoge;79;1;80
44;Grand Est;52;3;17;528;Ville-en-Blaisois;146;1;147
44;Grand Est;52;2;16;529;Villegusien-le-Lac;983;18;1001
44;Grand Est;52;3;13;534;Villiers-en-Lieu;1498;36;1534
44;Grand Est;52;1;06;535;Villiers-le-Sec;714;11;725
44;Grand Est;52;2;16;536;Villiers-lès-Aprey;45;0;45
44;Grand Est;52;1;04;538;Villiers-sur-Suize;263;2;265
44;Grand Est;52;2;03;539;Violot;67;0;67
44;Grand Est;52;2;16;540;Vitry-en-Montagne;22;0;22
44;Grand Est;52;1;11;541;Vitry-lès-Nogent;204;4;208
44;Grand Est;52;2;16;542;Vivey;52;1;53
44;Grand Est;52;3;17;543;Voillecomte;516;10;526
44;Grand Est;52;2;02;544;Voisey;277;2;279
44;Grand Est;52;2;16;545;Voisines;107;2;109
44;Grand Est;52;2;03;546;Voncourt;15;0;15
44;Grand Est;52;1;01;547;Vouécourt;202;1;203
44;Grand Est;52;1;01;548;Vraincourt;92;2;94
44;Grand Est;52;1;12;549;Vroncourt-la-Côte;27;0;27
44;Grand Est;52;3;17;550;Wassy;2819;110;2929
52;Pays de la Loire;53;2;08;001;Ahuillé;1831;59;1890
52;Pays de la Loire;53;3;14;002;Alexain;606;9;615
52;Pays de la Loire;53;3;07;003;Ambrières-les-Vallées;2639;69;2708
52;Pays de la Loire;53;3;05;005;Andouillé;2319;50;2369
52;Pays de la Loire;53;2;02;007;Argentré;2825;75;2900
52;Pays de la Loire;53;3;09;008;Aron;1819;50;1869
52;Pays de la Loire;53;1;15;009;Arquenay;659;14;673
52;Pays de la Loire;53;3;06;010;Assé-le-Bérenger;460;13;473
52;Pays de la Loire;53;1;04;011;Astillé;879;19;898
52;Pays de la Loire;53;1;04;012;Athée;476;26;502
52;Pays de la Loire;53;3;17;013;Averton;564;16;580
52;Pays de la Loire;53;3;05;015;La Baconnière;1923;44;1967
52;Pays de la Loire;53;3;06;016;Bais;1224;14;1238
52;Pays de la Loire;53;1;15;017;Val-du-Maine;956;27;983
52;Pays de la Loire;53;1;04;018;Ballots;1298;32;1330
52;Pays de la Loire;53;1;15;019;Bannes;118;3;121
52;Pays de la Loire;53;3;09;021;La Bazoge-Montpinçon;1047;28;1075
52;Pays de la Loire;53;1;15;022;La Bazouge-de-Chemeré;516;10;526
52;Pays de la Loire;53;3;06;023;La Bazouge-des-Alleux;561;6;567
52;Pays de la Loire;53;1;15;025;Bazougers;1096;12;1108
52;Pays de la Loire;53;2;13;026;Beaulieu-sur-Oudon;529;9;538
52;Pays de la Loire;53;1;15;027;Beaumont-Pied-de-Bœuf;203;3;206
52;Pays de la Loire;53;3;09;028;Belgeard;585;12;597
52;Pays de la Loire;53;1;01;029;Bierné-les-Villages;1252;32;1284
52;Pays de la Loire;53;1;15;030;Le Bignon-du-Maine;325;4;329
52;Pays de la Loire;53;3;05;031;La Bigottière;496;2;498
52;Pays de la Loire;53;1;04;033;La Boissière;115;5;120
52;Pays de la Loire;53;2;02;034;Bonchamp-lès-Laval;6137;193;6330
52;Pays de la Loire;53;1;03;035;Bouchamps-lès-Craon;587;9;596
52;Pays de la Loire;53;1;15;036;Bouère;1065;20;1085
52;Pays de la Loire;53;1;15;037;Bouessay;729;26;755
52;Pays de la Loire;53;3;17;038;Boulay-les-Ifs;143;4;147
52;Pays de la Loire;53;2;13;039;Le Bourgneuf-la-Forêt;1736;36;1772
52;Pays de la Loire;53;2;13;040;Bourgon;630;12;642
52;Pays de la Loire;53;1;04;041;Brains-sur-les-Marches;277;5;282
52;Pays de la Loire;53;3;07;042;Brecé;844;12;856
52;Pays de la Loire;53;3;06;043;Brée;554;11;565
52;Pays de la Loire;53;2;13;045;La Brûlatte;682;18;700
52;Pays de la Loire;53;1;15;046;Le Buret;307;3;310
52;Pays de la Loire;53;3;07;047;Carelles;269;4;273
52;Pays de la Loire;53;3;05;048;Chailland;1155;34;1189
52;Pays de la Loire;53;2;02;049;Châlons-du-Maine;711;8;719
52;Pays de la Loire;53;3;09;051;Champéon;600;6;606
52;Pays de la Loire;53;3;17;052;Champfrémont;293;7;300
52;Pays de la Loire;53;3;06;053;Champgenéteux;505;21;526
52;Pays de la Loire;53;2;16;054;Changé;6209;198;6407
52;Pays de la Loire;53;3;07;055;Chantrigné;606;15;621
52;Pays de la Loire;53;2;02;056;La Chapelle-Anthenaise;983;26;1009
52;Pays de la Loire;53;3;09;057;La Chapelle-au-Riboul;507;10;517
52;Pays de la Loire;53;1;04;058;La Chapelle-Craonnaise;336;13;349
52;Pays de la Loire;53;3;15;059;La Chapelle-Rainsouin;413;6;419
52;Pays de la Loire;53;3;09;061;Charchigné;464;6;470
52;Pays de la Loire;53;1;88;062;Château-Gontier-sur-Mayenne;16950;666;17616
52;Pays de la Loire;53;1;01;063;Châtelain;455;14;469
52;Pays de la Loire;53;3;07;064;Châtillon-sur-Colmont;979;24;1003
52;Pays de la Loire;53;1;01;066;Chemazé;1381;32;1413
52;Pays de la Loire;53;1;15;067;Chémeré-le-Roi;395;12;407
52;Pays de la Loire;53;1;03;068;Chérancé;155;1;156
52;Pays de la Loire;53;3;17;069;Chevaigné-du-Maine;160;5;165
52;Pays de la Loire;53;3;07;071;Colombiers-du-Plessis;484;22;506
52;Pays de la Loire;53;3;09;072;Commer;1253;28;1281
52;Pays de la Loire;53;1;04;073;Congrier;887;23;910
52;Pays de la Loire;53;3;14;074;Contest;842;35;877
52;Pays de la Loire;53;1;04;075;Cosmes;275;7;282
52;Pays de la Loire;53;1;15;076;Cossé-en-Champagne;329;11;340
52;Pays de la Loire;53;1;04;077;Cossé-le-Vivien;3199;77;3276
52;Pays de la Loire;53;1;01;078;Coudray;852;16;868
52;Pays de la Loire;53;3;07;079;Couesmes-Vaucé;378;11;389
52;Pays de la Loire;53;3;17;080;Couptrain;133;2;135
52;Pays de la Loire;53;1;04;082;Courbeveille;640;13;653
52;Pays de la Loire;53;3;17;083;Courcité;854;29;883
52;Pays de la Loire;53;1;03;084;Craon;4486;178;4664
52;Pays de la Loire;53;3;17;085;Crennes-sur-Fraubée;194;2;196
52;Pays de la Loire;53;3;05;086;La Croixille;652;12;664
52;Pays de la Loire;53;1;15;087;La Cropte;210;4;214
52;Pays de la Loire;53;1;04;088;Cuillé;842;29;871
52;Pays de la Loire;53;1;01;089;Daon;509;5;514
52;Pays de la Loire;53;1;03;090;Denazé;159;5;164
52;Pays de la Loire;53;3;07;091;Désertines;456;15;471
52;Pays de la Loire;53;3;07;093;La Dorée;272;5;277
52;Pays de la Loire;53;2;08;094;Entrammes;2255;41;2296
52;Pays de la Loire;53;3;05;096;Ernée;5717;96;5813
52;Pays de la Loire;53;3;06;097;Évron;8614;229;8843
52;Pays de la Loire;53;1;04;098;Fontaine-Couverte;432;9;441
52;Pays de la Loire;53;2;08;099;Forcé;1096;33;1129
52;Pays de la Loire;53;3;07;100;Fougerolles-du-Plessis;1176;15;1191
52;Pays de la Loire;53;1;01;101;Fromentières;836;11;847
52;Pays de la Loire;53;1;04;102;Gastines;168;2;170
52;Pays de la Loire;53;2;13;103;Le Genest-Saint-Isle;2134;58;2192
52;Pays de la Loire;53;1;01;104;Gennes-Longuefuye;1330;23;1353
52;Pays de la Loire;53;3;02;105;Gesnes;230;5;235
52;Pays de la Loire;53;3;17;106;Gesvres;509;11;520
52;Pays de la Loire;53;3;07;107;Gorron;2552;55;2607
52;Pays de la Loire;53;2;13;108;La Gravelle;563;6;569
52;Pays de la Loire;53;3;09;109;Grazay;621;17;638
52;Pays de la Loire;53;1;15;110;Grez-en-Bouère;997;19;1016
52;Pays de la Loire;53;3;09;111;La Haie-Traversaine;464;14;478
52;Pays de la Loire;53;3;17;112;Le Ham;393;7;400
52;Pays de la Loire;53;3;06;113;Hambers;611;14;625
52;Pays de la Loire;53;3;09;114;Hardanges;204;2;206
52;Pays de la Loire;53;3;07;115;Hercé;313;12;325
52;Pays de la Loire;53;3;09;116;Le Horps;720;18;738
52;Pays de la Loire;53;1;01;117;Houssay;499;5;504
52;Pays de la Loire;53;3;09;118;Le Housseau-Brétignolles;235;2;237
52;Pays de la Loire;53;2;08;119;L'Huisserie;4326;157;4483
52;Pays de la Loire;53;3;06;120;Izé;455;10;465
52;Pays de la Loire;53;3;17;121;Javron-les-Chapelles;1379;30;1409
52;Pays de la Loire;53;3;09;122;Jublains;750;17;767
52;Pays de la Loire;53;3;05;123;Juvigné;1465;14;1479
52;Pays de la Loire;53;1;03;124;Prée-d'Anjou;1393;43;1436
52;Pays de la Loire;53;3;07;125;Landivy;1156;22;1178
52;Pays de la Loire;53;3;05;126;Larchamp;1115;16;1131
52;Pays de la Loire;53;3;09;127;Lassay-les-Châteaux;2234;58;2292
52;Pays de la Loire;53;1;04;128;Laubrières;364;4;368
52;Pays de la Loire;53;2;13;129;Launay-Villiers;383;5;388
52;Pays de la Loire;53;2;99;130;Laval;49733;2637;52370
52;Pays de la Loire;53;3;07;131;Lesbois;194;2;196
52;Pays de la Loire;53;3;07;132;Levaré;285;11;296
52;Pays de la Loire;53;3;17;133;Lignières-Orgères;718;17;735
52;Pays de la Loire;53;3;06;134;Livet;172;1;173
52;Pays de la Loire;53;1;04;135;Livré-la-Touche;736;23;759
52;Pays de la Loire;53;1;01;136;La Roche-Neuville;1194;38;1232
52;Pays de la Loire;53;2;13;137;Loiron-Ruillé;2745;63;2808
52;Pays de la Loire;53;3;17;139;Loupfougères;412;6;418
52;Pays de la Loire;53;2;02;140;Louverné;4375;96;4471
52;Pays de la Loire;53;2;08;141;Louvigné;1150;31;1181
52;Pays de la Loire;53;3;17;142;Madré;291;6;297
52;Pays de la Loire;53;1;15;143;Maisoncelles-du-Maine;516;11;527
52;Pays de la Loire;53;3;09;144;Marcillé-la-Ville;761;24;785
52;Pays de la Loire;53;1;03;145;Marigné-Peuton;546;14;560
52;Pays de la Loire;53;3;09;146;Martigné-sur-Mayenne;1914;28;1942
52;Pays de la Loire;53;3;14;147;Mayenne;12823;680;13503
52;Pays de la Loire;53;1;03;148;Mée;235;1;236
52;Pays de la Loire;53;1;01;150;Ménil;905;28;933
52;Pays de la Loire;53;1;04;151;Méral;1110;15;1125
52;Pays de la Loire;53;1;15;152;Meslay-du-Maine;2808;71;2879
52;Pays de la Loire;53;3;06;153;Mézangers;635;13;648
52;Pays de la Loire;53;3;07;154;Montaudin;912;15;927
52;Pays de la Loire;53;3;05;155;Montenay;1363;24;1387
52;Pays de la Loire;53;2;02;156;Montflours;252;8;260
52;Pays de la Loire;53;2;08;157;Montigné-le-Brillant;1322;53;1375
52;Pays de la Loire;53;2;13;158;Montjean;1039;20;1059
52;Pays de la Loire;53;3;09;160;Montreuil-Poulay;374;7;381
52;Pays de la Loire;53;3;06;161;Montsûrs;3162;62;3224
52;Pays de la Loire;53;3;09;162;Moulay;990;17;1007
52;Pays de la Loire;53;3;06;163;Neau;778;4;782
52;Pays de la Loire;53;3;17;164;Neuilly-le-Vendin;345;8;353
52;Pays de la Loire;53;1;03;165;Niafles;354;7;361
52;Pays de la Loire;53;2;08;168;Nuillé-sur-Vicoin;1206;25;1231
52;Pays de la Loire;53;2;13;169;Olivet;414;9;423
52;Pays de la Loire;53;3;07;170;Oisseau;1158;25;1183
52;Pays de la Loire;53;1;01;172;Origné;410;9;419
52;Pays de la Loire;53;3;17;173;La Pallu;181;6;187
52;Pays de la Loire;53;3;14;174;Parigné-sur-Braye;840;23;863
52;Pays de la Loire;53;2;08;175;Parné-sur-Roc;1371;48;1419
52;Pays de la Loire;53;3;07;176;Le Pas;549;11;560
52;Pays de la Loire;53;3;05;177;La Pellerine;305;5;310
52;Pays de la Loire;53;1;03;178;Peuton;229;10;239
52;Pays de la Loire;53;3;14;179;Placé;352;8;360
52;Pays de la Loire;53;1;03;180;Pommerieux;642;28;670
52;Pays de la Loire;53;3;07;181;Pontmain;813;14;827
52;Pays de la Loire;53;2;13;182;Port-Brillet;1799;27;1826
52;Pays de la Loire;53;1;15;184;Préaux;163;7;170
52;Pays de la Loire;53;3;17;185;Pré-en-Pail-Saint-Samson;2291;87;2378
52;Pays de la Loire;53;1;04;186;Quelaines-Saint-Gault;2121;64;2185
52;Pays de la Loire;53;3;17;187;Ravigny;229;13;242
52;Pays de la Loire;53;1;04;188;Renazé;2529;58;2587
52;Pays de la Loire;53;3;09;189;Rennes-en-Grenouilles;103;2;105
52;Pays de la Loire;53;3;09;190;Le Ribay;465;10;475
52;Pays de la Loire;53;1;04;191;La Roë;248;2;250
52;Pays de la Loire;53;1;04;192;La Rouaudière;318;4;322
52;Pays de la Loire;53;1;15;193;Ruillé-Froid-Fonds;566;11;577
52;Pays de la Loire;53;3;02;195;Sacé;500;8;508
52;Pays de la Loire;53;3;17;196;Saint-Aignan-de-Couptrain;359;12;371
52;Pays de la Loire;53;1;04;197;Saint-Aignan-sur-Roë;901;24;925
52;Pays de la Loire;53;3;17;198;Saint-Aubin-du-Désert;229;7;236
52;Pays de la Loire;53;3;07;199;Saint-Aubin-Fosse-Louvain;216;4;220
52;Pays de la Loire;53;3;14;200;Saint-Baudelle;1146;57;1203
52;Pays de la Loire;53;2;16;201;Saint-Berthevin;7353;259;7612
52;Pays de la Loire;53;3;07;202;Saint-Berthevin-la-Tannière;308;3;311
52;Pays de la Loire;53;1;15;203;Saint-Brice;525;13;538
52;Pays de la Loire;53;3;17;204;Saint-Calais-du-Désert;388;12;400
52;Pays de la Loire;53;1;15;206;Saint-Charles-la-Forêt;200;10;210
52;Pays de la Loire;53;3;17;208;Saint-Cyr-en-Pail;494;17;511
52;Pays de la Loire;53;2;13;209;Saint-Cyr-le-Gravelais;559;14;573
52;Pays de la Loire;53;1;01;210;Saint-Denis-d'Anjou;1548;30;1578
52;Pays de la Loire;53;3;05;211;Saint-Denis-de-Gastines;1447;33;1480
52;Pays de la Loire;53;1;15;212;Saint-Denis-du-Maine;429;9;438
52;Pays de la Loire;53;3;07;213;Saint-Ellier-du-Maine;494;8;502
52;Pays de la Loire;53;1;04;214;Saint-Erblon;166;4;170
52;Pays de la Loire;53;3;09;216;Saint-Fraimbault-de-Prières;993;27;1020
52;Pays de la Loire;53;3;06;218;Sainte-Gemmes-le-Robert;798;25;823
52;Pays de la Loire;53;3;14;219;Saint-Georges-Buttavent;1412;40;1452
52;Pays de la Loire;53;3;15;220;Saint-Georges-le-Fléchard;392;8;400
52;Pays de la Loire;53;3;06;221;Saint-Georges-sur-Erve;391;9;400
52;Pays de la Loire;53;3;14;222;Saint-Germain-d'Anxure;365;8;373
52;Pays de la Loire;53;3;17;223;Saint-Germain-de-Coulamer;335;9;344
52;Pays de la Loire;53;2;16;224;Saint-Germain-le-Fouilloux;1184;31;1215
52;Pays de la Loire;53;3;05;225;Saint-Germain-le-Guillaume;512;10;522
52;Pays de la Loire;53;3;05;226;Saint-Hilaire-du-Maine;832;32;864
52;Pays de la Loire;53;3;15;228;Blandouet-Saint Jean;576;14;590
52;Pays de la Loire;53;2;16;229;Saint-Jean-sur-Mayenne;1652;48;1700
52;Pays de la Loire;53;3;09;230;Saint-Julien-du-Terroux;223;9;232
52;Pays de la Loire;53;3;15;232;Saint-Léger;311;3;314
52;Pays de la Loire;53;1;15;233;Saint-Loup-du-Dorat;340;2;342
52;Pays de la Loire;53;3;07;234;Saint-Loup-du-Gast;370;13;383
52;Pays de la Loire;53;3;09;235;Sainte-Marie-du-Bois;227;4;231
52;Pays de la Loire;53;3;17;236;Saint-Mars-du-Désert;170;1;171
52;Pays de la Loire;53;3;07;237;Saint-Mars-sur-Colmont;454;13;467
52;Pays de la Loire;53;3;07;238;Saint-Mars-sur-la-Futaie;519;10;529
52;Pays de la Loire;53;1;04;240;Saint-Martin-du-Limet;437;6;443
52;Pays de la Loire;53;1;04;242;Saint-Michel-de-la-Roë;260;3;263
52;Pays de la Loire;53;2;13;243;Saint-Ouën-des-Toits;1782;36;1818
52;Pays de la Loire;53;3;05;245;Saint-Pierre-des-Landes;922;27;949
52;Pays de la Loire;53;3;17;246;Saint-Pierre-des-Nids;1853;33;1886
52;Pays de la Loire;53;2;13;247;Saint-Pierre-la-Cour;2265;44;2309
52;Pays de la Loire;53;3;15;248;Saint-Pierre-sur-Erve;141;3;144
52;Pays de la Loire;53;3;06;249;Vimartin-sur-Orthe;1113;14;1127
52;Pays de la Loire;53;1;04;250;Saint-Poix;407;6;413
52;Pays de la Loire;53;1;03;251;Saint-Quentin-les-Anges;464;8;472
52;Pays de la Loire;53;1;04;253;Saint-Saturnin-du-Limet;515;5;520
52;Pays de la Loire;53;3;15;255;Sainte-Suzanne-et-Chammes;1278;31;1309
52;Pays de la Loire;53;3;06;256;Saint-Thomas-de-Courceriers;172;4;176
52;Pays de la Loire;53;3;15;257;Saulges;318;8;326
52;Pays de la Loire;53;1;04;258;La Selle-Craonnaise;912;28;940
52;Pays de la Loire;53;1;04;259;Senonnes;347;8;355
52;Pays de la Loire;53;1;04;260;Simplé;415;1;416
52;Pays de la Loire;53;3;07;261;Soucé;167;3;170
52;Pays de la Loire;53;2;08;262;Soulgé-sur-Ouette;1109;34;1143
52;Pays de la Loire;53;3;09;263;Thubœuf;280;8;288
52;Pays de la Loire;53;3;15;264;Thorigné-en-Charnie;194;3;197
52;Pays de la Loire;53;3;15;265;Torcé-Viviers-en-Charnie;765;15;780
52;Pays de la Loire;53;3;06;266;Trans;227;4;231
52;Pays de la Loire;53;3;15;267;Vaiges;1166;32;1198
52;Pays de la Loire;53;3;05;269;Vautorte;609;5;614
52;Pays de la Loire;53;3;07;270;Vieuvy;108;8;116
52;Pays de la Loire;53;3;17;271;Villaines-la-Juhel;2738;42;2780
52;Pays de la Loire;53;3;17;272;Villepail;185;1;186
52;Pays de la Loire;53;1;15;273;Villiers-Charlemagne;1087;22;1109
52;Pays de la Loire;53;3;06;276;Voutré;924;15;939
44;Grand Est;54;3;02;001;Abaucourt;296;3;299
44;Grand Est;54;1;17;002;Abbéville-lès-Conflans;232;4;236
44;Grand Est;54;4;10;003;Aboncourt;96;4;100
44;Grand Est;54;1;17;004;Affléville;178;2;180
44;Grand Est;54;3;10;005;Affracourt;109;1;110
44;Grand Est;54;3;03;006;Agincourt;442;7;449
44;Grand Est;54;4;16;007;Aingeray;520;3;523
44;Grand Est;54;4;10;008;Allain;472;14;486
44;Grand Est;54;1;04;009;Allamont;167;3;170
44;Grand Est;54;4;10;010;Allamps;499;13;512
44;Grand Est;54;1;11;011;Allondrelle-la-Malmaison;654;2;656
44;Grand Est;54;3;03;012;Amance;350;5;355
44;Grand Est;54;2;01;013;Amenoncourt;83;2;85
44;Grand Est;54;2;01;014;Ancerviller;264;14;278
44;Grand Est;54;1;17;015;Anderny;259;6;265
44;Grand Est;54;4;16;016;Andilly;288;7;295
44;Grand Est;54;2;01;017;Angomont;76;1;77
44;Grand Est;54;1;17;018;Anoux;271;7;278
44;Grand Est;54;4;16;019;Ansauville;79;1;80
44;Grand Est;54;2;08;020;Anthelupt;452;6;458
44;Grand Est;54;3;02;021;Armaucourt;231;1;232
44;Grand Est;54;4;18;022;Arnaville;563;10;573
44;Grand Est;54;2;01;023;Arracourt;248;2;250
44;Grand Est;54;3;02;024;Arraye-et-Han;363;6;369
44;Grand Est;54;3;03;025;Art-sur-Meurthe;1591;208;1799
44;Grand Est;54;2;01;026;Athienville;177;3;180
44;Grand Est;54;3;18;027;Atton;872;12;884
44;Grand Est;54;1;04;028;Auboué;2617;18;2635
44;Grand Est;54;1;17;029;Audun-le-Roman;2462;48;2510
44;Grand Est;54;2;01;030;Autrepierre;82;0;82
44;Grand Est;54;3;02;031;Autreville-sur-Moselle;266;5;271
44;Grand Est;54;3;10;032;Autrey;187;4;191
44;Grand Est;54;1;17;033;Avillers;129;0;129
44;Grand Est;54;4;16;034;Avrainville;215;10;225
44;Grand Est;54;2;01;035;Avricourt;387;3;390
44;Grand Est;54;1;17;036;Avril;1150;17;1167
44;Grand Est;54;3;05;037;Azelot;424;2;426
44;Grand Est;54;2;01;038;Azerailles;755;18;773
44;Grand Est;54;2;01;039;Baccarat;4192;61;4253
44;Grand Est;54;2;01;040;Badonviller;1553;32;1585
44;Grand Est;54;4;10;041;Bagneux;145;7;152
44;Grand Est;54;3;10;042;Bainville-aux-Miroirs;284;2;286
44;Grand Est;54;3;15;043;Bainville-sur-Madon;1427;18;1445
44;Grand Est;54;2;01;044;Barbas;195;2;197
44;Grand Est;54;2;09;045;Barbonville;433;7;440
44;Grand Est;54;4;10;046;Barisey-au-Plain;395;8;403
44;Grand Est;54;4;10;047;Barisey-la-Côte;249;6;255
44;Grand Est;54;1;17;048;Les Baroches;351;15;366
44;Grand Est;54;1;11;049;Baslieux;538;14;552
44;Grand Est;54;2;01;050;Bathelémont;65;1;66
44;Grand Est;54;1;04;051;Batilly;1272;21;1293
44;Grand Est;54;4;10;052;Battigny;148;2;150
44;Grand Est;54;2;08;053;Bauzemont;156;6;162
44;Grand Est;54;2;09;054;Bayon;1557;18;1575
44;Grand Est;54;4;18;055;Bayonville-sur-Mad;320;5;325
44;Grand Est;54;1;11;056;Bazailles;141;2;143
44;Grand Est;54;4;16;057;Beaumont;75;0;75
44;Grand Est;54;1;17;058;Béchamps;89;2;91
44;Grand Est;54;3;02;059;Belleau;755;10;765
44;Grand Est;54;3;02;060;Belleville;1465;16;1481
44;Grand Est;54;2;01;061;Bénaménil;584;11;595
44;Grand Est;54;3;10;062;Benney;657;10;667
44;Grand Est;54;4;16;063;Bernécourt;174;4;178
44;Grand Est;54;2;01;064;Bertrambois;315;6;321
44;Grand Est;54;2;01;065;Bertrichamps;1095;23;1118
44;Grand Est;54;1;17;066;Bettainvillers;405;2;407
44;Grand Est;54;1;11;067;Beuveille;758;11;769
44;Grand Est;54;4;10;068;Beuvezin;93;2;95
44;Grand Est;54;1;17;069;Beuvillers;439;8;447
44;Grand Est;54;3;02;070;Bey-sur-Seille;174;0;174
44;Grand Est;54;2;01;071;Bezange-la-Grande;158;1;159
44;Grand Est;54;3;02;072;Bezaumont;259;5;264
44;Grand Est;54;4;20;073;Bicqueley;918;15;933
44;Grand Est;54;2;08;074;Bienville-la-Petite;37;0;37
44;Grand Est;54;2;01;075;Bionville;118;2;120
44;Grand Est;54;2;09;076;Blainville-sur-l'Eau;3973;46;4019
44;Grand Est;54;2;01;077;Blâmont;1063;12;1075
44;Grand Est;54;2;01;078;Blémerey;57;1;58
44;Grand Est;54;3;18;079;Blénod-lès-Pont-à-Mousson;4628;31;4659
44;Grand Est;54;4;10;080;Blénod-lès-Toul;1045;19;1064
44;Grand Est;54;1;11;081;Boismont;422;6;428
44;Grand Est;54;1;04;082;Boncourt;170;3;173
44;Grand Est;54;2;08;083;Bonviller;177;3;180
44;Grand Est;54;1;17;084;Mont-Bonvillers;945;14;959
44;Grand Est;54;2;09;085;Borville;89;2;91
44;Grand Est;54;4;16;086;Boucq;354;11;365
44;Grand Est;54;4;16;087;Bouillonville;151;1;152
44;Grand Est;54;4;16;088;Bouvron;240;1;241
44;Grand Est;54;3;03;089;Bouxières-aux-Chênes;1417;20;1437
44;Grand Est;54;3;02;090;Bouxières-aux-Dames;4159;41;4200
44;Grand Est;54;3;18;091;Bouxières-sous-Froidmont;389;4;393
44;Grand Est;54;3;10;092;Bouzanville;64;1;65
44;Grand Est;54;1;04;093;Brainville;168;2;170
44;Grand Est;54;3;10;094;Bralleville;173;3;176
44;Grand Est;54;3;02;095;Bratte;46;0;46
44;Grand Est;54;1;23;096;Bréhain-la-Ville;429;9;438
44;Grand Est;54;2;01;097;Bréménil;102;3;105
44;Grand Est;54;2;09;098;Brémoncourt;167;3;170
44;Grand Est;54;1;17;099;Val de Briey;8069;231;8300
44;Grand Est;54;3;02;100;Brin-sur-Seille;780;12;792
44;Grand Est;54;2;01;101;Brouville;129;1;130
44;Grand Est;54;4;16;102;Bruley;609;15;624
44;Grand Est;54;1;04;103;Bruville;224;5;229
44;Grand Est;54;3;03;104;Buissoncourt;260;2;262
44;Grand Est;54;4;10;105;Bulligny;527;15;542
44;Grand Est;54;2;01;106;Bures;62;2;64
44;Grand Est;54;2;01;107;Buriville;74;3;77
44;Grand Est;54;3;05;108;Burthecourt-aux-Chênes;130;4;134
44;Grand Est;54;3;10;109;Ceintrey;933;12;945
44;Grand Est;54;3;03;110;Cerville;562;12;574
44;Grand Est;54;3;15;111;Chaligny;2826;19;2845
44;Grand Est;54;1;04;112;Chambley-Bussières;706;9;715
44;Grand Est;54;3;03;113;Champenoux;1490;15;1505
44;Grand Est;54;3;18;114;Champey-sur-Moselle;332;5;337
44;Grand Est;54;3;21;115;Champigneulles;6671;65;6736
44;Grand Est;54;2;09;116;Chanteheux;2159;43;2202
44;Grand Est;54;3;10;117;Chaouilley;115;3;118
44;Grand Est;54;1;11;118;Charency-Vezin;600;10;610
44;Grand Est;54;4;16;119;Charey;87;3;90
44;Grand Est;54;4;20;120;Charmes-la-Côte;328;8;336
44;Grand Est;54;2;09;121;Charmois;191;3;194
44;Grand Est;54;4;20;122;Chaudeney-sur-Moselle;729;17;746
44;Grand Est;54;3;15;123;Chavigny;1739;10;1749
44;Grand Est;54;2;01;124;Chazelles-sur-Albe;45;3;48
44;Grand Est;54;2;01;125;Chenevières;490;8;498
44;Grand Est;54;3;02;126;Chenicourt;221;1;222
44;Grand Est;54;1;07;127;Chenières;631;19;650
44;Grand Est;54;4;20;128;Choloy-Ménillot;717;7;724
44;Grand Est;54;2;01;129;Cirey-sur-Vezouze;1610;25;1635
44;Grand Est;54;2;09;130;Clayeures;181;1;182
44;Grand Est;54;3;02;131;Clémery;496;10;506
44;Grand Est;54;3;10;132;Clérey-sur-Brenon;63;2;65
44;Grand Est;54;2;01;133;Coincourt;119;4;123
44;Grand Est;54;1;11;134;Colmey;244;7;251
44;Grand Est;54;4;10;135;Colombey-les-Belles;1449;20;1469
44;Grand Est;54;1;04;136;Conflans-en-Jarnisy;2383;33;2416
44;Grand Est;54;1;11;137;Cons-la-Grandville;507;17;524
44;Grand Est;54;1;11;138;Cosnes-et-Romain;2741;56;2797
44;Grand Est;54;2;08;139;Courbesseaux;366;2;368
44;Grand Est;54;4;10;140;Courcelles;96;0;96
44;Grand Est;54;3;05;141;Coyviller;149;2;151
44;Grand Est;54;3;10;142;Crantenoy;158;2;160
44;Grand Est;54;4;10;143;Crépey;391;7;398
44;Grand Est;54;3;10;144;Crévéchamps;398;3;401
44;Grand Est;54;2;08;145;Crévic;931;12;943
44;Grand Est;54;4;10;146;Crézilles;294;3;297
44;Grand Est;54;2;08;147;Crion;104;2;106
44;Grand Est;54;2;08;148;Croismare;647;8;655
44;Grand Est;54;1;23;149;Crusnes;1568;12;1580
44;Grand Est;54;3;02;150;Custines;3082;28;3110
44;Grand Est;54;1;07;151;Cutry;1042;28;1070
44;Grand Est;54;2;09;152;Damelevières;3155;45;3200
44;Grand Est;54;1;04;153;Dampvitoux;55;0;55
44;Grand Est;54;2;01;154;Deneuvre;491;21;512
44;Grand Est;54;2;08;155;Deuxville;410;7;417
44;Grand Est;54;3;10;156;Diarville;502;17;519
44;Grand Est;54;3;02;157;Dieulouard;4772;45;4817
44;Grand Est;54;4;10;158;Dolcourt;133;2;135
44;Grand Est;54;3;08;159;Dombasle-sur-Meurthe;9668;189;9857
44;Grand Est;54;4;16;160;Domèvre-en-Haye;403;9;412
44;Grand Est;54;2;01;161;Domèvre-sur-Vezouze;311;10;321
44;Grand Est;54;4;20;162;Domgermain;1164;14;1178
44;Grand Est;54;2;01;163;Domjevin;258;2;260
44;Grand Est;54;3;10;164;Dommarie-Eulmont;87;2;89
44;Grand Est;54;3;19;165;Dommartemont;575;28;603
44;Grand Est;54;4;16;166;Dommartin-la-Chaussée;32;2;34
44;Grand Est;54;4;20;167;Dommartin-lès-Toul;1951;37;1988
44;Grand Est;54;3;03;168;Dommartin-sous-Amance;287;2;289
44;Grand Est;54;1;17;169;Domprix;93;3;96
44;Grand Est;54;2;09;170;Domptail-en-l'Air;71;1;72
44;Grand Est;54;1;04;171;Doncourt-lès-Conflans;1158;21;1179
44;Grand Est;54;1;11;172;Doncourt-lès-Longuyon;290;7;297
44;Grand Est;54;2;08;173;Drouville;212;4;216
44;Grand Est;54;4;20;174;Écrouves;4428;53;4481
44;Grand Est;54;2;09;175;Einvaux;370;3;373
44;Grand Est;54;2;08;176;Einville-au-Jard;1116;22;1138
44;Grand Est;54;2;01;177;Emberménil;257;3;260
44;Grand Est;54;1;11;178;Épiez-sur-Chiers;194;3;197
44;Grand Est;54;3;02;179;Éply;302;4;306
44;Grand Est;54;3;03;180;Erbéviller-sur-Amezule;72;2;74
44;Grand Est;54;1;23;181;Errouville;699;17;716
44;Grand Est;54;4;16;182;Essey-et-Maizerais;332;10;342
44;Grand Est;54;2;09;183;Essey-la-Côte;78;0;78
44;Grand Est;54;3;19;184;Essey-lès-Nancy;8833;188;9021
44;Grand Est;54;3;10;185;Étreval;60;1;61
44;Grand Est;54;3;03;186;Eulmont;1105;21;1126
44;Grand Est;54;4;16;187;Euvezin;113;1;114
44;Grand Est;54;3;02;188;Faulx;1367;10;1377
44;Grand Est;54;4;10;189;Favières;597;8;605
44;Grand Est;54;4;10;190;Fécocourt;112;3;115
44;Grand Est;54;2;01;191;Fenneviller;101;2;103
44;Grand Est;54;3;09;192;Ferrières;301;4;305
44;Grand Est;54;3;18;193;Fey-en-Haye;77;1;78
44;Grand Est;54;1;23;194;Fillières;512;9;521
44;Grand Est;54;2;08;195;Flainval;203;0;203
44;Grand Est;54;3;15;196;Flavigny-sur-Moselle;1735;134;1869
44;Grand Est;54;3;05;197;Fléville-devant-Nancy;2225;25;2250
44;Grand Est;54;1;17;198;Fléville-Lixières;309;5;314
44;Grand Est;54;2;01;199;Flin;382;11;393
44;Grand Est;54;4;16;200;Flirey;156;1;157
44;Grand Est;54;2;01;201;Fontenoy-la-Joûte;309;3;312
44;Grand Est;54;4;16;202;Fontenoy-sur-Moselle;376;4;380
44;Grand Est;54;3;10;203;Forcelles-Saint-Gorgon;138;3;141
44;Grand Est;54;3;10;204;Forcelles-sous-Gugney;93;2;95
44;Grand Est;54;4;20;205;Foug;2629;30;2659
44;Grand Est;54;2;09;206;Fraimbois;391;5;396
44;Grand Est;54;3;10;207;Fraisnes-en-Saintois;100;2;102
44;Grand Est;54;4;16;208;Francheville;288;2;290
44;Grand Est;54;2;09;209;Franconville;71;0;71
44;Grand Est;54;2;01;210;Fréménil;211;4;215
44;Grand Est;54;2;01;211;Frémonville;189;2;191
44;Grand Est;54;1;11;212;Fresnois-la-Montagne;413;13;426
44;Grand Est;54;1;04;213;Friauville;367;5;372
44;Grand Est;54;3;15;214;Frolois;700;6;706
44;Grand Est;54;3;21;215;Frouard;6584;78;6662
44;Grand Est;54;2;09;216;Froville;125;0;125
44;Grand Est;54;2;01;217;Gélacourt;169;2;171
44;Grand Est;54;4;10;218;Gélaucourt;58;1;59
44;Grand Est;54;3;03;219;Gellenoncourt;79;0;79
44;Grand Est;54;4;10;220;Gémonville;79;0;79
44;Grand Est;54;3;10;221;Gerbécourt-et-Haplemont;230;1;231
44;Grand Est;54;2;09;222;Gerbéviller;1328;23;1351
44;Grand Est;54;4;10;223;Germiny;218;7;225
44;Grand Est;54;3;10;224;Germonville;123;1;124
44;Grand Est;54;4;16;225;Gézoncourt;179;3;182
44;Grand Est;54;4;10;226;Gibeaumeix;171;3;174
44;Grand Est;54;1;04;227;Giraumont;1346;17;1363
44;Grand Est;54;2;09;228;Giriviller;70;3;73
44;Grand Est;54;2;01;229;Glonville;366;5;371
44;Grand Est;54;2;01;230;Gogney;50;0;50
44;Grand Est;54;1;17;231;Gondrecourt-Aix;175;3;178
44;Grand Est;54;4;16;232;Gondreville;2712;50;2762
44;Grand Est;54;2;01;233;Gondrexon;37;2;39
44;Grand Est;54;1;11;234;Gorcy;2877;45;2922
44;Grand Est;54;3;10;235;Goviller;421;9;430
44;Grand Est;54;1;11;236;Grand-Failly;352;8;360
44;Grand Est;54;4;10;237;Grimonviller;86;3;89
44;Grand Est;54;3;10;238;Gripport;271;1;272
44;Grand Est;54;4;16;239;Griscourt;137;2;139
44;Grand Est;54;4;16;240;Grosrouvres;57;0;57
44;Grand Est;54;3;10;241;Gugney;75;3;78
44;Grand Est;54;4;20;242;Gye;272;4;276
44;Grand Est;54;2;01;243;Hablainville;213;7;220
44;Grand Est;54;1;04;244;Hagéville;111;3;114
44;Grand Est;54;2;09;245;Haigneville;61;0;61
44;Grand Est;54;2;01;246;Halloville;66;6;72
44;Grand Est;54;3;10;247;Hammeville;177;4;181
44;Grand Est;54;4;16;248;Hamonville;100;0;100
44;Grand Est;54;1;04;249;Hannonville-Suzémont;254;4;258
44;Grand Est;54;3;03;250;Haraucourt;735;6;741
44;Grand Est;54;2;01;251;Harbouey;125;1;126
44;Grand Est;54;3;10;252;Haroué;506;6;512
44;Grand Est;54;1;04;253;Hatrize;773;12;785
44;Grand Est;54;1;07;254;Haucourt-Moulaine;3394;43;3437
44;Grand Est;54;2;09;255;Haudonville;85;6;91
44;Grand Est;54;2;09;256;Haussonville;305;8;313
44;Grand Est;54;3;05;257;Heillecourt;5403;83;5486
44;Grand Est;54;2;08;258;Hénaménil;144;3;147
44;Grand Est;54;2;01;259;Herbéviller;240;2;242
44;Grand Est;54;2;09;260;Hériménil;955;18;973
44;Grand Est;54;1;07;261;Herserange;4409;46;4455
44;Grand Est;54;2;08;262;Hoéville;197;0;197
44;Grand Est;54;1;04;263;Homécourt;6267;55;6322
44;Grand Est;54;3;10;264;Houdelmont;284;0;284
44;Grand Est;54;3;05;265;Houdemont;2097;44;2141
44;Grand Est;54;3;10;266;Houdreville;407;10;417
44;Grand Est;54;3;10;268;Housséville;142;4;146
44;Grand Est;54;2;08;269;Hudiviller;360;5;365
44;Grand Est;54;1;23;270;Hussigny-Godbrange;3693;65;3758
44;Grand Est;54;2;01;271;Igney;122;6;128
44;Grand Est;54;4;16;272;Jaillon;469;3;472
44;Grand Est;54;1;04;273;Jarny;8219;186;8405
44;Grand Est;54;3;05;274;Jarville-la-Malgrange;9354;237;9591
44;Grand Est;54;4;16;275;Jaulny;190;6;196
44;Grand Est;54;3;02;276;Jeandelaincourt;795;7;802
44;Grand Est;54;1;04;277;Jeandelize;373;2;375
44;Grand Est;54;3;10;278;Jevoncourt;99;1;100
44;Grand Est;54;3;18;279;Jezainville;983;21;1004
44;Grand Est;54;1;17;280;Jœuf;6570;53;6623
44;Grand Est;54;2;08;281;Jolivet;896;18;914
44;Grand Est;54;1;17;282;Joppécourt;161;4;165
44;Grand Est;54;1;04;283;Jouaville;290;9;299
44;Grand Est;54;1;17;284;Joudreville;1137;20;1157
44;Grand Est;54;2;01;285;Juvrecourt;56;1;57
44;Grand Est;54;1;04;286;Labry;1587;30;1617
44;Grand Est;54;2;01;287;Lachapelle;260;1;261
44;Grand Est;54;4;16;288;Lagney;498;5;503
44;Grand Est;54;3;03;289;Laître-sous-Amance;366;10;376
44;Grand Est;54;1;23;290;Laix;211;3;214
44;Grand Est;54;3;10;291;Lalœuf;291;2;293
44;Grand Est;54;2;09;292;Lamath;190;3;193
44;Grand Est;54;2;09;293;Landécourt;85;4;89
44;Grand Est;54;3;02;294;Landremont;147;1;148
44;Grand Est;54;1;17;295;Landres;972;111;1083
44;Grand Est;54;3;03;296;Laneuvelotte;433;4;437
44;Grand Est;54;2;01;297;Laneuveville-aux-Bois;309;3;312
44;Grand Est;54;4;20;298;Laneuveville-derrière-Foug;153;2;155
44;Grand Est;54;3;10;299;Laneuveville-devant-Bayon;226;6;232
44;Grand Est;54;3;03;300;Laneuveville-devant-Nancy;6553;109;6662
44;Grand Est;54;3;02;301;Lanfroicourt;128;1;129
44;Grand Est;54;1;17;302;Lantéfontaine;746;18;764
44;Grand Est;54;2;01;303;Laronxe;368;3;371
44;Grand Est;54;3;06;304;Laxou;14366;191;14557
44;Grand Est;54;3;02;305;Lay-Saint-Christophe;2400;48;2448
44;Grand Est;54;4;20;306;Lay-Saint-Remy;343;5;348
44;Grand Est;54;3;10;307;Lebeuville;176;4;180
44;Grand Est;54;2;01;308;Leintrey;146;3;149
44;Grand Est;54;3;10;309;Lemainville;379;3;382
44;Grand Est;54;3;10;310;Leménil-Mitry;3;0;3
44;Grand Est;54;3;03;311;Lenoncourt;595;8;603
44;Grand Est;54;3;18;312;Lesménils;480;10;490
44;Grand Est;54;3;02;313;Létricourt;229;1;230
44;Grand Est;54;1;07;314;Lexy;3816;65;3881
44;Grand Est;54;3;02;315;Leyr;902;6;908
44;Grand Est;54;4;16;316;Limey-Remenauville;298;5;303
44;Grand Est;54;4;16;317;Lironville;131;5;136
44;Grand Est;54;4;16;318;Liverdun;5863;73;5936
44;Grand Est;54;3;18;320;Loisy;324;4;328
44;Grand Est;54;1;23;321;Longlaville;2365;28;2393
44;Grand Est;54;1;11;322;Longuyon;5218;62;5280
44;Grand Est;54;1;07;323;Longwy;14774;272;15046
44;Grand Est;54;2;09;324;Lorey;89;1;90
44;Grand Est;54;2;09;325;Loromontzey;82;8;90
44;Grand Est;54;1;17;326;Lubey;222;10;232
44;Grand Est;54;4;16;327;Lucey;630;15;645
44;Grand Est;54;3;05;328;Ludres;6142;89;6231
44;Grand Est;54;2;98;329;Lunéville;17867;324;18191
44;Grand Est;54;3;05;330;Lupcourt;428;9;437
44;Grand Est;54;2;09;331;Magnières;280;6;286
44;Grand Est;54;3;18;332;Maidières;1547;24;1571
44;Grand Est;54;3;02;333;Mailly-sur-Seille;248;14;262
44;Grand Est;54;1;17;334;Mairy-Mainville;561;11;572
44;Grand Est;54;2;08;335;Maixe;412;4;416
44;Grand Est;54;3;15;336;Maizières;927;11;938
44;Grand Est;54;1;17;337;Malavillers;129;3;132
44;Grand Est;54;3;02;338;Malleloy;980;14;994
44;Grand Est;54;3;19;339;Malzéville;8191;270;8461
44;Grand Est;54;4;16;340;Mamey;343;5;348
44;Grand Est;54;4;16;343;Mandres-aux-Quatre-Tours;187;5;192
44;Grand Est;54;3;10;344;Mangonville;218;4;222
44;Grand Est;54;3;05;345;Manoncourt-en-Vermois;344;5;349
44;Grand Est;54;4;16;346;Manoncourt-en-Woëvre;246;4;250
44;Grand Est;54;4;16;348;Manonville;236;8;244
44;Grand Est;54;2;01;349;Manonviller;163;2;165
44;Grand Est;54;2;01;350;Marainviller;697;8;705
44;Grand Est;54;3;21;351;Marbache;1682;15;1697
44;Grand Est;54;3;15;352;Maron;829;9;838
44;Grand Est;54;1;04;353;Mars-la-Tour;922;16;938
44;Grand Est;54;3;10;354;Marthemont;46;0;46
44;Grand Est;54;4;16;355;Martincourt;94;2;96
44;Grand Est;54;2;09;356;Mattexey;67;2;69
44;Grand Est;54;3;21;357;Maxéville;9818;119;9937
44;Grand Est;54;3;03;358;Mazerulles;279;5;284
44;Grand Est;54;2;09;359;Méhoncourt;243;3;246
44;Grand Est;54;4;16;360;Ménil-la-Tour;337;8;345
44;Grand Est;54;1;17;362;Mercy-le-Bas;1281;7;1288
44;Grand Est;54;1;17;363;Mercy-le-Haut;270;6;276
44;Grand Est;54;3;15;364;Méréville;1289;19;1308
44;Grand Est;54;2;01;365;Merviller;324;9;333
44;Grand Est;54;3;15;366;Messein;1976;20;1996
44;Grand Est;54;1;07;367;Mexy;2278;67;2345
44;Grand Est;54;2;01;368;Mignéville;175;3;178
44;Grand Est;54;3;02;369;Millery;617;7;624
44;Grand Est;54;4;16;370;Minorville;225;1;226
44;Grand Est;54;1;04;371;Moineville;1069;20;1089
44;Grand Est;54;3;02;372;Moivrons;511;2;513
44;Grand Est;54;2;09;373;Moncel-lès-Lunéville;618;5;623
44;Grand Est;54;3;03;374;Moncel-sur-Seille;514;9;523
44;Grand Est;54;3;18;375;Montauville;1078;17;1095
44;Grand Est;54;3;02;376;Montenoy;409;7;416
44;Grand Est;54;2;01;377;Montigny;159;0;159
44;Grand Est;54;1;11;378;Montigny-sur-Chiers;473;8;481
44;Grand Est;54;4;10;379;Mont-l'Étroit;97;0;97
44;Grand Est;54;4;10;380;Mont-le-Vignoble;413;10;423
44;Grand Est;54;2;01;381;Montreux;55;2;57
44;Grand Est;54;1;11;382;Mont-Saint-Martin;8994;113;9107
44;Grand Est;54;2;09;383;Mont-sur-Meurthe;1117;11;1128
44;Grand Est;54;1;23;385;Morfontaine;1086;25;1111
44;Grand Est;54;2;09;386;Moriviller;92;1;93
44;Grand Est;54;3;02;387;Morville-sur-Seille;151;0;151
44;Grand Est;54;2;01;388;Mouacourt;74;2;76
44;Grand Est;54;1;17;389;Mouaville;99;2;101
44;Grand Est;54;3;18;390;Mousson;101;3;104
44;Grand Est;54;1;04;391;Moutiers;1568;23;1591
44;Grand Est;54;4;10;392;Moutrot;312;2;314
44;Grand Est;54;2;09;393;Moyen;539;6;545
44;Grand Est;54;1;17;394;Murville;251;6;257
44;Grand Est;54;3;99;395;Nancy;105058;1446;106504
44;Grand Est;54;2;01;396;Neufmaisons;227;8;235
44;Grand Est;54;3;15;397;Neuves-Maisons;6633;55;6688
44;Grand Est;54;2;01;398;Neuviller-lès-Badonviller;97;2;99
44;Grand Est;54;3;10;399;Neuviller-sur-Moselle;248;1;249
44;Grand Est;54;3;02;400;Nomeny;1150;22;1172
44;Grand Est;54;2;01;401;Nonhigny;127;5;132
44;Grand Est;54;1;17;402;Norroy-le-Sec;413;11;424
44;Grand Est;54;3;18;403;Norroy-lès-Pont-à-Mousson;1190;34;1224
44;Grand Est;54;4;16;404;Noviant-aux-Prés;264;5;269
44;Grand Est;54;4;10;405;Ochey;522;0;522
44;Grand Est;54;2;01;406;Ogéviller;279;7;286
44;Grand Est;54;3;10;407;Ognéville;96;3;99
44;Grand Est;54;1;04;408;Olley;231;3;234
44;Grand Est;54;3;10;409;Omelmont;188;0;188
44;Grand Est;54;1;18;410;Onville;519;2;521
44;Grand Est;54;3;10;411;Ormes-et-Ville;218;2;220
44;Grand Est;54;1;11;412;Othe;38;3;41
44;Grand Est;54;1;17;413;Ozerailles;151;1;152
44;Grand Est;54;4;20;414;Pagney-derrière-Barine;660;8;668
44;Grand Est;54;3;18;415;Pagny-sur-Moselle;4105;52;4157
44;Grand Est;54;4;16;416;Pannes;180;3;183
44;Grand Est;54;3;10;417;Parey-Saint-Césaire;240;7;247
44;Grand Est;54;2;01;418;Parroy;171;1;172
44;Grand Est;54;2;01;419;Parux;73;0;73
44;Grand Est;54;1;11;420;Petit-Failly;87;1;88
44;Grand Est;54;2;01;421;Petitmont;317;4;321
44;Grand Est;54;2;01;422;Pettonville;70;0;70
44;Grand Est;54;2;01;423;Pexonne;348;10;358
44;Grand Est;54;3;02;424;Phlin;43;1;44
44;Grand Est;54;1;17;425;Piennes;2539;28;2567
44;Grand Est;54;4;20;426;Pierre-la-Treiche;480;6;486
44;Grand Est;54;2;01;427;Pierre-Percée;94;1;95
44;Grand Est;54;1;11;428;Pierrepont;863;9;872
44;Grand Est;54;3;10;429;Pierreville;300;2;302
44;Grand Est;54;3;21;430;Pompey;4870;56;4926
44;Grand Est;54;3;18;431;Pont-à-Mousson;14497;187;14684
44;Grand Est;54;3;15;432;Pont-Saint-Vincent;1844;38;1882
44;Grand Est;54;3;02;433;Port-sur-Seille;229;7;236
44;Grand Est;54;3;10;434;Praye;252;2;254
44;Grand Est;54;3;18;435;Prény;362;4;366
44;Grand Est;54;1;17;436;Preutin-Higny;146;4;150
44;Grand Est;54;3;15;437;Pulligny;1151;20;1171
44;Grand Est;54;4;10;438;Pulney;56;0;56
44;Grand Est;54;3;03;439;Pulnoy;5077;62;5139
44;Grand Est;54;1;04;440;Puxe;121;0;121
44;Grand Est;54;1;04;441;Puxieux;234;5;239
44;Grand Est;54;3;10;442;Quevilloncourt;97;2;99
44;Grand Est;54;2;01;443;Raon-lès-Leau;37;0;37
44;Grand Est;54;3;02;444;Raucourt;222;2;224
44;Grand Est;54;2;08;445;Raville-sur-Sânon;102;0;102
44;Grand Est;54;2;01;446;Réchicourt-la-Petite;65;2;67
44;Grand Est;54;2;01;447;Réclonville;76;1;77
44;Grand Est;54;2;09;449;Rehainviller;1048;15;1063
44;Grand Est;54;2;01;450;Reherrey;141;1;142
44;Grand Est;54;1;07;451;Réhon;3809;76;3885
44;Grand Est;54;2;01;452;Reillon;78;2;80
44;Grand Est;54;4;16;453;Rembercourt-sur-Mad;161;1;162
44;Grand Est;54;2;09;455;Remenoville;158;4;162
44;Grand Est;54;3;03;456;Réméréville;584;8;592
44;Grand Est;54;2;01;457;Remoncourt;44;0;44
44;Grand Est;54;2;01;458;Repaix;105;1;106
44;Grand Est;54;3;15;459;Richardménil;2329;25;2354
44;Grand Est;54;4;16;460;Rogéville;156;3;159
44;Grand Est;54;2;09;461;Romain;70;2;72
44;Grand Est;54;3;09;462;Rosières-aux-Salines;2870;28;2898
44;Grand Est;54;4;16;463;Rosières-en-Haye;235;2;237
44;Grand Est;54;3;02;464;Rouves;105;0;105
44;Grand Est;54;3;10;465;Roville-devant-Bayon;769;11;780
44;Grand Est;54;4;16;466;Royaumeix;390;5;395
44;Grand Est;54;2;09;467;Rozelieures;191;5;196
44;Grand Est;54;3;09;468;Saffais;113;2;115
44;Grand Est;54;1;04;469;Saint-Ail;418;5;423
44;Grand Est;54;4;16;470;Saint-Baussant;74;2;76
44;Grand Est;54;2;09;471;Saint-Boingt;71;3;74
44;Grand Est;54;2;01;472;Saint-Clément;854;16;870
44;Grand Est;54;3;10;473;Saint-Firmin;280;6;286
44;Grand Est;54;3;02;474;Sainte-Geneviève;192;0;192
44;Grand Est;54;2;09;475;Saint-Germain;155;6;161
44;Grand Est;54;1;11;476;Saint-Jean-lès-Longuyon;416;11;427
44;Grand Est;54;1;04;477;Saint-Julien-lès-Gorze;162;3;165
44;Grand Est;54;1;04;478;Saint-Marcel;149;1;150
44;Grand Est;54;2;09;479;Saint-Mard;95;1;96
44;Grand Est;54;2;01;480;Saint-Martin;56;1;57
44;Grand Est;54;2;01;481;Saint-Maurice-aux-Forges;98;3;101
44;Grand Est;54;3;19;482;Saint-Max;10019;110;10129
44;Grand Est;54;3;05;483;Saint-Nicolas-de-Port;7417;73;7490
44;Grand Est;54;2;01;484;Sainte-Pôle;186;3;189
44;Grand Est;54;1;11;485;Saint-Pancré;310;6;316
44;Grand Est;54;3;10;486;Saint-Remimont;355;5;360
44;Grand Est;54;2;09;487;Saint-Rémy-aux-Bois;64;0;64
44;Grand Est;54;2;01;488;Saint-Sauveur;35;0;35
44;Grand Est;54;1;11;489;Saint-Supplet;148;4;152
44;Grand Est;54;3;16;490;Saizerais;1473;23;1496
44;Grand Est;54;1;17;491;Sancy;315;7;322
44;Grand Est;54;4;16;492;Sanzey;152;2;154
44;Grand Est;54;1;23;493;Saulnes;2415;39;2454
44;Grand Est;54;4;10;494;Saulxerotte;101;0;101
44;Grand Est;54;3;03;495;Saulxures-lès-Nancy;4221;59;4280
44;Grand Est;54;4;10;496;Saulxures-lès-Vannes;368;4;372
44;Grand Est;54;3;10;497;Saxon-Sion;106;3;109
44;Grand Est;54;3;03;498;Seichamps;5069;66;5135
44;Grand Est;54;4;16;499;Seicheprey;112;4;116
44;Grand Est;54;4;10;500;Selaincourt;183;3;186
44;Grand Est;54;2;09;501;Seranville;101;0;101
44;Grand Est;54;2;08;502;Serres;243;1;244
44;Grand Est;54;1;23;504;Serrouville;668;16;684
44;Grand Est;54;4;15;505;Sexey-aux-Forges;714;8;722
44;Grand Est;54;2;08;507;Sionviller;103;2;105
44;Grand Est;54;3;02;508;Sivry;245;4;249
44;Grand Est;54;2;08;509;Sommerviller;994;4;998
44;Grand Est;54;3;03;510;Sornéville;312;6;318
44;Grand Est;54;1;04;511;Sponville;112;4;116
44;Grand Est;54;2;01;512;Tanconville;106;2;108
44;Grand Est;54;3;10;513;Tantonville;646;4;650
44;Grand Est;54;1;11;514;Tellancourt;601;15;616
44;Grand Est;54;3;10;515;Thélod;250;0;250
44;Grand Est;54;3;10;516;They-sous-Vaudemont;17;1;18
44;Grand Est;54;3;02;517;Thézey-Saint-Martin;203;2;205
44;Grand Est;54;4;16;518;Thiaucourt-Regniéville;1110;10;1120
44;Grand Est;54;2;01;519;Thiaville-sur-Meurthe;587;8;595
44;Grand Est;54;2;01;520;Thiébauménil;381;9;390
44;Grand Est;54;1;23;521;Thil;1950;30;1980
44;Grand Est;54;3;10;522;Thorey-Lyautey;142;3;145
44;Grand Est;54;4;10;523;Thuilley-aux-Groseilles;424;2;426
44;Grand Est;54;1;17;524;Thumeréville;84;2;86
44;Grand Est;54;1;23;525;Tiercelet;664;12;676
44;Grand Est;54;3;19;526;Tomblaine;8856;289;9145
44;Grand Est;54;3;09;527;Tonnoy;675;26;701
44;Grand Est;54;4;20;528;Toul;15633;265;15898
44;Grand Est;54;4;10;529;Tramont-Émy;28;0;28
44;Grand Est;54;4;10;530;Tramont-Lassus;86;2;88
44;Grand Est;54;4;10;531;Tramont-Saint-André;56;1;57
44;Grand Est;54;4;16;532;Tremblecourt;165;3;168
44;Grand Est;54;1;17;533;Trieux;2605;33;2638
44;Grand Est;54;4;16;534;Trondes;530;21;551
44;Grand Est;54;1;04;535;Tronville;200;2;202
44;Grand Est;54;1;17;536;Tucquegnieux;2438;24;2462
44;Grand Est;54;1;11;537;Ugny;690;29;719
44;Grand Est;54;4;10;538;Uruffe;381;3;384
44;Grand Est;54;2;01;539;Vacqueville;234;13;247
44;Grand Est;54;2;01;540;Val-et-Châtillon;578;6;584
44;Grand Est;54;2;08;541;Valhey;165;2;167
44;Grand Est;54;1;04;542;Valleroy;2322;35;2357
44;Grand Est;54;2;09;543;Vallois;158;2;160
44;Grand Est;54;4;18;544;Vandelainville;140;2;142
44;Grand Est;54;4;10;545;Vandeléville;211;5;216
44;Grand Est;54;3;18;546;Vandières;930;9;939
44;Grand Est;54;3;22;547;Vandœuvre-lès-Nancy;29942;281;30223
44;Grand Est;54;4;10;548;Vannes-le-Châtel;538;8;546
44;Grand Est;54;3;08;549;Varangéville;3594;42;3636
44;Grand Est;54;2;09;550;Vathiménil;322;8;330
44;Grand Est;54;2;01;551;Vaucourt;60;2;62
44;Grand Est;54;3;10;552;Vaudémont;62;2;64
44;Grand Est;54;3;10;553;Vaudeville;150;4;154
44;Grand Est;54;3;10;554;Vaudigny;77;1;78
44;Grand Est;54;2;01;555;Vaxainville;88;0;88
44;Grand Est;54;2;01;556;Vého;107;3;110
44;Grand Est;54;4;16;557;Bois-de-Haye;2306;96;2402
44;Grand Est;54;3;03;558;Velaine-sous-Amance;280;5;285
44;Grand Est;54;2;09;559;Velle-sur-Moselle;302;2;304
44;Grand Est;54;2;01;560;Veney;52;0;52
44;Grand Est;54;2;09;561;Vennezey;47;1;48
44;Grand Est;54;2;01;562;Verdenal;159;7;166
44;Grand Est;54;3;10;563;Vézelise;1392;17;1409
44;Grand Est;54;4;16;564;Viéville-en-Haye;141;4;145
44;Grand Est;54;2;09;565;Vigneulles;235;2;237
44;Grand Est;54;4;16;566;Vilcey-sur-Trey;154;1;155
44;Grand Est;54;2;09;567;Villacourt;366;13;379
44;Grand Est;54;1;11;568;Ville-au-Montois;271;3;274
44;Grand Est;54;3;02;569;Ville-au-Val;191;4;195
44;Grand Est;54;1;18;570;Villecey-sur-Mad;340;7;347
44;Grand Est;54;3;05;571;Ville-en-Vermois;594;8;602
44;Grand Est;54;1;11;572;Ville-Houdlémont;683;5;688
44;Grand Est;54;4;16;573;Villers-en-Haye;170;0;170
44;Grand Est;54;1;11;574;Villers-la-Chèvre;551;19;570
44;Grand Est;54;1;23;575;Villers-la-Montagne;1525;37;1562
44;Grand Est;54;1;11;576;Villers-le-Rond;117;1;118
44;Grand Est;54;3;02;577;Villers-lès-Moivrons;143;1;144
44;Grand Est;54;3;06;578;Villers-lès-Nancy;14525;302;14827
44;Grand Est;54;3;18;579;Villers-sous-Prény;339;7;346
44;Grand Est;54;1;23;580;Villerupt;10003;108;10111
44;Grand Est;54;1;04;581;Ville-sur-Yron;297;9;306
44;Grand Est;54;1;11;582;Villette;183;1;184
44;Grand Est;54;4;20;583;Villey-le-Sec;415;8;423
44;Grand Est;54;4;16;584;Villey-Saint-Étienne;1032;22;1054
44;Grand Est;54;2;09;585;Virecourt;491;6;497
44;Grand Est;54;3;10;586;Viterne;741;7;748
44;Grand Est;54;3;10;587;Vitrey;195;3;198
44;Grand Est;54;2;08;588;Vitrimont;395;9;404
44;Grand Est;54;3;18;589;Vittonville;128;6;134
44;Grand Est;54;1;11;590;Viviers-sur-Chiers;665;19;684
44;Grand Est;54;3;10;591;Voinémont;330;12;342
44;Grand Est;54;3;10;592;Vroncourt;260;3;263
44;Grand Est;54;1;18;593;Waville;428;5;433
44;Grand Est;54;4;16;594;Xammes;159;1;160
44;Grand Est;54;2;09;595;Xermaménil;561;7;568
44;Grand Est;54;3;10;596;Xeuilley;966;7;973
44;Grand Est;54;3;10;597;Xirocourt;443;3;446
44;Grand Est;54;1;17;598;Xivry-Circourt;270;7;277
44;Grand Est;54;1;04;599;Xonville;112;0;112
44;Grand Est;54;2;01;600;Xousse;129;1;130
44;Grand Est;54;2;01;601;Xures;103;1;104
44;Grand Est;54;1;11;602;Han-devant-Pierrepont;148;0;148
44;Grand Est;55;2;10;001;Abainville;290;10;300
44;Grand Est;55;3;04;002;Abaucourt-Hautecourt;103;3;106
44;Grand Est;55;3;14;004;Aincreville;77;0;77
44;Grand Est;55;2;10;005;Amanty;36;1;37
44;Grand Est;55;3;08;007;Ambly-sur-Meuse;241;2;243
44;Grand Est;55;3;05;008;Amel-sur-l'Étang;146;5;151
44;Grand Est;55;3;08;009;Ancemont;538;19;557
44;Grand Est;55;1;01;010;Ancerville;2662;73;2735
44;Grand Est;55;1;12;011;Andernay;257;3;260
44;Grand Est;55;2;13;012;Apremont-la-Forêt;414;8;422
44;Grand Est;55;3;05;013;Arrancy-sur-Crusne;474;8;482
44;Grand Est;55;3;06;014;Aubréville;361;7;368
44;Grand Est;55;1;01;015;Aulnois-en-Perthois;498;12;510
44;Grand Est;55;1;08;017;Autrécourt-sur-Aire;118;5;123
44;Grand Est;55;3;14;018;Autréville-Saint-Lambert;40;2;42
44;Grand Est;55;3;09;021;Avillers-Sainte-Croix;62;2;64
44;Grand Est;55;3;11;022;Avioth;151;4;155
44;Grand Est;55;3;06;023;Avocourt;116;1;117
44;Grand Est;55;3;11;024;Azannes-et-Soumazannes;162;3;165
44;Grand Est;55;3;14;025;Baâlon;277;3;280
44;Grand Est;55;2;10;026;Badonvilliers-Gérauvilliers;132;5;137
44;Grand Est;55;2;08;027;Bannoncourt;159;3;162
44;Grand Est;55;3;06;028;Bantheville;113;3;116
44;Grand Est;55;1;98;029;Bar-le-Duc;14625;596;15221
44;Grand Est;55;1;01;031;Baudonvilliers;378;6;384
44;Grand Est;55;2;08;032;Baudrémont;45;1;46
44;Grand Est;55;3;06;033;Baulny;18;1;19
44;Grand Est;55;3;11;034;Bazeilles-sur-Othain;115;3;118
44;Grand Est;55;1;01;035;Bazincourt-sur-Saulx;147;6;153
44;Grand Est;55;3;14;036;Beauclair;92;1;93
44;Grand Est;55;3;14;037;Beaufort-en-Argonne;145;2;147
44;Grand Est;55;1;08;038;Beaulieu-en-Argonne;38;2;40
44;Grand Est;55;3;04;039;Beaumont-en-Verdunois;0;0;0
44;Grand Est;55;1;08;040;Beausite;253;6;259
44;Grand Est;55;1;03;041;Behonne;608;16;624
44;Grand Est;55;3;17;042;Belleray;525;12;537
44;Grand Est;55;3;04;043;Belleville-sur-Meuse;3040;53;3093
44;Grand Est;55;2;08;044;Belrain;33;3;36
44;Grand Est;55;3;17;045;Belrupt-en-Verdunois;558;8;566
44;Grand Est;55;2;13;046;Beney-en-Woëvre;128;4;132
44;Grand Est;55;3;06;047;Béthelainville;161;6;167
44;Grand Est;55;3;06;048;Béthincourt;34;2;36
44;Grand Est;55;1;12;049;Beurey-sur-Saulx;421;0;421
44;Grand Est;55;3;04;050;Bezonvaux;0;0;0
44;Grand Est;55;1;10;051;Biencourt-sur-Orge;125;3;128
44;Grand Est;55;3;05;053;Billy-sous-Mangiennes;369;2;371
44;Grand Est;55;2;13;054;Bislée;61;5;66
44;Grand Est;55;3;04;055;Blanzée;13;1;14
44;Grand Est;55;3;09;057;Boinville-en-Woëvre;78;2;80
44;Grand Est;55;2;07;058;Boncourt-sur-Meuse;326;10;336
44;Grand Est;55;2;10;059;Bonnet;191;8;199
44;Grand Est;55;3;09;060;Bonzée;346;14;360
44;Grand Est;55;1;10;061;Le Bouchon-sur-Saulx;239;6;245
44;Grand Est;55;2;13;062;Bouconville-sur-Madt;114;1;115
44;Grand Est;55;3;05;063;Bouligny;2464;39;2503
44;Grand Est;55;2;08;064;Bouquemont;104;0;104
44;Grand Est;55;3;06;065;Boureuilles;119;0;119
44;Grand Est;55;2;15;066;Bovée-sur-Barboure;131;4;135
44;Grand Est;55;2;15;067;Boviolles;100;2;102
44;Grand Est;55;3;06;068;Brabant-en-Argonne;111;3;114
44;Grand Est;55;1;12;069;Brabant-le-Roi;229;3;232
44;Grand Est;55;3;06;070;Brabant-sur-Meuse;120;6;126
44;Grand Est;55;3;11;071;Brandeville;182;5;187
44;Grand Est;55;3;09;072;Braquis;109;1;110
44;Grand Est;55;3;04;073;Bras-sur-Meuse;691;50;741
44;Grand Est;55;1;10;075;Brauvilliers;174;4;178
44;Grand Est;55;3;11;076;Bréhéville;168;1;169
44;Grand Est;55;3;11;077;Breux;263;9;272
44;Grand Est;55;3;14;078;Brieulles-sur-Meuse;305;9;314
44;Grand Est;55;1;01;079;Brillon-en-Barrois;696;21;717
44;Grand Est;55;2;15;080;Brixey-aux-Chanoines;80;4;84
44;Grand Est;55;1;08;081;Brizeaux;58;1;59
44;Grand Est;55;3;06;082;Brocourt-en-Argonne;46;1;47
44;Grand Est;55;3;14;083;Brouennes;153;4;157
44;Grand Est;55;2;15;084;Broussey-en-Blois;57;2;59
44;Grand Est;55;2;13;085;Broussey-Raulecourt;288;4;292
44;Grand Est;55;1;10;087;Bure;81;8;89
44;Grand Est;55;2;15;088;Burey-en-Vaux;152;4;156
44;Grand Est;55;2;15;089;Burey-la-Côte;88;1;89
44;Grand Est;55;2;13;093;Buxières-sous-les-Côtes;290;3;293
44;Grand Est;55;3;09;094;Buzy-Darmont;549;11;560
44;Grand Est;55;3;14;095;Cesse;104;4;108
44;Grand Est;55;2;13;096;Chaillon;112;1;113
44;Grand Est;55;2;15;097;Chalaines;312;6;318
44;Grand Est;55;3;04;099;Champneuville;121;1;122
44;Grand Est;55;2;15;100;Champougny;79;8;87
44;Grand Est;55;1;03;101;Chardogne;298;8;306
44;Grand Est;55;3;04;102;Charny-sur-Meuse;524;19;543
44;Grand Est;55;3;06;103;Charpentry;21;2;23
44;Grand Est;55;2;10;104;Chassey-Beaupré;81;3;84
44;Grand Est;55;3;04;105;Châtillon-sous-les-Côtes;178;4;182
44;Grand Est;55;3;06;106;Chattancourt;179;5;184
44;Grand Est;55;3;11;107;Chaumont-devant-Damvillers;47;1;48
44;Grand Est;55;1;12;108;Chaumont-sur-Aire;124;4;128
44;Grand Est;55;3;11;109;Chauvency-le-Château;237;7;244
44;Grand Est;55;3;11;110;Chauvency-Saint-Hubert;226;7;233
44;Grand Est;55;2;13;111;Chauvoncourt;444;20;464
44;Grand Est;55;3;06;113;Cheppy;156;1;157
44;Grand Est;55;2;07;114;Chonville-Malaumont;206;4;210
44;Grand Est;55;3;06;115;Cierges-sous-Montfaucon;46;0;46
44;Grand Est;55;3;06;116;Le Claon;55;2;57
44;Grand Est;55;3;06;117;Clermont-en-Argonne;1453;34;1487
44;Grand Est;55;3;14;118;Cléry-le-Grand;96;2;98
44;Grand Est;55;3;14;119;Cléry-le-Petit;190;1;191
44;Grand Est;55;1;02;120;Combles-en-Barrois;785;23;808
44;Grand Est;55;3;09;121;Combres-sous-les-Côtes;119;5;124
44;Grand Est;55;2;07;122;Commercy;5386;235;5621
44;Grand Est;55;1;12;123;Les Hauts-de-Chée;712;15;727
44;Grand Est;55;3;06;124;Consenvoye;309;4;313
44;Grand Est;55;1;12;125;Contrisson;797;19;816
44;Grand Est;55;2;08;127;Courcelles-en-Barrois;41;0;41
44;Grand Est;55;1;12;128;Courcelles-sur-Aire;41;1;42
44;Grand Est;55;2;08;129;Courouvre;37;1;38
44;Grand Est;55;1;01;132;Cousances-les-Forges;1680;29;1709
44;Grand Est;55;1;10;133;Couvertpuis;87;5;92
44;Grand Est;55;1;12;134;Couvonges;153;4;157
44;Grand Est;55;3;06;137;Cuisy;48;0;48
44;Grand Est;55;1;15;138;Culey;133;3;136
44;Grand Est;55;3;04;139;Cumières-le-Mort-Homme;0;0;0
44;Grand Est;55;3;06;140;Cunel;17;0;17
44;Grand Est;55;2;15;141;Dagonville;83;0;83
44;Grand Est;55;2;10;142;Dainville-Bertheléville;121;6;127
44;Grand Est;55;3;04;143;Damloup;127;8;135
44;Grand Est;55;1;10;144;Dammarie-sur-Saulx;385;13;398
44;Grand Est;55;3;11;145;Damvillers;626;74;700
44;Grand Est;55;3;06;146;Dannevoux;207;11;218
44;Grand Est;55;2;10;148;Delouze-Rosières;112;4;116
44;Grand Est;55;3;11;149;Delut;122;0;122
44;Grand Est;55;2;10;150;Demange-Baudignécourt;521;13;534
44;Grand Est;55;3;04;153;Dieppe-sous-Douaumont;195;2;197
44;Grand Est;55;3;08;154;Dieue-sur-Meuse;1441;47;1488
44;Grand Est;55;3;06;155;Dombasle-en-Argonne;397;7;404
44;Grand Est;55;3;11;156;Dombras;138;4;142
44;Grand Est;55;3;09;157;Dommartin-la-Montagne;52;0;52
44;Grand Est;55;3;05;158;Dommary-Baroncourt;731;8;739
44;Grand Est;55;2;08;159;Dompcevrin;338;3;341
44;Grand Est;55;2;13;160;Dompierre-aux-Bois;38;0;38
44;Grand Est;55;3;05;162;Domremy-la-Canne;35;0;35
44;Grand Est;55;3;09;163;Doncourt-aux-Templiers;56;3;59
44;Grand Est;55;3;14;165;Doulcon;426;12;438
44;Grand Est;55;3;17;166;Dugny-sur-Meuse;1311;24;1335
44;Grand Est;55;3;14;167;Dun-sur-Meuse;660;10;670
44;Grand Est;55;3;05;168;Duzey;44;0;44
44;Grand Est;55;3;11;169;Écouviez;514;6;520
44;Grand Est;55;3;11;170;Écurey-en-Verdunois;118;1;119
44;Grand Est;55;3;04;171;Eix;256;4;260
44;Grand Est;55;3;09;172;Les Éparges;63;1;64
44;Grand Est;55;2;15;173;Épiez-sur-Meuse;40;3;43
44;Grand Est;55;3;06;174;Épinonville;77;0;77
44;Grand Est;55;1;02;175;Érize-la-Brûlée;189;5;194
44;Grand Est;55;1;12;177;Érize-la-Petite;46;4;50
44;Grand Est;55;1;02;178;Érize-Saint-Dizier;184;6;190
44;Grand Est;55;2;15;179;Erneville-aux-Bois;153;3;156
44;Grand Est;55;3;06;180;Esnes-en-Argonne;136;11;147
44;Grand Est;55;3;09;181;Étain;3507;74;3581
44;Grand Est;55;3;05;182;Éton;208;3;211
44;Grand Est;55;3;11;183;Étraye;37;1;38
44;Grand Est;55;2;07;184;Euville;1651;32;1683
44;Grand Est;55;1;08;185;Èvres;89;5;94
44;Grand Est;55;1;03;186;Fains-Véel;2109;58;2167
44;Grand Est;55;3;11;188;Flassigny;44;1;45
44;Grand Est;55;3;04;189;Fleury-devant-Douaumont;0;0;0
44;Grand Est;55;3;05;191;Foameix-Ornel;232;5;237
44;Grand Est;55;3;14;192;Fontaines-Saint-Clair;44;1;45
44;Grand Est;55;3;06;193;Forges-sur-Meuse;123;2;125
44;Grand Est;55;1;08;194;Foucaucourt-sur-Thabas;58;0;58
44;Grand Est;55;1;10;195;Fouchères-aux-Bois;127;4;131
44;Grand Est;55;2;07;196;Frémeréville-sous-les-Côtes;128;1;129
44;Grand Est;55;2;08;197;Fresnes-au-Mont;167;4;171
44;Grand Est;55;3;09;198;Fresnes-en-Woëvre;652;9;661
44;Grand Est;55;3;06;199;Froidos;91;2;93
44;Grand Est;55;3;06;200;Fromeréville-les-Vallons;206;4;210
44;Grand Est;55;3;09;201;Fromezey;59;0;59
44;Grand Est;55;3;06;202;Futeau;149;3;152
44;Grand Est;55;3;08;204;Génicourt-sur-Meuse;293;5;298
44;Grand Est;55;3;06;206;Gercourt-et-Drillancourt;98;4;102
44;Grand Est;55;1;02;207;Géry;53;1;54
44;Grand Est;55;3;06;208;Gesnes-en-Argonne;60;2;62
44;Grand Est;55;2;08;210;Gimécourt;40;0;40
44;Grand Est;55;3;04;211;Gincrey;65;1;66
44;Grand Est;55;2;07;212;Girauvoisin;81;0;81
44;Grand Est;55;1;10;214;Givrauval;279;21;300
44;Grand Est;55;2;10;215;Gondrecourt-le-Château;1074;17;1091
44;Grand Est;55;3;05;216;Gouraincourt;63;0;63
44;Grand Est;55;2;15;217;Goussaincourt;115;6;121
44;Grand Est;55;3;11;218;Gremilly;39;0;39
44;Grand Est;55;3;04;219;Grimaucourt-en-Woëvre;102;2;104
44;Grand Est;55;2;07;220;Grimaucourt-près-Sampigny;78;0;78
44;Grand Est;55;1;01;221;Guerpont;245;6;251
44;Grand Est;55;3;09;222;Gussainville;32;2;34
44;Grand Est;55;1;01;224;Haironville;583;13;596
44;Grand Est;55;3;14;225;Halles-sous-les-Côtes;143;7;150
44;Grand Est;55;3;11;226;Han-lès-Juvigny;123;1;124
44;Grand Est;55;3;09;228;Hannonville-sous-les-Côtes;552;11;563
44;Grand Est;55;2;13;229;Han-sur-Meuse;272;3;275
44;Grand Est;55;3;09;232;Harville;114;0;114
44;Grand Est;55;3;17;236;Haudainville;941;24;965
44;Grand Est;55;3;09;237;Haudiomont;227;1;228
44;Grand Est;55;3;04;239;Haumont-près-Samogneux;0;0;0
44;Grand Est;55;3;08;241;Heippes;78;3;81
44;Grand Est;55;3;09;242;Hennemont;111;4;115
44;Grand Est;55;3;09;243;Herbeuville;181;5;186
44;Grand Est;55;3;09;244;Herméville-en-Woëvre;232;3;235
44;Grand Est;55;2;13;245;Heudicourt-sous-les-Côtes;165;2;167
44;Grand Est;55;1;10;246;Hévilliers;150;1;151
44;Grand Est;55;2;10;247;Horville-en-Ornois;51;5;56
44;Grand Est;55;2;10;248;Houdelaincourt;285;7;292
44;Grand Est;55;3;14;250;Inor;182;8;190
44;Grand Est;55;1;08;251;Ippécourt;103;3;106
44;Grand Est;55;3;11;252;Iré-le-Sec;154;2;156
44;Grand Est;55;3;06;253;Les Islettes;715;13;728
44;Grand Est;55;1;08;254;Les Trois-Domaines;123;3;126
44;Grand Est;55;3;11;255;Jametz;260;6;266
44;Grand Est;55;2;13;256;Jonville-en-Woëvre;148;0;148
44;Grand Est;55;3;06;257;Jouy-en-Argonne;43;0;43
44;Grand Est;55;2;07;258;Geville;617;17;634
44;Grand Est;55;3;08;260;Julvécourt;54;2;56
44;Grand Est;55;1;01;261;Juvigny-en-Perthois;142;2;144
44;Grand Est;55;3;11;262;Juvigny-sur-Loison;266;2;268
44;Grand Est;55;2;08;263;Kœur-la-Grande;158;4;162
44;Grand Est;55;2;08;264;Kœur-la-Petite;266;5;271
44;Grand Est;55;3;09;265;Labeuville;138;5;143
44;Grand Est;55;3;06;266;Lachalade;50;0;50
44;Grand Est;55;2;13;267;Lachaussée;272;8;280
44;Grand Est;55;2;13;268;Lacroix-sur-Meuse;712;17;729
44;Grand Est;55;2;08;269;Lahaymeix;74;0;74
44;Grand Est;55;2;13;270;Lahayville;28;1;29
44;Grand Est;55;1;12;271;Laheycourt;378;6;384
44;Grand Est;55;1;12;272;Laimont;441;17;458
44;Grand Est;55;2;13;274;Lamorville;290;6;296
44;Grand Est;55;3;14;275;Lamouilly;87;4;91
44;Grand Est;55;3;08;276;Landrecourt-Lempire;215;2;217
44;Grand Est;55;2;15;278;Laneuville-au-Rupt;194;3;197
44;Grand Est;55;3;14;279;Laneuville-sur-Meuse;445;8;453
44;Grand Est;55;3;05;280;Lanhères;59;0;59
44;Grand Est;55;3;09;281;Latour-en-Woëvre;95;0;95
44;Grand Est;55;2;08;282;Lavallée;95;3;98
44;Grand Est;55;1;01;284;Lavincourt;72;0;72
44;Grand Est;55;1;08;285;Lavoye;153;4;157
44;Grand Est;55;3;08;286;Lemmes;241;1;242
44;Grand Est;55;2;07;288;Lérouville;1416;16;1432
44;Grand Est;55;2;08;289;Levoncourt;60;1;61
44;Grand Est;55;2;08;290;Lignières-sur-Aire;54;2;56
44;Grand Est;55;1;10;291;Ligny-en-Barrois;4018;135;4153
44;Grand Est;55;3;14;292;Liny-devant-Dun;189;7;196
44;Grand Est;55;3;14;293;Lion-devant-Dun;168;4;172
44;Grand Est;55;1;12;295;Lisle-en-Barrois;31;1;32
44;Grand Est;55;1;01;296;L'Isle-en-Rigault;477;8;485
44;Grand Est;55;3;11;297;Lissey;111;1;112
44;Grand Est;55;1;15;298;Loisey;295;9;304
44;Grand Est;55;3;05;299;Loison;120;3;123
44;Grand Est;55;1;10;300;Longeaux;224;7;231
44;Grand Est;55;2;08;301;Longchamps-sur-Aire;121;8;129
44;Grand Est;55;1;02;302;Longeville-en-Barrois;1129;35;1164
44;Grand Est;55;2;13;303;Loupmont;72;4;76
44;Grand Est;55;1;12;304;Louppy-le-Château;159;6;165
44;Grand Est;55;3;11;306;Louppy-sur-Loison;113;1;114
44;Grand Est;55;3;04;307;Louvemont-Côte-du-Poivre;0;0;0
44;Grand Est;55;3;14;310;Luzy-Saint-Martin;113;4;117
44;Grand Est;55;3;09;311;Maizeray;29;1;30
44;Grand Est;55;2;13;312;Maizey;165;6;171
44;Grand Est;55;3;06;313;Malancourt;67;2;69
44;Grand Est;55;1;10;315;Mandres-en-Barrois;117;5;122
44;Grand Est;55;3;05;316;Mangiennes;400;7;407
44;Grand Est;55;3;09;317;Manheulles;142;7;149
44;Grand Est;55;3;09;320;Marchéville-en-Woëvre;67;2;69
44;Grand Est;55;3;06;321;Marre;162;7;169
44;Grand Est;55;2;15;322;Marson-sur-Barboure;46;1;47
44;Grand Est;55;3;14;323;Martincourt-sur-Meuse;68;1;69
44;Grand Est;55;3;11;324;Marville;517;13;530
44;Grand Est;55;3;04;325;Maucourt-sur-Orne;51;1;52
44;Grand Est;55;1;01;326;Maulan;111;3;114
44;Grand Est;55;2;10;327;Mauvages;251;2;253
44;Grand Est;55;2;15;328;Maxey-sur-Vaise;288;6;294
44;Grand Est;55;2;07;329;Mécrin;223;2;225
44;Grand Est;55;2;15;330;Méligny-le-Grand;90;2;92
44;Grand Est;55;2;15;331;Méligny-le-Petit;78;0;78
44;Grand Est;55;1;10;332;Menaucourt;238;5;243
44;Grand Est;55;2;08;333;Ménil-aux-Bois;41;0;41
44;Grand Est;55;2;15;334;Ménil-la-Horgne;167;3;170
44;Grand Est;55;1;10;335;Ménil-sur-Saulx;252;9;261
44;Grand Est;55;3;11;336;Merles-sur-Loison;151;2;153
44;Grand Est;55;3;14;338;Milly-sur-Bradon;149;5;154
44;Grand Est;55;3;04;339;Mogeville;78;1;79
44;Grand Est;55;1;12;340;Mognéville;377;11;388
44;Grand Est;55;3;11;341;Moirey-Flabas-Crépion;126;2;128
44;Grand Est;55;3;06;343;Montblainville;60;2;62
44;Grand Est;55;2;15;344;Montbras;22;0;22
44;Grand Est;55;3;14;345;Mont-devant-Sassey;102;3;105
44;Grand Est;55;3;06;346;Montfaucon-d'Argonne;296;7;303
44;Grand Est;55;3;08;347;Les Monthairons;350;3;353
44;Grand Est;55;1;10;348;Montiers-sur-Saulx;373;4;377
44;Grand Est;55;3;14;349;Montigny-devant-Sassey;111;6;117
44;Grand Est;55;2;15;350;Montigny-lès-Vaucouleurs;74;0;74
44;Grand Est;55;3;11;351;Montmédy;2052;85;2137
44;Grand Est;55;1;01;352;Montplonne;143;18;161
44;Grand Est;55;2;13;353;Montsec;81;0;81
44;Grand Est;55;3;06;355;Montzéville;155;1;156
44;Grand Est;55;3;04;356;Moranville;105;1;106
44;Grand Est;55;3;05;357;Morgemoulin;108;3;111
44;Grand Est;55;1;10;358;Chanteraine;189;5;194
44;Grand Est;55;1;10;359;Morley;206;2;208
44;Grand Est;55;3;09;360;Mouilly;110;1;111
44;Grand Est;55;3;04;361;Moulainville;127;0;127
44;Grand Est;55;3;14;362;Moulins-Saint-Hubert;178;3;181
44;Grand Est;55;3;09;363;Moulotte;93;1;94
44;Grand Est;55;3;14;364;Mouzay;667;29;696
44;Grand Est;55;3;14;365;Murvaux;142;4;146
44;Grand Est;55;1;12;366;Val-d'Ornain;993;34;1027
44;Grand Est;55;3;05;367;Muzeray;136;4;140
44;Grand Est;55;2;15;368;Naives-en-Blois;144;9;153
44;Grand Est;55;1;02;369;Naives-Rosières;803;21;824
44;Grand Est;55;1;10;370;Naix-aux-Forges;225;2;227
44;Grand Est;55;2;15;371;Nançois-le-Grand;74;4;78
44;Grand Est;55;1;15;372;Nançois-sur-Ornain;373;12;385
44;Grand Est;55;1;01;373;Nant-le-Grand;83;5;88
44;Grand Est;55;1;01;374;Nant-le-Petit;75;1;76
44;Grand Est;55;3;06;375;Nantillois;64;1;65
44;Grand Est;55;1;10;376;Nantois;86;4;90
44;Grand Est;55;3;14;377;Nepvant;90;1;91
44;Grand Est;55;1;12;378;Nettancourt;244;3;247
44;Grand Est;55;3;06;379;Le Neufour;71;2;73
44;Grand Est;55;2;08;380;Neuville-en-Verdunois;54;1;55
44;Grand Est;55;2;15;381;Neuville-lès-Vaucouleurs;174;8;182
44;Grand Est;55;1;12;382;Neuville-sur-Ornain;362;9;371
44;Grand Est;55;3;06;383;Neuvilly-en-Argonne;216;2;218
44;Grand Est;55;2;08;384;Nicey-sur-Aire;123;4;127
44;Grand Est;55;3;08;385;Nixéville-Blercourt;491;16;507
44;Grand Est;55;2;13;386;Nonsard-Lamarche;219;5;224
44;Grand Est;55;3;05;387;Nouillonpont;239;4;243
44;Grand Est;55;1;12;388;Noyers-Auzécourt;278;4;282
44;Grand Est;55;1;08;389;Nubécourt;250;6;256
44;Grand Est;55;3;14;391;Olizy-sur-Chiers;197;6;203
44;Grand Est;55;3;04;394;Ornes;6;0;6
44;Grand Est;55;3;08;395;Osches;56;3;59
44;Grand Est;55;2;15;396;Ourches-sur-Meuse;226;5;231
44;Grand Est;55;2;15;397;Pagny-la-Blanche-Côte;238;4;242
44;Grand Est;55;2;15;398;Pagny-sur-Meuse;1016;17;1033
44;Grand Est;55;3;09;399;Pareid;117;0;117
44;Grand Est;55;3;09;400;Parfondrupt;43;0;43
44;Grand Est;55;2;13;401;Les Paroches;413;11;424
44;Grand Est;55;3;11;403;Peuvillers;60;1;61
44;Grand Est;55;2;08;404;Pierrefitte-sur-Aire;326;11;337
44;Grand Est;55;3;05;405;Pillon;256;4;260
44;Grand Est;55;3;09;406;Pintheville;110;4;114
44;Grand Est;55;2;07;407;Pont-sur-Meuse;127;6;133
44;Grand Est;55;3;14;408;Pouilly-sur-Meuse;173;8;181
44;Grand Est;55;1;08;409;Pretz-en-Argonne;65;2;67
44;Grand Est;55;3;11;410;Quincy-Landzécourt;134;6;140
44;Grand Est;55;3;08;411;Rambluzin-et-Benoite-Vaux;107;1;108
44;Grand Est;55;2;13;412;Rambucourt;187;5;192
44;Grand Est;55;1;12;414;Rancourt-sur-Ornain;184;1;185
44;Grand Est;55;2;13;415;Ranzières;86;1;87
44;Grand Est;55;3;06;416;Rarécourt;224;7;231
44;Grand Est;55;3;06;419;Récicourt;161;4;165
44;Grand Est;55;3;08;420;Récourt-le-Creux;77;0;77
44;Grand Est;55;2;15;421;Reffroy;77;4;81
44;Grand Est;55;3;06;422;Regnéville-sur-Meuse;51;0;51
44;Grand Est;55;1;12;423;Rembercourt-Sommaisne;330;8;338
44;Grand Est;55;1;12;424;Remennecourt;50;0;50
44;Grand Est;55;3;11;425;Remoiville;134;0;134
44;Grand Est;55;1;02;426;Resson;387;15;402
44;Grand Est;55;1;12;427;Revigny-sur-Ornain;2802;51;2853
44;Grand Est;55;3;11;428;Réville-aux-Bois;123;1;124
44;Grand Est;55;3;09;429;Riaville;47;0;47
44;Grand Est;55;1;10;430;Ribeaucourt;65;1;66
44;Grand Est;55;2;13;431;Richecourt;58;0;58
44;Grand Est;55;2;15;433;Rigny-la-Salle;358;13;371
44;Grand Est;55;2;15;434;Rigny-Saint-Martin;50;2;52
44;Grand Est;55;1;12;435;Robert-Espagne;782;24;806
44;Grand Est;55;2;10;436;Les Roises;29;0;29
44;Grand Est;55;3;11;437;Romagne-sous-les-Côtes;122;3;125
44;Grand Est;55;3;06;438;Romagne-sous-Montfaucon;185;4;189
44;Grand Est;55;3;09;439;Ronvaux;89;5;94
44;Grand Est;55;1;02;442;Raival;248;3;251
44;Grand Est;55;3;05;443;Rouvres-en-Woëvre;592;6;598
44;Grand Est;55;2;13;444;Rouvrois-sur-Meuse;221;0;221
44;Grand Est;55;3;05;445;Rouvrois-sur-Othain;189;8;197
44;Grand Est;55;1;02;446;Rumont;85;4;89
44;Grand Est;55;1;01;447;Rupt-aux-Nonains;372;7;379
44;Grand Est;55;2;08;448;Rupt-devant-Saint-Mihiel;48;1;49
44;Grand Est;55;3;08;449;Rupt-en-Woëvre;289;4;293
44;Grand Est;55;3;11;450;Rupt-sur-Othain;45;2;47
44;Grand Est;55;1;10;452;Saint-Amand-sur-Ornain;49;2;51
44;Grand Est;55;3;08;453;Saint-André-en-Barrois;65;1;66
44;Grand Est;55;2;15;454;Saint-Aubin-sur-Aire;166;1;167
44;Grand Est;55;2;15;456;Saint-Germain-sur-Meuse;232;8;240
44;Grand Est;55;3;09;457;Saint-Hilaire-en-Woëvre;181;5;186
44;Grand Est;55;3;09;458;Saint-Jean-lès-Buzy;375;0;375
44;Grand Est;55;2;10;459;Saint-Joire;239;3;242
44;Grand Est;55;2;07;460;Saint-Julien-sous-les-Côtes;139;2;141
44;Grand Est;55;3;05;461;Saint-Laurent-sur-Othain;472;16;488
44;Grand Est;55;2;13;462;Saint-Maurice-sous-les-Côtes;340;11;351
44;Grand Est;55;2;13;463;Saint-Mihiel;4039;71;4110
44;Grand Est;55;3;05;464;Saint-Pierrevillers;155;8;163
44;Grand Est;55;3;09;465;Saint-Remy-la-Calonne;104;0;104
44;Grand Est;55;1;15;466;Salmagne;294;8;302
44;Grand Est;55;2;08;467;Sampigny;689;14;703
44;Grand Est;55;3;04;468;Samogneux;98;0;98
44;Grand Est;55;3;14;469;Sassey-sur-Meuse;90;0;90
44;Grand Est;55;1;01;470;Saudrupt;193;2;195
44;Grand Est;55;3;14;471;Saulmory-Villefranche;83;1;84
44;Grand Est;55;2;15;472;Saulvaux;116;6;122
44;Grand Est;55;3;09;473;Saulx-lès-Champlon;113;12;125
44;Grand Est;55;2;15;474;Sauvigny;230;7;237
44;Grand Est;55;2;15;475;Sauvoy;60;1;61
44;Grand Est;55;1;02;476;Savonnières-devant-Bar;471;13;484
44;Grand Est;55;1;01;477;Savonnières-en-Perthois;405;15;420
44;Grand Est;55;1;02;479;Seigneulles;163;3;166
44;Grand Est;55;3;05;481;Senon;336;2;338
44;Grand Est;55;3;08;482;Senoncourt-les-Maujouy;101;2;103
44;Grand Est;55;3;06;484;Septsarges;47;1;48
44;Grand Est;55;2;15;485;Sepvigny;72;3;75
44;Grand Est;55;2;13;487;Seuzey;97;2;99
44;Grand Est;55;1;01;488;Silmont;150;5;155
44;Grand Est;55;3;16;489;Sivry-la-Perche;274;7;281
44;Grand Est;55;3;06;490;Sivry-sur-Meuse;332;11;343
44;Grand Est;55;3;08;492;Sommedieue;989;13;1002
44;Grand Est;55;1;12;493;Sommeilles;190;5;195
44;Grand Est;55;1;01;494;Sommelonne;428;21;449
44;Grand Est;55;3;05;495;Sorbey;252;1;253
44;Grand Est;55;2;15;496;Sorcy-Saint-Martin;1066;30;1096
44;Grand Est;55;3;08;497;Les Souhesmes-Rampont;327;3;330
44;Grand Est;55;3;08;498;Souilly;465;5;470
44;Grand Est;55;3;05;500;Spincourt;832;12;844
44;Grand Est;55;1;01;501;Stainville;385;10;395
44;Grand Est;55;3;14;502;Stenay;2507;129;2636
44;Grand Est;55;2;15;503;Taillancourt;124;2;126
44;Grand Est;55;1;01;504;Tannois;414;11;425
44;Grand Est;55;3;04;505;Thierville-sur-Meuse;3165;97;3262
44;Grand Est;55;2;08;506;Thillombois;31;0;31
44;Grand Est;55;3;09;507;Thillot;219;2;221
44;Grand Est;55;3;11;508;Thonne-la-Long;348;2;350
44;Grand Est;55;3;11;509;Thonne-le-Thil;274;6;280
44;Grand Est;55;3;11;510;Thonne-les-Près;131;3;134
44;Grand Est;55;3;11;511;Thonnelle;120;3;123
44;Grand Est;55;3;08;512;Tilly-sur-Meuse;279;4;283
44;Grand Est;55;1;02;514;Trémont-sur-Saulx;605;10;615
44;Grand Est;55;3;09;515;Trésauvaux;69;1;70
44;Grand Est;55;2;10;516;Tréveray;559;6;565
44;Grand Est;55;1;08;517;Seuil-d'Argonne;513;6;519
44;Grand Est;55;2;15;518;Cousances-lès-Triconville;143;2;145
44;Grand Est;55;1;01;519;Tronville-en-Barrois;1353;29;1382
44;Grand Est;55;2;15;520;Troussey;461;11;472
44;Grand Est;55;2;13;521;Troyon;244;1;245
44;Grand Est;55;2;15;522;Ugny-sur-Meuse;111;3;114
44;Grand Est;55;3;04;523;Vacherauville;189;4;193
44;Grand Est;55;3;08;525;Vadelaincourt;75;0;75
44;Grand Est;55;2;07;526;Vadonville;263;4;267
44;Grand Est;55;3;06;527;Varennes-en-Argonne;639;11;650
44;Grand Est;55;2;13;528;Varnéville;51;0;51
44;Grand Est;55;2;13;530;Valbois;93;1;94
44;Grand Est;55;1;12;531;Vassincourt;280;27;307
44;Grand Est;55;1;12;532;Vaubecourt;310;5;315
44;Grand Est;55;2;15;533;Vaucouleurs;1939;23;1962
44;Grand Est;55;2;10;534;Vaudeville-le-Haut;53;0;53
44;Grand Est;55;3;05;535;Vaudoncourt;96;0;96
44;Grand Est;55;3;06;536;Vauquois;17;3;20
44;Grand Est;55;3;04;537;Douaumont-Vaux;80;0;80
44;Grand Est;55;2;13;540;Vaux-lès-Palameix;60;1;61
44;Grand Est;55;1;03;541;Vavincourt;525;9;534
44;Grand Est;55;1;01;543;Velaines;948;21;969
44;Grand Est;55;3;11;544;Velosnes;151;2;153
44;Grand Est;55;3;99;545;Verdun;16942;964;17906
44;Grand Est;55;3;11;546;Verneuil-Grand;206;8;214
44;Grand Est;55;3;11;547;Verneuil-Petit;117;4;121
44;Grand Est;55;3;06;549;Véry;89;1;90
44;Grand Est;55;2;13;551;Vigneulles-lès-Hattonchâtel;1555;94;1649
44;Grand Est;55;3;11;552;Vigneul-sous-Montmédy;82;4;86
44;Grand Est;55;2;07;553;Vignot;1309;36;1345
44;Grand Est;55;3;11;554;Villécloye;267;15;282
44;Grand Est;55;2;08;555;Ville-devant-Belrain;33;1;34
44;Grand Est;55;3;11;556;Ville-devant-Chaumont;49;1;50
44;Grand Est;55;3;09;557;Ville-en-Woëvre;120;2;122
44;Grand Est;55;2;15;559;Villeroy-sur-Méholle;46;2;48
44;Grand Est;55;1;12;560;Villers-aux-Vents;131;4;135
44;Grand Est;55;3;14;561;Villers-devant-Dun;51;5;56
44;Grand Est;55;1;10;562;Villers-le-Sec;125;2;127
44;Grand Est;55;3;05;563;Villers-lès-Mangiennes;80;4;84
44;Grand Est;55;3;09;565;Villers-sous-Pareid;79;3;82
44;Grand Est;55;3;08;566;Villers-sur-Meuse;306;3;309
44;Grand Est;55;3;08;567;Ville-sur-Cousances;142;2;144
44;Grand Est;55;1;01;568;Ville-sur-Saulx;280;5;285
44;Grand Est;55;1;12;569;Villotte-devant-Louppy;165;5;170
44;Grand Est;55;2;08;570;Villotte-sur-Aire;208;7;215
44;Grand Est;55;3;06;571;Vilosnes-Haraumont;226;8;234
44;Grand Est;55;3;11;572;Vittarville;87;1;88
44;Grand Est;55;2;15;573;Void-Vacon;1629;30;1659
44;Grand Est;55;2;10;574;Vouthon-Bas;44;2;46
44;Grand Est;55;2;10;575;Vouthon-Haut;86;0;86
44;Grand Est;55;1;08;577;Waly;59;2;61
44;Grand Est;55;3;09;578;Warcq;184;7;191
44;Grand Est;55;3;09;579;Watronville;102;0;102
44;Grand Est;55;3;11;580;Wavrille;51;3;54
44;Grand Est;55;1;15;581;Willeroncourt;106;3;109
44;Grand Est;55;3;14;582;Wiseppe;91;1;92
44;Grand Est;55;3;09;583;Woël;201;4;205
44;Grand Est;55;2;08;584;Woimbey;123;2;125
44;Grand Est;55;2;13;586;Xivray-et-Marvoisin;107;3;110
53;Bretagne;56;3;04;001;Allaire;3886;128;4014
53;Bretagne;56;3;11;002;Ambon;1961;52;2013
53;Bretagne;56;3;20;003;Arradon;5392;175;5567
53;Bretagne;56;3;11;004;Arzal;1682;31;1713
53;Bretagne;56;3;18;005;Arzon;2198;35;2233
53;Bretagne;56;3;04;006;Augan;1526;31;1557
53;Bretagne;56;1;01;007;Auray;14141;423;14564
53;Bretagne;56;3;20;008;Baden;4396;121;4517
53;Bretagne;56;1;17;009;Bangor;1012;20;1032
53;Bretagne;56;2;15;010;Baud;6234;192;6426
53;Bretagne;56;3;04;011;Béganne;1395;27;1422
53;Bretagne;56;3;04;012;Beignon;1962;42;2004
53;Bretagne;56;1;17;013;Belz;3760;61;3821
53;Bretagne;56;2;02;014;Berné;1544;137;1681
53;Bretagne;56;3;16;015;Berric;2026;30;2056
53;Bretagne;56;2;10;017;Bignan;2774;63;2837
53;Bretagne;56;3;11;018;Billiers;1008;27;1035
53;Bretagne;56;2;10;019;Billio;336;10;346
53;Bretagne;56;3;10;020;Bohal;855;15;870
53;Bretagne;56;1;14;021;Brandérion;1459;27;1486
53;Bretagne;56;3;03;022;Brandivy;1300;27;1327
53;Bretagne;56;1;14;023;Brech;6660;282;6942
53;Bretagne;56;2;03;024;Bréhan;2289;35;2324
53;Bretagne;56;2;13;025;Brignac;192;4;196
53;Bretagne;56;1;05;026;Bubry;2317;59;2376
53;Bretagne;56;2;10;027;Buléon;540;8;548
53;Bretagne;56;3;16;028;Caden;1589;37;1626
53;Bretagne;56;1;05;029;Calan;1233;24;1257
53;Bretagne;56;3;11;030;Camoël;1039;16;1055
53;Bretagne;56;1;14;031;Camors;3066;61;3127
53;Bretagne;56;2;13;032;Campénéac;1888;53;1941
53;Bretagne;56;3;04;033;Carentoir;3074;58;3132
53;Bretagne;56;1;17;034;Carnac;4236;126;4362
53;Bretagne;56;3;10;035;Caro;1149;31;1180
53;Bretagne;56;1;07;036;Caudan;6920;202;7122
53;Bretagne;56;2;03;039;La Chapelle-Neuve;979;21;1000
53;Bretagne;56;1;05;040;Cléguer;3298;61;3359
53;Bretagne;56;2;02;041;Cléguérec;2828;90;2918
53;Bretagne;56;3;03;042;Colpo;2192;36;2228
53;Bretagne;56;2;13;043;Concoret;737;10;747
53;Bretagne;56;3;04;044;Cournon;786;30;816
53;Bretagne;56;3;16;045;Le Cours;672;10;682
53;Bretagne;56;1;01;046;Crach;3394;81;3475
53;Bretagne;56;2;03;047;Crédin;1520;47;1567
53;Bretagne;56;2;02;048;Le Croisty;708;17;725
53;Bretagne;56;2;15;049;Croixanvec;173;4;177
53;Bretagne;56;2;13;050;La Croix-Helléan;885;32;917
53;Bretagne;56;2;13;051;Cruguel;655;5;660
53;Bretagne;56;3;11;052;Damgan;1839;26;1865
53;Bretagne;56;3;16;053;Elven;6261;119;6380
53;Bretagne;56;1;17;054;Erdeven;3853;97;3950
53;Bretagne;56;1;17;055;Étel;2054;180;2234
53;Bretagne;56;2;13;056;Évriguet;199;4;203
53;Bretagne;56;2;02;057;Le Faouët;2793;58;2851
53;Bretagne;56;3;11;058;Férel;3318;62;3380
53;Bretagne;56;3;04;060;Les Fougerêts;951;35;986
53;Bretagne;56;3;04;061;La Gacilly;3962;80;4042
53;Bretagne;56;1;14;062;Gâvres;680;20;700
53;Bretagne;56;1;05;063;Gestel;2637;90;2727
53;Bretagne;56;2;13;065;Gourhel;721;25;746
53;Bretagne;56;2;02;066;Gourin;3779;150;3929
53;Bretagne;56;3;03;067;Grand-Champ;5552;139;5691
53;Bretagne;56;2;13;068;La Grée-Saint-Laurent;322;3;325
53;Bretagne;56;1;09;069;Groix;2234;53;2287
53;Bretagne;56;2;13;070;Guégon;2272;51;2323
53;Bretagne;56;2;10;071;Guéhenno;800;12;812
53;Bretagne;56;2;15;072;Gueltas;514;10;524
53;Bretagne;56;2;02;073;Guémené-sur-Scorff;1060;17;1077
53;Bretagne;56;2;15;074;Guénin;1822;37;1859
53;Bretagne;56;3;04;075;Guer;6091;300;6391
53;Bretagne;56;2;15;076;Guern;1313;38;1351
53;Bretagne;56;3;11;077;Le Guerno;999;17;1016
53;Bretagne;56;1;05;078;Guidel;11767;309;12076
53;Bretagne;56;2;13;079;Guillac;1343;41;1384
53;Bretagne;56;2;13;080;Guilliers;1305;143;1448
53;Bretagne;56;2;02;081;Guiscriff;2083;60;2143
53;Bretagne;56;2;13;082;Helléan;384;7;391
53;Bretagne;56;1;06;083;Hennebont;16062;405;16467
53;Bretagne;56;3;18;084;Le Hézo;852;13;865
53;Bretagne;56;1;17;085;Hœdic;94;6;100
53;Bretagne;56;1;17;086;Île-d'Houat;216;6;222
53;Bretagne;56;3;20;087;Île-aux-Moines;620;18;638
53;Bretagne;56;3;20;088;Île-d'Arz;227;8;235
53;Bretagne;56;1;05;089;Inguiniel;2185;58;2243
53;Bretagne;56;1;05;090;Inzinzac-Lochrist;6548;135;6683
53;Bretagne;56;2;13;091;Josselin;2482;95;2577
53;Bretagne;56;2;15;092;Kerfourn;833;15;848
53;Bretagne;56;2;02;093;Kergrist;720;26;746
53;Bretagne;56;1;06;094;Kervignac;6786;216;7002
53;Bretagne;56;1;14;096;Landaul;2392;51;2443
53;Bretagne;56;1;14;097;Landévant;3961;70;4031
53;Bretagne;56;1;07;098;Lanester;23124;475;23599
53;Bretagne;56;2;02;099;Langoëlan;378;6;384
53;Bretagne;56;2;02;100;Langonnet;1724;58;1782
53;Bretagne;56;1;06;101;Languidic;8064;151;8215
53;Bretagne;56;2;13;102;Forges de Lanouée;2165;49;2214
53;Bretagne;56;2;13;103;Lantillac;299;4;303
53;Bretagne;56;1;05;104;Lanvaudan;801;11;812
53;Bretagne;56;2;02;105;Lanvénégen;1144;23;1167
53;Bretagne;56;3;20;106;Larmor-Baden;874;18;892
53;Bretagne;56;1;12;107;Larmor-Plage;8319;243;8562
53;Bretagne;56;3;16;108;Larré;1067;21;1088
53;Bretagne;56;3;16;109;Lauzach;1167;27;1194
53;Bretagne;56;2;02;110;Lignol;846;21;867
53;Bretagne;56;3;16;111;Limerzel;1312;22;1334
53;Bretagne;56;3;10;112;Lizio;736;15;751
53;Bretagne;56;2;02;113;Locmalo;903;20;923
53;Bretagne;56;1;17;114;Locmaria;931;30;961
53;Bretagne;56;3;03;115;Locmaria-Grand-Champ;1708;39;1747
53;Bretagne;56;1;01;116;Locmariaquer;1552;45;1597
53;Bretagne;56;2;03;117;Locminé;4505;238;4743
53;Bretagne;56;1;06;118;Locmiquélic;4039;112;4151
53;Bretagne;56;1;17;119;Locoal-Mendon;3464;63;3527
53;Bretagne;56;3;03;120;Locqueltas;1885;40;1925
53;Bretagne;56;1;98;121;Lorient;57246;1486;58732
53;Bretagne;56;2;13;122;Loyat;1621;42;1663
53;Bretagne;56;3;16;123;Malansac;2195;43;2238
53;Bretagne;56;3;10;124;Malestroit;2470;78;2548
53;Bretagne;56;2;02;125;Malguénac;1841;66;1907
53;Bretagne;56;3;11;126;Marzan;2421;28;2449
53;Bretagne;56;2;13;127;Mauron;3145;71;3216
53;Bretagne;56;2;15;128;Melrand;1521;27;1548
53;Bretagne;56;2;13;129;Ménéac;1532;36;1568
53;Bretagne;56;1;14;130;Merlevenez;3238;70;3308
53;Bretagne;56;2;02;131;Meslan;1417;31;1448
53;Bretagne;56;3;21;132;Meucon;2262;53;2315
53;Bretagne;56;3;10;133;Missiriac;1155;27;1182
53;Bretagne;56;2;13;134;Mohon;979;11;990
53;Bretagne;56;3;16;135;Molac;1605;29;1634
53;Bretagne;56;3;04;136;Monteneuf;756;15;771
53;Bretagne;56;3;21;137;Monterblanc;3299;78;3377
53;Bretagne;56;2;13;139;Montertelot;360;10;370
53;Bretagne;56;2;10;140;Moréac;3733;94;3827
53;Bretagne;56;2;03;141;Moustoir-Ac;1733;37;1770
53;Bretagne;56;3;11;143;Muzillac;5066;126;5192
53;Bretagne;56;2;03;144;Évellys;3483;63;3546
53;Bretagne;56;2;13;145;Néant-sur-Yvel;1109;27;1136
53;Bretagne;56;2;02;146;Neulliac;1390;49;1439
53;Bretagne;56;3;11;147;Nivillac;4677;85;4762
53;Bretagne;56;1;14;148;Nostang;1576;32;1608
53;Bretagne;56;3;11;149;Noyal-Muzillac;2520;52;2572
53;Bretagne;56;2;15;151;Noyal-Pontivy;3605;116;3721
53;Bretagne;56;1;17;152;Le Palais;2544;54;2598
53;Bretagne;56;3;11;153;Péaule;2712;43;2755
53;Bretagne;56;3;04;154;Peillac;1847;50;1897
53;Bretagne;56;3;11;155;Pénestin;2019;26;2045
53;Bretagne;56;2;02;156;Persquen;351;6;357
53;Bretagne;56;3;03;157;Plaudren;1953;55;2008
53;Bretagne;56;3;20;158;Plescop;6145;178;6323
53;Bretagne;56;3;10;159;Pleucadeuc;1820;43;1863
53;Bretagne;56;2;03;160;Pleugriffet;1297;22;1319
53;Bretagne;56;1;17;161;Ploemel;2988;89;3077
53;Bretagne;56;1;12;162;Ploemeur;17778;639;18417
53;Bretagne;56;2;02;163;Ploërdut;1209;26;1235
53;Bretagne;56;3;20;164;Ploeren;6635;222;6857
53;Bretagne;56;2;13;165;Ploërmel;9791;564;10355
53;Bretagne;56;1;05;166;Plouay;5792;128;5920
53;Bretagne;56;3;20;167;Plougoumelen;2522;82;2604
53;Bretagne;56;1;17;168;Plouharnel;2214;48;2262
53;Bretagne;56;1;14;169;Plouhinec;5386;125;5511
53;Bretagne;56;2;02;170;Plouray;1062;32;1094
53;Bretagne;56;3;16;171;Pluherlin;1532;26;1558
53;Bretagne;56;2;10;172;Plumelec;2679;79;2758
53;Bretagne;56;2;15;173;Pluméliau-Bieuzy;4355;97;4452
53;Bretagne;56;2;03;174;Plumelin;2770;70;2840
53;Bretagne;56;1;01;175;Plumergat;4178;94;4272
53;Bretagne;56;1;01;176;Pluneret;5905;140;6045
53;Bretagne;56;1;14;177;Pluvigner;7676;141;7817
53;Bretagne;56;2;15;178;Pontivy;15064;934;15998
53;Bretagne;56;1;05;179;Pont-Scorff;3844;85;3929
53;Bretagne;56;3;04;180;Porcaro;729;16;745
53;Bretagne;56;1;06;181;Port-Louis;2654;100;2754
53;Bretagne;56;2;02;182;Priziac;967;181;1148
53;Bretagne;56;3;16;184;Questembert;7862;274;8136
53;Bretagne;56;1;12;185;Quéven;8770;238;9008
53;Bretagne;56;1;17;186;Quiberon;4658;91;4749
53;Bretagne;56;1;05;188;Quistinic;1416;23;1439
53;Bretagne;56;2;03;189;Radenac;1067;16;1083
53;Bretagne;56;2;03;190;Réguiny;1964;52;2016
53;Bretagne;56;3;04;191;Réminiac;411;10;421
53;Bretagne;56;1;06;193;Riantec;5821;144;5965
53;Bretagne;56;3;04;194;Rieux;2865;74;2939
53;Bretagne;56;3;11;195;La Roche-Bernard;701;11;712
53;Bretagne;56;3;16;196;Rochefort-en-Terre;641;13;654
53;Bretagne;56;2;10;197;Val d'Oust;2758;75;2833
53;Bretagne;56;2;03;198;Rohan;1636;44;1680
53;Bretagne;56;2;02;199;Roudouallec;705;14;719
53;Bretagne;56;3;10;200;Ruffiac;1385;34;1419
53;Bretagne;56;2;02;201;Le Saint;579;11;590
53;Bretagne;56;3;10;202;Saint-Abraham;529;14;543
53;Bretagne;56;2;02;203;Saint-Aignan;631;14;645
53;Bretagne;56;2;10;204;Saint-Allouestre;632;8;640
53;Bretagne;56;3;18;205;Saint-Armel;873;18;891
53;Bretagne;56;3;21;206;Saint-Avé;11895;303;12198
53;Bretagne;56;2;15;207;Saint-Barthélemy;1160;17;1177
53;Bretagne;56;2;13;208;Saint-Brieuc-de-Mauron;304;10;314
53;Bretagne;56;2;02;209;Sainte-Brigitte;179;7;186
53;Bretagne;56;2;02;210;Saint-Caradec-Trégomel;480;6;486
53;Bretagne;56;3;10;211;Saint-Congard;795;17;812
53;Bretagne;56;3;11;212;Saint-Dolay;2539;42;2581
53;Bretagne;56;2;15;213;Saint-Gérand;1144;30;1174
53;Bretagne;56;3;18;214;Saint-Gildas-de-Rhuys;1531;24;1555
53;Bretagne;56;2;15;215;Saint-Gonnery;1106;25;1131
53;Bretagne;56;3;04;216;Saint-Gorgon;393;4;397
53;Bretagne;56;3;16;218;Saint-Gravé;716;5;721
53;Bretagne;56;3;10;219;Saint-Guyomard;1389;22;1411
53;Bretagne;56;1;14;220;Sainte-Hélène;1262;30;1292
53;Bretagne;56;3;04;221;Saint-Jacut-les-Pins;1747;83;1830
53;Bretagne;56;2;10;222;Saint-Jean-Brévelay;2836;140;2976
53;Bretagne;56;3;04;223;Saint-Jean-la-Poterie;1469;59;1528
53;Bretagne;56;3;10;224;Saint-Laurent-sur-Oust;381;10;391
53;Bretagne;56;2;13;225;Saint-Léry;202;8;210
53;Bretagne;56;3;04;226;Saint-Malo-de-Beignon;532;23;555
53;Bretagne;56;2;13;227;Saint-Malo-des-Trois-Fontaines;584;14;598
53;Bretagne;56;3;10;228;Saint-Marcel;1106;48;1154
53;Bretagne;56;3;04;229;Saint-Martin-sur-Oust;1294;19;1313
53;Bretagne;56;3;10;230;Saint-Nicolas-du-Tertre;470;11;481
53;Bretagne;56;3;21;231;Saint-Nolff;3847;123;3970
53;Bretagne;56;3;04;232;Saint-Perreux;1074;41;1115
53;Bretagne;56;1;01;233;Saint-Philibert;1495;43;1538
53;Bretagne;56;1;17;234;Saint-Pierre-Quiberon;2056;39;2095
53;Bretagne;56;2;13;236;Saint-Servant;812;18;830
53;Bretagne;56;2;15;237;Saint-Thuriau;1865;77;1942
53;Bretagne;56;2;02;238;Saint-Tugdual;369;9;378
53;Bretagne;56;3;04;239;Saint-Vincent-sur-Oust;1563;42;1605
53;Bretagne;56;3;18;240;Sarzeau;8791;177;8968
53;Bretagne;56;1;17;241;Sauzon;996;24;1020
53;Bretagne;56;2;02;242;Séglien;652;18;670
53;Bretagne;56;3;18;243;Séné;8900;255;9155
53;Bretagne;56;3;10;244;Sérent;3066;40;3106
53;Bretagne;56;2;02;245;Silfiac;463;14;477
53;Bretagne;56;2;15;246;Le Sourn;2104;44;2148
53;Bretagne;56;3;16;247;Sulniac;3756;90;3846
53;Bretagne;56;3;18;248;Surzur;4724;96;4820
53;Bretagne;56;2;13;249;Taupont;2191;87;2278
53;Bretagne;56;3;04;250;Théhillac;604;5;609
53;Bretagne;56;3;18;251;Theix-Noyalo;8251;236;8487
53;Bretagne;56;3;18;252;Le Tour-du-Parc;1210;8;1218
53;Bretagne;56;3;04;253;Tréal;640;25;665
53;Bretagne;56;3;16;254;Trédion;1308;19;1327
53;Bretagne;56;3;21;255;Treffléan;2406;56;2462
53;Bretagne;56;2;13;256;Tréhorenteuc;116;0;116
53;Bretagne;56;2;13;257;La Trinité-Porhoët;671;17;688
53;Bretagne;56;1;17;258;La Trinité-sur-Mer;1622;47;1669
53;Bretagne;56;3;18;259;La Trinité-Surzur;1687;22;1709
53;Bretagne;56;3;99;260;Vannes;53719;1973;55692
53;Bretagne;56;3;16;261;La Vraie-Croix;1489;30;1519
53;Bretagne;56;3;20;262;Bono;2533;43;2576
53;Bretagne;56;1;01;263;Sainte-Anne-d'Auray;2770;126;2896
53;Bretagne;56;2;02;264;Kernascléden;384;10;394
44;Grand Est;57;7;14;001;Aboncourt;330;3;333
44;Grand Est;57;5;23;002;Aboncourt-sur-Seille;70;1;71
44;Grand Est;57;5;17;003;Abreschviller;1400;20;1420
44;Grand Est;57;5;23;004;Achain;79;1;80
44;Grand Est;57;6;02;006;Achen;991;28;1019
44;Grand Est;57;3;07;007;Adaincourt;124;2;126
44;Grand Est;57;3;07;008;Adelange;204;7;211
44;Grand Est;57;5;23;009;Ajoncourt;104;1;105
44;Grand Est;57;5;23;010;Alaincourt-la-Côte;156;2;158
44;Grand Est;57;5;23;011;Albestroff;618;23;641
44;Grand Est;57;7;01;012;Algrange;6120;56;6176
44;Grand Est;57;3;25;013;Alsting;2535;51;2586
44;Grand Est;57;3;20;014;Altrippe;370;7;377
44;Grand Est;57;3;19;015;Altviller;577;7;584
44;Grand Est;57;3;04;016;Alzing;389;8;397
44;Grand Est;57;9;18;017;Amanvillers;2098;23;2121
44;Grand Est;57;5;23;018;Amelécourt;132;8;140
44;Grand Est;57;9;18;019;Amnéville;10416;72;10488
44;Grand Est;57;9;07;020;Ancerville;305;3;308
44;Grand Est;57;9;05;021;Ancy-Dornot;1518;30;1548
44;Grand Est;57;7;01;022;Angevillers;1253;29;1282
44;Grand Est;57;9;16;024;Antilly;184;0;184
44;Grand Est;57;3;04;025;Anzeling;527;7;534
44;Grand Est;57;7;04;026;Apach;1070;18;1088
44;Grand Est;57;3;07;027;Arraincourt;126;3;129
44;Grand Est;57;9;16;028;Argancy;1339;39;1378
44;Grand Est;57;3;07;029;Arriance;215;3;218
44;Grand Est;57;9;05;030;Arry;565;3;568
44;Grand Est;57;9;16;031;Ars-Laquenexy;899;15;914
44;Grand Est;57;9;05;032;Ars-sur-Moselle;4704;53;4757
44;Grand Est;57;5;17;033;Arzviller;537;15;552
44;Grand Est;57;5;17;034;Aspach;35;1;36
44;Grand Est;57;5;21;035;Assenoncourt;117;3;120
44;Grand Est;57;5;23;036;Attilloncourt;103;0;103
44;Grand Est;57;9;07;037;Aube;269;5;274
44;Grand Est;57;7;01;038;Audun-le-Tiche;7048;63;7111
44;Grand Est;57;9;05;039;Augny;2165;34;2199
44;Grand Est;57;5;23;040;Aulnois-sur-Seille;278;2;280
44;Grand Est;57;7;01;041;Aumetz;2351;33;2384
44;Grand Est;57;5;21;042;Avricourt;593;12;605
44;Grand Est;57;9;16;043;Ay-sur-Moselle;1469;31;1500
44;Grand Est;57;5;21;044;Azoudange;123;5;128
44;Grand Est;57;5;23;045;Bacourt;109;1;110
44;Grand Est;57;6;02;046;Baerenthal;763;14;777
44;Grand Est;57;3;07;047;Bambiderstroff;1055;20;1075
44;Grand Est;57;3;03;048;Bannay;73;2;75
44;Grand Est;57;9;15;049;Le Ban-Saint-Martin;4517;72;4589
44;Grand Est;57;5;17;050;Barchain;112;2;114
44;Grand Est;57;3;20;051;Baronville;368;4;372
44;Grand Est;57;3;09;052;Barst;576;9;585
44;Grand Est;57;5;23;053;Bassing;111;6;117
44;Grand Est;57;5;23;054;Baudrecourt;188;0;188
44;Grand Est;57;9;16;055;Bazoncourt;536;3;539
44;Grand Est;57;5;21;056;Bébing;194;5;199
44;Grand Est;57;9;07;057;Béchy;608;6;614
44;Grand Est;57;3;25;058;Behren-lès-Forbach;6562;65;6627
44;Grand Est;57;5;23;059;Bellange;51;2;53
44;Grand Est;57;5;23;060;Bénestroff;532;7;539
44;Grand Est;57;3;09;061;Béning-lès-Saint-Avold;1152;26;1178
44;Grand Est;57;7;27;062;Berg-sur-Moselle;432;14;446
44;Grand Est;57;3;20;063;Bérig-Vintrange;216;8;224
44;Grand Est;57;5;17;064;Berling;261;4;265
44;Grand Est;57;5;23;065;Bermering;220;6;226
44;Grand Est;57;5;21;066;Berthelming;514;8;522
44;Grand Est;57;7;14;067;Bertrange;2801;59;2860
44;Grand Est;57;3;04;069;Berviller-en-Moselle;463;7;470
44;Grand Est;57;3;03;070;Bettange;248;2;250
44;Grand Est;57;5;21;071;Bettborn;387;5;392
44;Grand Est;57;7;14;072;Bettelainville;622;8;630
44;Grand Est;57;3;09;073;Betting;870;16;886
44;Grand Est;57;6;02;074;Bettviller;824;17;841
44;Grand Est;57;9;07;075;Beux;293;3;296
44;Grand Est;57;7;27;076;Beyren-lès-Sierck;508;17;525
44;Grand Est;57;5;23;077;Bezange-la-Petite;97;3;100
44;Grand Est;57;3;04;079;Bibiche;445;9;454
44;Grand Est;57;5;21;080;Bickenholtz;83;0;83
44;Grand Est;57;5;23;081;Bidestroff;131;1;132
44;Grand Est;57;3;20;082;Biding;331;7;338
44;Grand Est;57;6;02;083;Bining;1211;26;1237
44;Grand Est;57;5;23;084;Bioncourt;303;2;305
44;Grand Est;57;3;03;085;Bionville-sur-Nied;384;2;386
44;Grand Est;57;5;21;086;Belles-Forêts;235;5;240
44;Grand Est;57;3;03;087;Bisten-en-Lorraine;248;4;252
44;Grand Est;57;3;20;088;Bistroff;313;7;320
44;Grand Est;57;6;02;089;Bitche;4951;101;5052
44;Grand Est;57;5;23;090;Blanche-Église;111;2;113
44;Grand Est;57;6;22;091;Bliesbruck;1010;21;1031
44;Grand Est;57;6;22;092;Blies-Ébersing;619;8;627
44;Grand Est;57;6;22;093;Blies-Guersviller;646;12;658
44;Grand Est;57;3;07;095;Boucheporn;578;9;587
44;Grand Est;57;7;01;096;Boulange;2476;25;2501
44;Grand Est;57;3;03;097;Boulay-Moselle;5580;71;5651
44;Grand Est;57;5;23;098;Bourgaltroff;239;13;252
44;Grand Est;57;5;23;099;Bourdonnay;230;5;235
44;Grand Est;57;5;17;100;Bourscheid;174;5;179
44;Grand Est;57;3;25;101;Bousbach;1248;24;1272
44;Grand Est;57;7;14;102;Bousse;3205;48;3253
44;Grand Est;57;6;02;103;Bousseviller;125;4;129
44;Grand Est;57;7;27;104;Boust;1180;28;1208
44;Grand Est;57;3;20;105;Boustroff;150;1;151
44;Grand Est;57;3;04;106;Bouzonville;3926;78;4004
44;Grand Est;57;5;23;107;Bréhain;106;0;106
44;Grand Est;57;6;02;108;Breidenbach;318;5;323
44;Grand Est;57;7;27;109;Breistroff-la-Grande;761;12;773
44;Grand Est;57;3;04;110;Brettnach;430;2;432
44;Grand Est;57;9;18;111;Bronvaux;525;3;528
44;Grand Est;57;3;03;112;Brouck;85;1;86
44;Grand Est;57;5;17;113;Brouderdorff;972;22;994
44;Grand Est;57;5;17;114;Brouviller;425;15;440
44;Grand Est;57;3;20;115;Brulange;96;4;100
44;Grand Est;57;9;07;116;Buchy;95;1;96
44;Grand Est;57;7;14;117;Buding;588;5;593
44;Grand Est;57;7;14;118;Budling;167;6;173
44;Grand Est;57;5;21;119;Buhl-Lorraine;1191;31;1222
44;Grand Est;57;5;23;120;Burlioncourt;123;3;126
44;Grand Est;57;9;16;121;Burtoncourt;212;5;217
44;Grand Est;57;3;09;122;Cappel;685;11;696
44;Grand Est;57;3;19;123;Carling;3415;44;3459
44;Grand Est;57;7;27;124;Cattenom;2628;34;2662
44;Grand Est;57;9;16;125;Chailly-lès-Ennery;420;7;427
44;Grand Est;57;5;23;126;Chambrey;325;10;335
44;Grand Est;57;9;07;127;Chanville;147;1;148
44;Grand Est;57;9;16;128;Charleville-sous-Bois;321;3;324
44;Grand Est;57;9;16;129;Charly-Oradour;672;21;693
44;Grand Est;57;5;23;130;Château-Bréhain;75;1;76
44;Grand Est;57;3;04;131;Château-Rouge;286;11;297
44;Grand Est;57;5;23;132;Château-Salins;2357;244;2601
44;Grand Est;57;5;23;133;Château-Voué;96;0;96
44;Grand Est;57;9;05;134;Châtel-Saint-Germain;1916;193;2109
44;Grand Est;57;3;04;136;Chémery-les-Deux;570;17;587
44;Grand Est;57;9;07;137;Cheminot;812;14;826
44;Grand Est;57;5;23;138;Chenois;83;3;86
44;Grand Est;57;9;07;139;Chérisey;291;6;297
44;Grand Est;57;9;16;140;Chesny;577;10;587
44;Grand Est;57;5;23;141;Chicourt;91;0;91
44;Grand Est;57;9;16;142;Chieulles;423;7;430
44;Grand Est;57;7;10;143;Clouange;3374;33;3407
44;Grand Est;57;3;08;144;Cocheren;3380;42;3422
44;Grand Est;57;9;16;145;Coincy;326;5;331
44;Grand Est;57;9;05;146;Coin-lès-Cuvry;796;19;815
44;Grand Est;57;9;05;147;Coin-sur-Seille;338;14;352
44;Grand Est;57;9;16;148;Colligny-Maizery;567;11;578
44;Grand Est;57;3;04;149;Colmen;200;4;204
44;Grand Est;57;3;03;150;Condé-Northen;691;8;699
44;Grand Est;57;5;23;151;Conthil;153;2;155
44;Grand Est;57;7;04;152;Contz-les-Bains;510;10;520
44;Grand Est;57;9;05;153;Corny-sur-Moselle;2185;39;2224
44;Grand Est;57;3;03;154;Coume;634;19;653
44;Grand Est;57;9;16;155;Courcelles-Chaussy;3006;325;3331
44;Grand Est;57;9;16;156;Courcelles-sur-Nied;1172;11;1183
44;Grand Est;57;5;23;158;Craincourt;246;1;247
44;Grand Est;57;3;07;159;Créhange;3871;56;3927
44;Grand Est;57;3;03;160;Creutzwald;13042;216;13258
44;Grand Est;57;5;23;161;Cutting;116;1;117
44;Grand Est;57;9;05;162;Cuvry;864;14;878
44;Grand Est;57;5;17;163;Dabo;2430;47;2477
44;Grand Est;57;3;04;165;Dalem;690;9;699
44;Grand Est;57;5;23;166;Dalhain;107;2;109
44;Grand Est;57;3;04;167;Dalstein;371;6;377
44;Grand Est;57;5;17;168;Danne-et-Quatre-Vents;679;16;695
44;Grand Est;57;5;17;169;Dannelbourg;497;16;513
44;Grand Est;57;5;23;171;Delme;1148;9;1157
44;Grand Est;57;3;03;172;Denting;282;1;283
44;Grand Est;57;5;21;173;Desseling;101;3;104
44;Grand Est;57;3;20;174;Destry;96;1;97
44;Grand Est;57;5;21;175;Diane-Capelle;221;6;227
44;Grand Est;57;3;25;176;Diebling;1680;41;1721
44;Grand Est;57;5;23;177;Dieuze;2800;232;3032
44;Grand Est;57;3;20;178;Diffembach-lès-Hellimer;346;6;352
44;Grand Est;57;7;14;179;Distroff;1828;33;1861
44;Grand Est;57;5;21;180;Dolving;345;7;352
44;Grand Est;57;5;23;181;Domnom-lès-Dieuze;78;1;79
44;Grand Est;57;5;23;182;Donjeux;96;3;99
44;Grand Est;57;5;23;183;Donnelay;189;2;191
44;Grand Est;57;3;04;186;Ébersviller;954;11;965
44;Grand Est;57;3;03;187;Éblange;367;6;373
44;Grand Est;57;6;02;188;Éguelshardt;419;77;496
44;Grand Est;57;3;20;189;Eincheville;222;2;224
44;Grand Est;57;3;07;190;Elvange;418;4;422
44;Grand Est;57;7;14;191;Elzange;705;8;713
44;Grand Est;57;6;02;192;Enchenberg;1239;33;1272
44;Grand Est;57;9;16;193;Ennery;2157;25;2182
44;Grand Est;57;7;27;194;Entrange;1242;37;1279
44;Grand Est;57;6;02;195;Epping;572;15;587
44;Grand Est;57;6;02;196;Erching;420;11;431
44;Grand Est;57;6;20;197;Ernestviller;513;5;518
44;Grand Est;57;3;20;198;Erstroff;193;3;196
44;Grand Est;57;7;27;199;Escherange;686;15;701
44;Grand Est;57;9;16;200;Les Étangs;399;10;409
44;Grand Est;57;6;02;201;Etting;725;13;738
44;Grand Est;57;3;25;202;Etzling;1161;17;1178
44;Grand Est;57;7;27;203;Évrange;228;4;232
44;Grand Est;57;9;16;204;Failly;530;10;540
44;Grand Est;57;3;04;205;Falck;2506;31;2537
44;Grand Est;57;7;06;206;Fameck;14442;157;14599
44;Grand Est;57;3;09;207;Farébersviller;5493;56;5549
44;Grand Est;57;3;25;208;Farschviller;1355;34;1389
44;Grand Est;57;3;07;209;Faulquemont;5154;84;5238
44;Grand Est;57;5;21;210;Fénétrange;686;17;703
44;Grand Est;57;9;18;211;Fèves;1179;12;1191
44;Grand Est;57;9;05;212;Féy;730;9;739
44;Grand Est;57;3;04;213;Filstroff;773;14;787
44;Grand Est;57;7;27;214;Fixem;414;7;421
44;Grand Est;57;7;04;215;Flastroff;324;4;328
44;Grand Est;57;5;21;216;Fleisheim;144;5;149
44;Grand Est;57;3;07;217;Flétrange;900;18;918
44;Grand Est;57;9;07;218;Fleury;1286;30;1316
44;Grand Est;57;9;16;219;Flévy;546;6;552
44;Grand Est;57;9;07;220;Flocourt;119;2;121
44;Grand Est;57;7;06;221;Florange;11972;93;12065
44;Grand Est;57;3;25;222;Folkling;1325;38;1363
44;Grand Est;57;3;19;224;Folschviller;3949;69;4018
44;Grand Est;57;5;23;225;Fonteny;140;0;140
44;Grand Est;57;7;01;226;Fontoy;3095;40;3135
44;Grand Est;57;3;08;227;Forbach;21597;290;21887
44;Grand Est;57;5;23;228;Fossieux;200;5;205
44;Grand Est;57;5;21;229;Foulcrey;156;3;159
44;Grand Est;57;3;07;230;Fouligny;195;2;197
44;Grand Est;57;9;23;231;Foville;99;0;99
44;Grand Est;57;5;23;232;Francaltroff;776;12;788
44;Grand Est;57;5;17;233;Fraquelfing;85;1;86
44;Grand Est;57;6;22;234;Frauenberg;597;8;605
44;Grand Est;57;3;04;235;Freistroff;1037;20;1057
44;Grand Est;57;5;23;236;Frémery;84;0;84
44;Grand Est;57;3;20;237;Frémestroff;304;7;311
44;Grand Est;57;5;23;238;Fresnes-en-Saulnois;190;6;196
44;Grand Est;57;3;20;239;Freybouse;432;6;438
44;Grand Est;57;3;09;240;Freyming-Merlebach;12725;120;12845
44;Grand Est;57;5;21;241;Fribourg;166;8;174
44;Grand Est;57;7;10;242;Gandrange;3028;35;3063
44;Grand Est;57;5;17;244;Garrebourg;491;11;502
44;Grand Est;57;7;27;245;Gavisse;570;9;579
44;Grand Est;57;5;23;246;Gelucourt;215;4;219
44;Grand Est;57;5;23;247;Gerbécourt;80;3;83
44;Grand Est;57;5;23;248;Givrycourt;87;1;88
44;Grand Est;57;9;16;249;Glatigny;259;7;266
44;Grand Est;57;6;02;250;Goetzenbruck;1494;40;1534
44;Grand Est;57;9;07;251;Goin;339;2;341
44;Grand Est;57;3;03;252;Gomelange;480;10;490
44;Grand Est;57;5;21;253;Gondrexange;501;3;504
44;Grand Est;57;9;05;254;Gorze;1157;10;1167
44;Grand Est;57;5;21;255;Gosselming;575;23;598
44;Grand Est;57;9;05;256;Gravelotte;827;4;831
44;Grand Est;57;5;23;257;Grémecey;105;0;105
44;Grand Est;57;3;20;258;Gréning;118;1;119
44;Grand Est;57;7;04;259;Grindorff-Bizing;319;7;326
44;Grand Est;57;6;22;260;Grosbliederstroff;3296;53;3349
44;Grand Est;57;6;02;261;Gros-Réderching;1350;40;1390
44;Grand Est;57;3;20;262;Grostenquin;647;7;654
44;Grand Est;57;6;20;263;Grundviller;642;19;661
44;Grand Est;57;6;20;264;Guebenhouse;411;6;417
44;Grand Est;57;5;23;265;Guébestroff;58;4;62
44;Grand Est;57;5;23;266;Guéblange-lès-Dieuze;150;4;154
44;Grand Est;57;6;20;267;Le Val-de-Guéblange;850;18;868
44;Grand Est;57;5;23;268;Guébling;123;4;127
44;Grand Est;57;7;14;269;Guénange;7559;67;7626
44;Grand Est;57;5;23;270;Val-de-Bride;583;13;596
44;Grand Est;57;3;09;271;Guenviller;667;17;684
44;Grand Est;57;5;21;272;Guermange;88;5;93
44;Grand Est;57;3;04;273;Guerstling;395;9;404
44;Grand Est;57;3;03;274;Guerting;856;20;876
44;Grand Est;57;3;20;275;Guessling-Hémering;919;12;931
44;Grand Est;57;3;07;276;Guinglange;328;5;333
44;Grand Est;57;3;03;277;Guinkirchen;149;6;155
44;Grand Est;57;5;23;278;Guinzeling;66;0;66
44;Grand Est;57;5;17;280;Guntzviller;370;20;390
44;Grand Est;57;5;23;281;Haboudange;246;5;251
44;Grand Est;57;7;27;282;Hagen;357;4;361
44;Grand Est;57;9;24;283;Hagondange;9287;105;9392
44;Grand Est;57;3;07;284;Hallering;113;5;118
44;Grand Est;57;7;04;286;Halstroff;305;9;314
44;Grand Est;57;7;14;287;Basse-Ham;2226;44;2270
44;Grand Est;57;3;03;288;Ham-sous-Varsberg;2848;40;2888
44;Grand Est;57;6;22;289;Hambach;2875;67;2942
44;Grand Est;57;5;23;290;Hampont;180;2;182
44;Grand Est;57;5;17;291;Hangviller;263;4;267
44;Grand Est;57;5;23;292;Hannocourt;20;0;20
44;Grand Est;57;3;07;293;Han-sur-Nied;258;6;264
44;Grand Est;57;6;02;294;Hanviller;198;8;206
44;Grand Est;57;5;23;295;Haraucourt-sur-Seille;106;1;107
44;Grand Est;57;3;04;296;Hargarten-aux-Mines;1096;20;1116
44;Grand Est;57;3;20;297;Harprich;183;6;189
44;Grand Est;57;5;17;298;Harreberg;382;7;389
44;Grand Est;57;5;17;299;Hartzviller;917;16;933
44;Grand Est;57;5;17;300;Haselbourg;330;7;337
44;Grand Est;57;6;02;301;Haspelschiedt;304;12;316
44;Grand Est;57;5;17;302;Hattigny;189;1;190
44;Grand Est;57;9;24;303;Hauconcourt;599;9;608
44;Grand Est;57;5;21;304;Haut-Clocher;355;11;366
44;Grand Est;57;7;01;305;Havange;451;8;459
44;Grand Est;57;7;10;306;Hayange;16005;186;16191
44;Grand Est;57;9;16;307;Hayes;249;5;254
44;Grand Est;57;6;20;308;Hazembourg;149;5;154
44;Grand Est;57;3;04;309;Heining-lès-Bouzonville;483;9;492
44;Grand Est;57;5;21;310;Hellering-lès-Fénétrange;190;4;194
44;Grand Est;57;3;20;311;Hellimer;527;9;536
44;Grand Est;57;3;03;312;Helstroff;506;8;514
44;Grand Est;57;3;07;313;Hémilly;141;3;144
44;Grand Est;57;5;17;314;Héming;496;3;499
44;Grand Est;57;5;17;315;Henridorff;712;15;727
44;Grand Est;57;3;09;316;Henriville;744;16;760
44;Grand Est;57;5;17;317;Hérange;108;4;112
44;Grand Est;57;5;17;318;Hermelange;215;5;220
44;Grand Est;57;3;07;319;Herny;521;5;526
44;Grand Est;57;5;21;320;Hertzing;183;3;186
44;Grand Est;57;5;17;321;Hesse;563;19;582
44;Grand Est;57;3;04;322;Hestroff;466;6;472
44;Grand Est;57;7;27;323;Hettange-Grande;7779;167;7946
44;Grand Est;57;5;21;324;Hilbesheim;617;22;639
44;Grand Est;57;6;20;325;Hilsprich;832;17;849
44;Grand Est;57;3;03;326;Hinckange;333;4;337
44;Grand Est;57;3;07;328;Holacourt;89;2;91
44;Grand Est;57;3;04;329;Holling;433;11;444
44;Grand Est;57;6;20;330;Holving;1283;21;1304
44;Grand Est;57;7;14;331;Hombourg-Budange;543;10;553
44;Grand Est;57;3;09;332;Hombourg-Haut;6283;61;6344
44;Grand Est;57;5;21;333;Hommarting;827;23;850
44;Grand Est;57;5;17;334;Hommert;324;10;334
44;Grand Est;57;5;23;335;Honskirch;221;4;225
44;Grand Est;57;3;19;336;L'Hôpital;5229;56;5285
44;Grand Est;57;3;09;337;Hoste;593;17;610
44;Grand Est;57;6;02;338;Hottviller;515;6;521
44;Grand Est;57;5;17;339;Hultehouse;367;6;373
44;Grand Est;57;6;22;340;Hundling;1345;20;1365
44;Grand Est;57;7;04;341;Hunting;707;16;723
44;Grand Est;57;5;21;342;Ibigny;96;1;97
44;Grand Est;57;7;27;343;Illange;1835;31;1866
44;Grand Est;57;5;21;344;Imling;734;9;743
44;Grand Est;57;7;14;345;Inglange;422;31;453
44;Grand Est;57;5;23;346;Insming;590;23;613
44;Grand Est;57;5;23;347;Insviller;174;3;177
44;Grand Est;57;6;22;348;Ippling;797;17;814
44;Grand Est;57;5;23;349;Jallaucourt;154;3;157
44;Grand Est;57;9;05;350;Jouy-aux-Arches;1438;20;1458
44;Grand Est;57;9;16;351;Jury;1223;19;1242
44;Grand Est;57;9;05;352;Jussy;445;15;460
44;Grand Est;57;5;23;353;Juvelize;72;1;73
44;Grand Est;57;5;23;354;Juville;122;5;127
44;Grand Est;57;6;22;355;Kalhausen;806;17;823
44;Grand Est;57;7;27;356;Kanfen;1198;22;1220
44;Grand Est;57;6;20;357;Kappelkinger;404;2;406
44;Grand Est;57;7;14;358;Kédange-sur-Canner;1080;22;1102
44;Grand Est;57;7;14;359;Kemplich;170;4;174
44;Grand Est;57;3;25;360;Kerbach;1199;33;1232
44;Grand Est;57;7;04;361;Kerling-lès-Sierck;598;17;615
44;Grand Est;57;5;21;362;Kerprich-aux-Bois;174;3;177
44;Grand Est;57;7;04;364;Kirsch-lès-Sierck;312;7;319
44;Grand Est;57;7;04;365;Kirschnaumen;474;11;485
44;Grand Est;57;6;20;366;Kirviller;139;2;141
44;Grand Est;57;7;14;367;Klang;225;4;229
44;Grand Est;57;7;01;368;Knutange;3192;59;3251
44;Grand Est;57;7;14;370;Kœnigsmacker;2256;39;2295
44;Grand Est;57;7;04;371;Haute-Kontz;584;7;591
44;Grand Est;57;7;14;372;Kuntzig;1357;15;1372
44;Grand Est;57;3;19;373;Lachambre;932;27;959
44;Grand Est;57;5;17;374;Lafrimbolle;198;6;204
44;Grand Est;57;5;23;375;Lagarde;186;1;187
44;Grand Est;57;6;02;376;Lambach;504;6;510
44;Grand Est;57;5;17;377;Landange;243;4;247
44;Grand Est;57;3;20;379;Landroff;273;2;275
44;Grand Est;57;5;17;380;Laneuveville-lès-Lorquin;106;3;109
44;Grand Est;57;5;23;381;Laneuveville-en-Saulnois;292;6;298
44;Grand Est;57;5;21;382;Langatte;557;6;563
44;Grand Est;57;5;21;383;Languimberg;164;6;170
44;Grand Est;57;3;20;384;Laning;620;18;638
44;Grand Est;57;9;16;385;Laquenexy;1220;22;1242
44;Grand Est;57;3;07;386;Laudrefang;345;7;352
44;Grand Est;57;7;04;387;Laumesfeld;290;1;291
44;Grand Est;57;7;04;388;Launstroff;267;4;271
44;Grand Est;57;3;20;389;Lelling;471;12;483
44;Grand Est;57;6;02;390;Lemberg;1432;38;1470
44;Grand Est;57;5;23;391;Lemoncourt;65;1;66
44;Grand Est;57;9;07;392;Lemud;527;4;531
44;Grand Est;57;6;02;393;Lengelsheim;206;3;209
44;Grand Est;57;5;23;394;Léning;340;12;352
44;Grand Est;57;5;23;395;Lesse;204;4;208
44;Grand Est;57;9;05;396;Lessy;736;28;764
44;Grand Est;57;5;23;397;Ley;102;1;103
44;Grand Est;57;3;20;398;Leyviller;502;8;510
44;Grand Est;57;5;23;399;Lezey;94;8;102
44;Grand Est;57;5;23;401;Lidrezing;85;1;86
44;Grand Est;57;6;02;402;Liederschiedt;120;4;124
44;Grand Est;57;9;07;403;Liéhon;123;0;123
44;Grand Est;57;5;23;404;Lindre-Basse;209;7;216
44;Grand Est;57;5;23;405;Lindre-Haute;53;1;54
44;Grand Est;57;5;23;406;Liocourt;138;7;145
44;Grand Est;57;5;17;407;Lixheim;591;6;597
44;Grand Est;57;6;22;408;Lixing-lès-Rouhling;877;19;896
44;Grand Est;57;3;20;409;Lixing-lès-Saint-Avold;673;15;688
44;Grand Est;57;5;23;410;Lhor;137;3;140
44;Grand Est;57;7;01;411;Lommerange;334;1;335
44;Grand Est;57;9;15;412;Longeville-lès-Metz;3955;64;4019
44;Grand Est;57;3;07;413;Longeville-lès-Saint-Avold;3651;84;3735
44;Grand Est;57;5;17;414;Lorquin;1147;26;1173
44;Grand Est;57;9;05;415;Lorry-lès-Metz;1748;76;1824
44;Grand Est;57;9;05;416;Lorry-Mardigny;657;17;674
44;Grand Est;57;5;23;417;Lostroff;68;0;68
44;Grand Est;57;5;23;418;Loudrefing;322;4;326
44;Grand Est;57;6;20;419;Loupershouse;904;23;927
44;Grand Est;57;6;02;421;Loutzviller;153;3;156
44;Grand Est;57;9;07;422;Louvigny;880;11;891
44;Grand Est;57;5;23;423;Lubécourt;75;0;75
44;Grand Est;57;5;23;424;Lucy;233;2;235
44;Grand Est;57;9;07;425;Luppy;573;4;577
44;Grand Est;57;7;14;426;Luttange;896;8;904
44;Grand Est;57;5;17;427;Lutzelbourg;568;10;578
44;Grand Est;57;3;19;428;Macheren;2753;67;2820
44;Grand Est;57;3;07;430;Mainvillers;330;5;335
44;Grand Est;57;9;16;431;Maizeroy;401;3;404
44;Grand Est;57;9;24;433;Maizières-lès-Metz;11668;127;11795
44;Grand Est;57;5;23;434;Maizières-lès-Vic;488;9;497
44;Grand Est;57;5;23;436;Malaucourt-sur-Seille;127;6;133
44;Grand Est;57;7;04;437;Malling;631;15;646
44;Grand Est;57;9;16;438;Malroy;348;5;353
44;Grand Est;57;7;04;439;Manderen-Ritzing;602;13;615
44;Grand Est;57;5;23;440;Manhoué;142;3;145
44;Grand Est;57;7;27;441;Manom;2915;59;2974
44;Grand Est;57;3;07;442;Many;242;2;244
44;Grand Est;57;9;18;443;Marange-Silvange;6458;57;6515
44;Grand Est;57;3;07;444;Marange-Zondrange;351;2;353
44;Grand Est;57;9;05;445;Marieulles;701;9;710
44;Grand Est;57;5;23;446;Marimont-lès-Bénestroff;41;1;42
44;Grand Est;57;9;15;447;Marly;10108;231;10339
44;Grand Est;57;5;23;448;Marsal;257;6;263
44;Grand Est;57;9;16;449;Marsilly;598;6;604
44;Grand Est;57;5;23;451;Marthille;168;3;171
44;Grand Est;57;9;24;452;La Maxe;1011;16;1027
44;Grand Est;57;3;20;453;Maxstadt;298;10;308
44;Grand Est;57;9;16;454;Mécleuves;1139;24;1163
44;Grand Est;57;3;03;455;Mégange;149;3;152
44;Grand Est;57;6;02;456;Meisenthal;674;24;698
44;Grand Est;57;3;04;457;Menskirch;139;2;141
44;Grand Est;57;7;04;459;Merschweiller;286;2;288
44;Grand Est;57;3;04;460;Merten;1481;26;1507
44;Grand Est;57;5;17;461;Métairies-Saint-Quirin;273;8;281
44;Grand Est;57;5;17;462;Metting;419;7;426
44;Grand Est;57;9;98;463;Metz;118489;1846;120335
44;Grand Est;57;7;14;464;Metzeresche;968;28;996
44;Grand Est;57;7;14;465;Metzervisse;2264;53;2317
44;Grand Est;57;3;25;466;Metzing;659;10;669
44;Grand Est;57;9;16;467;Mey;294;2;296
44;Grand Est;57;5;17;468;Mittelbronn;689;10;699
44;Grand Est;57;5;21;469;Mittersheim;603;5;608
44;Grand Est;57;5;23;470;Molring;5;0;5
44;Grand Est;57;3;03;471;Momerstroff;297;3;300
44;Grand Est;57;9;23;472;Moncheux;148;0;148
44;Grand Est;57;5;23;473;Moncourt;67;2;69
44;Grand Est;57;7;06;474;Mondelange;5631;77;5708
44;Grand Est;57;7;27;475;Mondorff;525;14;539
44;Grand Est;57;7;14;476;Monneren;410;6;416
44;Grand Est;57;6;02;477;Montbronn;1621;43;1664
44;Grand Est;57;5;23;478;Montdidier;87;0;87
44;Grand Est;57;7;04;479;Montenach;465;12;477
44;Grand Est;57;9;15;480;Montigny-lès-Metz;21879;357;22236
44;Grand Est;57;9;18;481;Montois-la-Montagne;2732;18;2750
44;Grand Est;57;9;16;482;Ogy-Montoy-Flanville;1759;31;1790
44;Grand Est;57;3;20;483;Morhange;3408;84;3492
44;Grand Est;57;3;08;484;Morsbach;2684;29;2713
44;Grand Est;57;5;23;485;Morville-lès-Vic;124;2;126
44;Grand Est;57;5;23;486;Morville-sur-Nied;117;1;118
44;Grand Est;57;9;05;487;Moulins-lès-Metz;5007;61;5068
44;Grand Est;57;5;21;488;Moussey;562;9;571
44;Grand Est;57;6;02;489;Mouterhouse;302;6;308
44;Grand Est;57;5;23;490;Moyenvic;345;4;349
44;Grand Est;57;7;10;491;Moyeuvre-Grande;7506;65;7571
44;Grand Est;57;7;10;492;Moyeuvre-Petite;451;8;459
44;Grand Est;57;5;23;493;Mulcey;211;5;216
44;Grand Est;57;5;23;494;Munster;239;0;239
44;Grand Est;57;3;03;495;Narbéfontaine;116;1;117
44;Grand Est;57;5;23;496;Nébing;335;5;340
44;Grand Est;57;6;20;497;Nelling;263;9;272
44;Grand Est;57;7;01;498;Neufchef;2590;52;2642
44;Grand Est;57;6;22;499;Neufgrange;1357;30;1387
44;Grand Est;57;5;17;500;Neufmoulins;43;0;43
44;Grand Est;57;5;23;501;Neufvillage;36;0;36
44;Grand Est;57;3;04;502;Neunkirchen-lès-Bouzonville;330;12;342
44;Grand Est;57;5;17;504;Niderhoff;280;4;284
44;Grand Est;57;5;17;505;Niderviller;1211;22;1233
44;Grand Est;57;5;21;506;Niederstinzel;252;1;253
44;Grand Est;57;3;03;507;Niedervisse;266;2;268
44;Grand Est;57;7;01;508;Nilvange;4515;53;4568
44;Grand Est;57;5;17;509;Nitting;479;10;489
44;Grand Est;57;9;16;510;Noisseville;1072;10;1082
44;Grand Est;57;9;18;511;Norroy-le-Veneur;1033;21;1054
44;Grand Est;57;9;16;512;Nouilly;716;11;727
44;Grand Est;57;6;02;513;Nousseviller-lès-Bitche;150;1;151
44;Grand Est;57;3;25;514;Nousseviller-Saint-Nabor;1194;25;1219
44;Grand Est;57;9;05;515;Novéant-sur-Moselle;1823;24;1847
44;Grand Est;57;3;04;516;Oberdorff;337;10;347
44;Grand Est;57;6;02;517;Obergailbach;283;4;287
44;Grand Est;57;5;21;518;Oberstinzel;331;9;340
44;Grand Est;57;3;03;519;Obervisse;160;3;163
44;Grand Est;57;5;23;520;Obreck;33;2;35
44;Grand Est;57;3;08;521;Œting;2706;53;2759
44;Grand Est;57;5;23;524;Ommeray;128;1;129
44;Grand Est;57;5;23;525;Oriocourt;55;1;56
44;Grand Est;57;6;02;526;Ormersviller;383;1;384
44;Grand Est;57;9;07;527;Orny;356;4;360
44;Grand Est;57;5;23;528;Oron;101;1;102
44;Grand Est;57;7;01;529;Ottange;3099;65;3164
44;Grand Est;57;3;03;530;Ottonville;442;6;448
44;Grand Est;57;7;14;531;Oudrenne;743;13;756
44;Grand Est;57;9;07;532;Pagny-lès-Goin;229;3;232
44;Grand Est;57;9;16;533;Pange;874;18;892
44;Grand Est;57;9;16;534;Peltre;1842;124;1966
44;Grand Est;57;6;02;535;Petit-Réderching;1443;36;1479
44;Grand Est;57;3;20;536;Petit-Tenquin;221;5;226
44;Grand Est;57;3;08;537;Petite-Rosselle;6298;98;6396
44;Grand Est;57;5;23;538;Pettoncourt;295;2;297
44;Grand Est;57;5;23;539;Pévange;46;3;49
44;Grand Est;57;5;17;540;Phalsbourg;4729;240;4969
44;Grand Est;57;6;02;541;Philippsbourg;593;17;610
44;Grand Est;57;3;03;542;Piblange;974;11;985
44;Grand Est;57;9;18;543;Pierrevillers;1498;24;1522
44;Grand Est;57;5;17;544;Plaine-de-Walsch;615;16;631
44;Grand Est;57;9;15;545;Plappeville;2021;57;2078
44;Grand Est;57;9;18;546;Plesnois;811;31;842
44;Grand Est;57;9;07;547;Pommérieux;699;9;708
44;Grand Est;57;9;07;548;Pontoy;543;7;550
44;Grand Est;57;3;07;549;Pontpierre;733;14;747
44;Grand Est;57;3;19;550;Porcelette;2478;65;2543
44;Grand Est;57;5;21;551;Postroff;213;1;214
44;Grand Est;57;9;05;552;Pouilly;627;8;635
44;Grand Est;57;9;05;553;Pournoy-la-Chétive;630;4;634
44;Grand Est;57;9;07;554;Pournoy-la-Grasse;694;21;715
44;Grand Est;57;5;23;555;Prévocourt;111;0;111
44;Grand Est;57;6;20;556;Puttelange-aux-Lacs;3089;45;3134
44;Grand Est;57;7;27;557;Puttelange-lès-Thionville;1009;24;1033
44;Grand Est;57;5;23;558;Puttigny;80;0;80
44;Grand Est;57;5;23;559;Puzieux;176;0;176
44;Grand Est;57;3;20;560;Racrange;624;13;637
44;Grand Est;57;6;02;561;Rahling;737;19;756
44;Grand Est;57;7;10;562;Ranguevaux;847;18;865
44;Grand Est;57;9;16;563;Raville;256;2;258
44;Grand Est;57;5;21;564;Réchicourt-le-Château;557;15;572
44;Grand Est;57;7;01;565;Rédange;995;20;1015
44;Grand Est;57;5;21;566;Réding;2358;64;2422
44;Grand Est;57;3;04;567;Rémelfang;147;1;148
44;Grand Est;57;6;22;568;Rémelfing;1397;28;1425
44;Grand Est;57;7;04;569;Rémeling;320;6;326
44;Grand Est;57;3;04;570;Rémering;423;5;428
44;Grand Est;57;6;20;571;Rémering-lès-Puttelange;1049;31;1080
44;Grand Est;57;9;07;572;Rémilly;2006;101;2107
44;Grand Est;57;5;23;573;Réning;135;3;138
44;Grand Est;57;7;27;574;Basse-Rentgen;512;13;525
44;Grand Est;57;9;16;575;Retonfey;1357;29;1386
44;Grand Est;57;7;04;576;Rettel;770;65;835
44;Grand Est;57;6;02;577;Reyersviller;375;7;382
44;Grand Est;57;9;05;578;Rezonville-Vionville;496;6;502
44;Grand Est;57;5;21;579;Rhodes;128;1;129
44;Grand Est;57;5;23;580;Riche;187;2;189
44;Grand Est;57;6;20;581;Richeling;351;7;358
44;Grand Est;57;7;06;582;Richemont;2092;42;2134
44;Grand Est;57;5;21;583;Richeval;136;2;138
44;Grand Est;57;6;02;584;Rimling;652;17;669
44;Grand Est;57;7;01;586;Rochonvillers;186;2;188
44;Grand Est;57;5;23;587;Rodalbe;250;5;255
44;Grand Est;57;7;27;588;Rodemack;1265;32;1297
44;Grand Est;57;6;02;589;Rohrbach-lès-Bitche;2313;49;2362
44;Grand Est;57;6;02;590;Rolbing;256;6;262
44;Grand Est;57;9;18;591;Rombas;9861;99;9960
44;Grand Est;57;5;21;592;Romelfing;348;2;350
44;Grand Est;57;9;18;593;Roncourt;1018;10;1028
44;Grand Est;57;6;02;594;Roppeviller;98;3;101
44;Grand Est;57;5;23;595;Rorbach-lès-Dieuze;50;1;51
44;Grand Est;57;3;08;596;Rosbruck;747;11;758
44;Grand Est;57;7;10;597;Rosselange;2650;20;2670
44;Grand Est;57;6;22;598;Rouhling;2005;52;2057
44;Grand Est;57;3;03;599;Roupeldange;362;9;371
44;Grand Est;57;7;27;600;Roussy-le-Village;1408;24;1432
44;Grand Est;57;9;05;601;Rozérieulles;1343;42;1385
44;Grand Est;57;7;14;602;Rurange-lès-Thionville;2431;54;2485
44;Grand Est;57;7;01;603;Russange;1273;17;1290
44;Grand Est;57;7;04;604;Rustroff;624;6;630
44;Grand Est;57;9;23;605;Sailly-Achâtel;299;2;301
44;Grand Est;57;3;19;606;Saint-Avold;15415;352;15767
44;Grand Est;57;9;16;607;Sainte-Barbe;761;10;771
44;Grand Est;57;5;23;609;Saint-Epvre;174;2;176
44;Grand Est;57;3;04;610;Saint-François-Lacroix;303;6;309
44;Grand Est;57;5;21;611;Saint-Georges;191;6;197
44;Grand Est;57;9;16;612;Saint-Hubert;240;5;245
44;Grand Est;57;5;21;613;Saint-Jean-de-Bassel;357;3;360
44;Grand Est;57;5;17;614;Saint-Jean-Kourtzerode;709;4;713
44;Grand Est;57;6;20;615;Saint-Jean-Rohrbach;968;19;987
44;Grand Est;57;9;16;616;Saint-Julien-lès-Metz;3373;84;3457
44;Grand Est;57;9;23;617;Saint-Jure;284;6;290
44;Grand Est;57;5;17;618;Saint-Louis;653;20;673
44;Grand Est;57;6;02;619;Saint-Louis-lès-Bitche;472;10;482
44;Grand Est;57;9;18;620;Sainte-Marie-aux-Chênes;4350;61;4411
44;Grand Est;57;5;23;621;Saint-Médard;109;1;110
44;Grand Est;57;9;18;622;Saint-Privat-la-Montagne;1909;21;1930
44;Grand Est;57;5;17;623;Saint-Quirin;711;50;761
44;Grand Est;57;9;05;624;Sainte-Ruffine;584;31;615
44;Grand Est;57;5;23;625;Salonnes;178;2;180
44;Grand Est;57;9;16;626;Sanry-lès-Vigy;531;8;539
44;Grand Est;57;9;16;627;Sanry-sur-Nied;324;4;328
44;Grand Est;57;6;20;628;Sarralbe;4485;94;4579
44;Grand Est;57;5;21;629;Sarraltroff;777;6;783
44;Grand Est;57;5;21;630;Sarrebourg;12449;312;12761
44;Grand Est;57;6;22;631;Sarreguemines;20635;470;21105
44;Grand Est;57;6;22;633;Sarreinsming;1262;31;1293
44;Grand Est;57;9;18;634;Saulny;1507;39;1546
44;Grand Est;57;5;21;635;Schalbach;364;7;371
44;Grand Est;57;6;02;636;Schmittviller;316;12;328
44;Grand Est;57;5;17;637;Schneckenbusch;304;9;313
44;Grand Est;57;3;08;638;Schœneck;2491;40;2531
44;Grand Est;57;6;02;639;Schorbach;540;9;549
44;Grand Est;57;3;04;640;Schwerdorff;479;14;493
44;Grand Est;57;6;02;641;Schweyen;303;4;307
44;Grand Est;57;9;15;642;Scy-Chazelles;2675;53;2728
44;Grand Est;57;9;23;643;Secourt;199;6;205
44;Grand Est;57;3;09;644;Seingbouse;1753;42;1795
44;Grand Est;57;9;24;645;Semécourt;1021;9;1030
44;Grand Est;57;7;10;647;Serémange-Erzange;4163;57;4220
44;Grand Est;57;9;16;648;Servigny-lès-Raville;493;5;498
44;Grand Est;57;9;16;649;Servigny-lès-Sainte-Barbe;475;4;479
44;Grand Est;57;7;04;650;Sierck-les-Bains;1776;13;1789
44;Grand Est;57;6;02;651;Siersthal;648;6;654
44;Grand Est;57;9;07;652;Sillegny;552;6;558
44;Grand Est;57;9;07;653;Silly-en-Saulnois;33;2;35
44;Grand Est;57;9;16;654;Silly-sur-Nied;693;11;704
44;Grand Est;57;9;07;655;Solgne;1119;57;1176
44;Grand Est;57;9;16;656;Sorbey;382;7;389
44;Grand Est;57;5;23;657;Sotzeling;19;0;19
44;Grand Est;57;6;02;658;Soucht;1053;20;1073
44;Grand Est;57;3;25;659;Spicheren;3232;56;3288
44;Grand Est;57;3;25;660;Stiring-Wendel;11178;126;11304
44;Grand Est;57;6;02;661;Sturzelbronn;174;3;177
44;Grand Est;57;3;20;662;Suisse;100;5;105
44;Grand Est;57;9;24;663;Talange;7781;187;7968
44;Grand Est;57;5;23;664;Tarquimpol;61;2;63
44;Grand Est;57;3;25;665;Tenteling;1060;19;1079
44;Grand Est;57;7;26;666;Terville;7134;90;7224
44;Grand Est;57;3;03;667;Téterchen;790;8;798
44;Grand Est;57;3;07;668;Teting-sur-Nied;1280;35;1315
44;Grand Est;57;3;25;669;Théding;2473;44;2517
44;Grand Est;57;3;07;670;Thicourt;135;1;136
44;Grand Est;57;9;07;671;Thimonville;154;0;154
44;Grand Est;57;7;99;672;Thionville;40778;756;41534
44;Grand Est;57;3;07;673;Thonville;47;0;47
44;Grand Est;57;5;23;674;Tincry;174;5;179
44;Grand Est;57;5;23;675;Torcheville;115;1;116
44;Grand Est;57;9;07;676;Tragny;93;1;94
44;Grand Est;57;9;16;677;Trémery;1047;18;1065
44;Grand Est;57;7;01;678;Tressange;2220;35;2255
44;Grand Est;57;3;07;679;Tritteling-Redlach;533;4;537
44;Grand Est;57;5;17;680;Troisfontaines;1256;28;1284
44;Grand Est;57;3;04;681;Tromborn;338;5;343
44;Grand Est;57;5;17;682;Turquestein-Blancrupt;11;0;11
44;Grand Est;57;7;06;683;Uckange;6926;47;6973
44;Grand Est;57;3;20;684;Vahl-Ebersing;513;10;523
44;Grand Est;57;5;23;685;Vahl-lès-Bénestroff;151;2;153
44;Grand Est;57;3;07;686;Vahl-lès-Faulquemont;250;2;252
44;Grand Est;57;3;20;687;Vallerange;213;4;217
44;Grand Est;57;7;14;689;Valmestroff;314;5;319
44;Grand Est;57;3;19;690;Valmont;3019;66;3085
44;Grand Est;57;3;03;691;Valmunster;86;4;90
44;Grand Est;57;5;23;692;Vannecourt;74;0;74
44;Grand Est;57;9;16;693;Vantoux;823;19;842
44;Grand Est;57;9;16;694;Vany;438;11;449
44;Grand Est;57;3;03;695;Varize-Vaudoncourt;521;9;530
44;Grand Est;57;3;03;696;Varsberg;961;26;987
44;Grand Est;57;5;17;697;Vasperviller;315;9;324
44;Grand Est;57;3;07;698;Vatimont;317;6;323
44;Grand Est;57;3;04;700;Vaudreching;504;8;512
44;Grand Est;57;9;05;701;Vaux;810;26;836
44;Grand Est;57;5;23;702;Vaxy;168;0;168
44;Grand Est;57;5;21;703;Veckersviller;233;17;250
44;Grand Est;57;7;14;704;Veckring;650;15;665
44;Grand Est;57;3;03;705;Velving;207;5;212
44;Grand Est;57;5;23;706;Vergaville;549;14;563
44;Grand Est;57;9;05;707;Vernéville;652;6;658
44;Grand Est;57;9;07;708;Verny;1953;43;1996
44;Grand Est;57;5;17;709;Vescheim;310;7;317
44;Grand Est;57;5;23;711;Vibersviller;418;7;425
44;Grand Est;57;5;23;712;Vic-sur-Seille;1283;105;1388
44;Grand Est;57;5;21;713;Vieux-Lixheim;248;8;256
44;Grand Est;57;3;07;714;Haute-Vigneulles;431;9;440
44;Grand Est;57;9;23;715;Vigny;377;11;388
44;Grand Est;57;9;16;716;Vigy;1741;34;1775
44;Grand Est;57;3;20;717;Viller;186;3;189
44;Grand Est;57;9;07;718;Villers-Stoncourt;218;1;219
44;Grand Est;57;5;23;719;Villers-sur-Nied;79;3;82
44;Grand Est;57;3;04;720;Villing;495;12;507
44;Grand Est;57;5;17;721;Vilsberg;346;9;355
44;Grand Est;57;5;23;723;Virming;293;6;299
44;Grand Est;57;7;10;724;Vitry-sur-Orne;3021;35;3056
44;Grand Est;57;5;23;725;Vittersbourg;348;7;355
44;Grand Est;57;3;07;726;Vittoncourt;382;4;386
44;Grand Est;57;5;23;727;Viviers;122;1;123
44;Grand Est;57;3;07;728;Voimhaut;253;3;256
44;Grand Est;57;3;03;730;Volmerange-lès-Boulay;566;12;578
44;Grand Est;57;7;27;731;Volmerange-les-Mines;2269;40;2309
44;Grand Est;57;6;02;732;Volmunster;777;21;798
44;Grand Est;57;7;14;733;Volstroff;2034;29;2063
44;Grand Est;57;5;17;734;Voyer;458;11;469
44;Grand Est;57;9;16;736;Vry;614;8;622
44;Grand Est;57;9;23;737;Vulmont;31;2;33
44;Grand Est;57;6;02;738;Waldhouse;405;6;411
44;Grand Est;57;7;04;739;Waldweistroff;504;2;506
44;Grand Est;57;7;04;740;Waldwisse;807;12;819
44;Grand Est;57;6;02;741;Walschbronn;438;13;451
44;Grand Est;57;5;17;742;Walscheid;1499;41;1540
44;Grand Est;57;5;17;743;Waltembourg;243;7;250
44;Grand Est;57;6;22;745;Wiesviller;931;21;952
44;Grand Est;57;6;22;746;Willerwald;1548;36;1584
44;Grand Est;57;5;17;747;Wintersbourg;269;7;276
44;Grand Est;57;6;22;748;Wittring;765;17;782
44;Grand Est;57;3;04;749;Vœlfling-lès-Bouzonville;156;6;162
44;Grand Est;57;6;22;750;Wœlfling-lès-Sarreguemines;718;26;744
44;Grand Est;57;9;24;751;Woippy;14014;137;14151
44;Grand Est;57;6;20;752;Woustviller;2986;51;3037
44;Grand Est;57;5;23;753;Wuisse;60;1;61
44;Grand Est;57;5;23;754;Xanrey;111;1;112
44;Grand Est;57;5;23;755;Xocourt;98;1;99
44;Grand Est;57;5;17;756;Xouaxange;310;3;313
44;Grand Est;57;7;27;757;Yutz;17143;265;17408
44;Grand Est;57;5;23;759;Zarbeling;63;1;64
44;Grand Est;57;6;22;760;Zetting;844;20;864
44;Grand Est;57;5;17;761;Zilling;267;4;271
44;Grand Est;57;3;07;762;Zimming;707;6;713
44;Grand Est;57;5;23;763;Zommange;46;2;48
44;Grand Est;57;7;27;764;Zoufftgen;1245;14;1259
44;Grand Est;57;3;19;765;Diesen;1057;16;1073
44;Grand Est;57;7;14;767;Stuckange;1308;34;1342
27;Bourgogne-Franche-Comté;58;1;02;001;Achun;160;0;160
27;Bourgogne-Franche-Comté;58;4;05;002;Alligny-Cosne;905;13;918
27;Bourgogne-Franche-Comté;58;1;02;003;Alligny-en-Morvan;607;7;614
27;Bourgogne-Franche-Comté;58;1;02;004;Alluy;377;9;386
27;Bourgogne-Franche-Comté;58;2;03;005;Amazy;224;1;225
27;Bourgogne-Franche-Comté;58;3;08;006;Anlezy;244;3;247
27;Bourgogne-Franche-Comté;58;4;15;007;Annay;340;5;345
27;Bourgogne-Franche-Comté;58;2;04;008;Anthien;169;5;174
27;Bourgogne-Franche-Comté;58;4;01;009;Arbourse;128;1;129
27;Bourgogne-Franche-Comté;58;1;02;010;Arleuf;683;12;695
27;Bourgogne-Franche-Comté;58;2;03;011;Armes;283;5;288
27;Bourgogne-Franche-Comté;58;4;15;012;Arquian;574;11;585
27;Bourgogne-Franche-Comté;58;4;01;013;Arthel;97;1;98
27;Bourgogne-Franche-Comté;58;4;01;014;Arzembouy;67;1;68
27;Bourgogne-Franche-Comté;58;2;04;015;Asnan;120;3;123
27;Bourgogne-Franche-Comté;58;2;03;016;Asnois;141;3;144
27;Bourgogne-Franche-Comté;58;1;02;017;Aunay-en-Bazois;226;7;233
27;Bourgogne-Franche-Comté;58;2;04;018;Authiou;47;0;47
27;Bourgogne-Franche-Comté;58;1;10;019;Avrée;83;3;86
27;Bourgogne-Franche-Comté;58;3;16;020;Avril-sur-Loire;253;4;257
27;Bourgogne-Franche-Comté;58;3;16;021;Azy-le-Vif;204;5;209
27;Bourgogne-Franche-Comté;58;1;04;023;Bazoches;175;3;178
27;Bourgogne-Franche-Comté;58;3;08;024;Bazolles;280;11;291
27;Bourgogne-Franche-Comté;58;3;09;025;Béard;162;7;169
27;Bourgogne-Franche-Comté;58;2;04;026;Beaulieu;141;9;150
27;Bourgogne-Franche-Comté;58;4;01;027;Beaumont-la-Ferrière;121;3;124
27;Bourgogne-Franche-Comté;58;3;08;028;Beaumont-Sardolles;117;3;120
27;Bourgogne-Franche-Comté;58;2;04;029;Beuvron;81;0;81
27;Bourgogne-Franche-Comté;58;1;02;030;Biches;284;11;295
27;Bourgogne-Franche-Comté;58;3;08;031;Billy-Chevannes;299;3;302
27;Bourgogne-Franche-Comté;58;2;03;032;Billy-sur-Oisy;361;6;367
27;Bourgogne-Franche-Comté;58;4;15;033;Bitry;296;8;304
27;Bourgogne-Franche-Comté;58;1;02;034;Blismes;183;6;189
27;Bourgogne-Franche-Comté;58;3;08;035;Bona;302;2;304
27;Bourgogne-Franche-Comté;58;4;15;036;Bouhy;464;9;473
27;Bourgogne-Franche-Comté;58;1;04;037;Brassy;592;36;628
27;Bourgogne-Franche-Comté;58;2;03;038;Breugnon;160;5;165
27;Bourgogne-Franche-Comté;58;2;03;039;Brèves;236;3;239
27;Bourgogne-Franche-Comté;58;1;02;040;Brinay;144;3;147
27;Bourgogne-Franche-Comté;58;2;04;041;Brinon-sur-Beuvron;171;5;176
27;Bourgogne-Franche-Comté;58;4;15;042;Bulcy;136;2;138
27;Bourgogne-Franche-Comté;58;2;04;043;Bussy-la-Pesle;54;0;54
27;Bourgogne-Franche-Comté;58;4;05;044;La Celle-sur-Loire;813;10;823
27;Bourgogne-Franche-Comté;58;4;01;045;La Celle-sur-Nièvre;158;1;159
27;Bourgogne-Franche-Comté;58;1;10;046;Cercy-la-Tour;1713;25;1738
27;Bourgogne-Franche-Comté;58;2;04;047;Cervon;661;16;677
27;Bourgogne-Franche-Comté;58;4;15;048;Cessy-les-Bois;107;5;112
27;Bourgogne-Franche-Comté;58;1;04;049;Chalaux;83;2;85
27;Bourgogne-Franche-Comté;58;2;04;050;Challement;45;2;47
27;Bourgogne-Franche-Comté;58;3;13;051;Challuy;1526;133;1659
27;Bourgogne-Franche-Comté;58;2;04;052;Champallement;45;2;47
27;Bourgogne-Franche-Comté;58;4;01;053;Champlemy;325;7;332
27;Bourgogne-Franche-Comté;58;2;01;054;Champlin;39;1;40
27;Bourgogne-Franche-Comté;58;3;06;055;Champvert;761;15;776
27;Bourgogne-Franche-Comté;58;4;01;056;Champvoux;297;7;304
27;Bourgogne-Franche-Comté;58;3;16;057;Chantenay-Saint-Imbert;1152;19;1171
27;Bourgogne-Franche-Comté;58;2;03;058;La Chapelle-Saint-André;300;5;305
27;Bourgogne-Franche-Comté;58;4;01;059;La Charité-sur-Loire;4742;57;4799
27;Bourgogne-Franche-Comté;58;1;10;060;Charrin;619;9;628
27;Bourgogne-Franche-Comté;58;4;01;061;Chasnay;122;1;123
27;Bourgogne-Franche-Comté;58;1;02;062;Château-Chinon (Ville);1932;384;2316
27;Bourgogne-Franche-Comté;58;1;02;063;Château-Chinon (Campagne);546;10;556
27;Bourgogne-Franche-Comté;58;4;15;064;Châteauneuf-Val-de-Bargis;499;15;514
27;Bourgogne-Franche-Comté;58;1;02;065;Châtillon-en-Bazois;905;16;921
27;Bourgogne-Franche-Comté;58;1;02;066;Châtin;84;0;84
27;Bourgogne-Franche-Comté;58;4;01;067;Chaulgnes;1503;23;1526
27;Bourgogne-Franche-Comté;58;1;02;068;Chaumard;209;5;214
27;Bourgogne-Franche-Comté;58;2;04;069;Chaumot;160;4;164
27;Bourgogne-Franche-Comté;58;2;04;070;Chazeuil;57;2;59
27;Bourgogne-Franche-Comté;58;2;04;071;Chevannes-Changy;138;7;145
27;Bourgogne-Franche-Comté;58;3;16;072;Chevenon;618;10;628
27;Bourgogne-Franche-Comté;58;2;03;073;Chevroches;122;6;128
27;Bourgogne-Franche-Comté;58;1;10;074;Chiddes;339;5;344
27;Bourgogne-Franche-Comté;58;2;04;075;Chitry-les-Mines;215;4;219
27;Bourgogne-Franche-Comté;58;1;02;076;Chougny;79;0;79
27;Bourgogne-Franche-Comté;58;4;15;077;Ciez;374;6;380
27;Bourgogne-Franche-Comté;58;3;08;078;Cizely;54;0;54
27;Bourgogne-Franche-Comté;58;2;03;079;Clamecy;3590;183;3773
27;Bourgogne-Franche-Comté;58;2;04;080;La Collancelle;169;1;170
27;Bourgogne-Franche-Comté;58;4;15;081;Colméry;276;4;280
27;Bourgogne-Franche-Comté;58;1;02;082;Corancy;285;4;289
27;Bourgogne-Franche-Comté;58;2;04;083;Corbigny;1440;109;1549
27;Bourgogne-Franche-Comté;58;2;04;084;Corvol-d'Embernard;85;4;89
27;Bourgogne-Franche-Comté;58;2;03;085;Corvol-l'Orgueilleux;753;13;766
27;Bourgogne-Franche-Comté;58;4;05;086;Cosne-Cours-sur-Loire;9589;238;9827
27;Bourgogne-Franche-Comté;58;3;06;087;Cossaye;706;8;714
27;Bourgogne-Franche-Comté;58;3;11;088;Coulanges-lès-Nevers;3724;87;3811
27;Bourgogne-Franche-Comté;58;4;15;089;Couloutre;189;7;196
27;Bourgogne-Franche-Comté;58;2;03;090;Courcelles;219;1;220
27;Bourgogne-Franche-Comté;58;3;08;092;Crux-la-Ville;395;9;404
27;Bourgogne-Franche-Comté;58;2;03;093;Cuncy-lès-Varzy;127;2;129
27;Bourgogne-Franche-Comté;58;4;15;094;Dampierre-sous-Bouhy;448;4;452
27;Bourgogne-Franche-Comté;58;3;06;095;Decize;5233;175;5408
27;Bourgogne-Franche-Comté;58;3;06;096;Devay;495;9;504
27;Bourgogne-Franche-Comté;58;3;08;097;Diennes-Aubigny;92;1;93
27;Bourgogne-Franche-Comté;58;2;03;098;Dirol;112;4;116
27;Bourgogne-Franche-Comté;58;1;02;099;Dommartin;164;3;167
27;Bourgogne-Franche-Comté;58;4;01;101;Dompierre-sur-Nièvre;190;2;192
27;Bourgogne-Franche-Comté;58;4;15;102;Donzy;1575;27;1602
27;Bourgogne-Franche-Comté;58;2;03;103;Dornecy;470;8;478
27;Bourgogne-Franche-Comté;58;3;16;104;Dornes;1466;24;1490
27;Bourgogne-Franche-Comté;58;3;09;105;Druy-Parigny;308;6;314
27;Bourgogne-Franche-Comté;58;1;04;106;Dun-les-Places;353;4;357
27;Bourgogne-Franche-Comté;58;1;02;107;Dun-sur-Grandry;144;2;146
27;Bourgogne-Franche-Comté;58;1;04;108;Empury;85;1;86
27;Bourgogne-Franche-Comté;58;2;03;109;Entrains-sur-Nohain;748;14;762
27;Bourgogne-Franche-Comté;58;2;04;110;Epiry;245;2;247
27;Bourgogne-Franche-Comté;58;1;02;111;Fâchin;106;0;106
27;Bourgogne-Franche-Comté;58;3;08;112;La Fermeté;632;7;639
27;Bourgogne-Franche-Comté;58;3;08;113;Fertrève;98;3;101
27;Bourgogne-Franche-Comté;58;1;10;114;Fléty;93;4;97
27;Bourgogne-Franche-Comté;58;3;16;115;Fleury-sur-Loire;227;6;233
27;Bourgogne-Franche-Comté;58;2;03;116;Flez-Cuzy;131;5;136
27;Bourgogne-Franche-Comté;58;3;07;117;Fourchambault;4125;53;4178
27;Bourgogne-Franche-Comté;58;1;10;118;Fours;642;7;649
27;Bourgogne-Franche-Comté;58;3;08;119;Frasnay-Reugny;82;3;85
27;Bourgogne-Franche-Comté;58;2;04;120;Gâcogne;224;0;224
27;Bourgogne-Franche-Comté;58;3;07;121;Garchizy;3740;46;3786
27;Bourgogne-Franche-Comté;58;4;15;122;Garchy;425;8;433
27;Bourgogne-Franche-Comté;58;2;04;123;Germenay;129;9;138
27;Bourgogne-Franche-Comté;58;3;07;124;Germigny-sur-Loire;769;9;778
27;Bourgogne-Franche-Comté;58;1;02;125;Gien-sur-Cure;95;2;97
27;Bourgogne-Franche-Comté;58;3;13;126;Gimouille;450;7;457
27;Bourgogne-Franche-Comté;58;4;01;127;Giry;188;3;191
27;Bourgogne-Franche-Comté;58;1;02;128;Glux-en-Glenne;91;0;91
27;Bourgogne-Franche-Comté;58;1;02;129;Gouloux;176;5;181
27;Bourgogne-Franche-Comté;58;2;04;130;Grenois;95;2;97
27;Bourgogne-Franche-Comté;58;3;08;131;Guérigny;2510;40;2550
27;Bourgogne-Franche-Comté;58;2;04;132;Guipy;227;11;238
27;Bourgogne-Franche-Comté;58;2;04;133;Héry;73;2;75
27;Bourgogne-Franche-Comté;58;3;09;134;Imphy;3202;38;3240
27;Bourgogne-Franche-Comté;58;1;10;135;Isenay;102;0;102
27;Bourgogne-Franche-Comté;58;3;08;136;Jailly;68;2;70
27;Bourgogne-Franche-Comté;58;3;06;137;Lamenay-sur-Loire;68;0;68
27;Bourgogne-Franche-Comté;58;3;16;138;Langeron;357;10;367
27;Bourgogne-Franche-Comté;58;1;10;139;Lanty;116;0;116
27;Bourgogne-Franche-Comté;58;1;10;140;Larochemillay;231;5;236
27;Bourgogne-Franche-Comté;58;1;02;141;Lavault-de-Frétoy;71;0;71
27;Bourgogne-Franche-Comté;58;1;02;142;Limanton;239;4;243
27;Bourgogne-Franche-Comté;58;3;08;143;Limon;144;5;149
27;Bourgogne-Franche-Comté;58;3;16;144;Livry;698;6;704
27;Bourgogne-Franche-Comté;58;1;04;145;Lormes;1273;29;1302
27;Bourgogne-Franche-Comté;58;3;06;146;Lucenay-lès-Aix;978;19;997
27;Bourgogne-Franche-Comté;58;4;01;147;Lurcy-le-Bourg;278;5;283
27;Bourgogne-Franche-Comté;58;3;16;148;Luthenay-Uxeloup;615;11;626
27;Bourgogne-Franche-Comté;58;1;10;149;Luzy;1988;38;2026
27;Bourgogne-Franche-Comté;58;2;03;150;Lys;110;6;116
27;Bourgogne-Franche-Comté;58;3;09;151;La Machine;3240;53;3293
27;Bourgogne-Franche-Comté;58;3;12;152;Magny-Cours;1395;27;1422
27;Bourgogne-Franche-Comté;58;2;04;153;Magny-Lormes;71;2;73
27;Bourgogne-Franche-Comté;58;2;03;154;La Maison-Dieu;117;1;118
27;Bourgogne-Franche-Comté;58;4;01;155;La Marche;561;17;578
27;Bourgogne-Franche-Comté;58;2;03;156;Marcy;145;2;147
27;Bourgogne-Franche-Comté;58;1;04;157;Marigny-l'Église;282;16;298
27;Bourgogne-Franche-Comté;58;3;16;158;Mars-sur-Allier;306;6;312
27;Bourgogne-Franche-Comté;58;2;04;159;Marigny-sur-Yonne;197;3;200
27;Bourgogne-Franche-Comté;58;3;07;160;Marzy;3724;201;3925
27;Bourgogne-Franche-Comté;58;1;10;161;Maux;144;0;144
27;Bourgogne-Franche-Comté;58;4;15;162;Menestreau;110;1;111
27;Bourgogne-Franche-Comté;58;2;03;163;Menou;185;3;188
27;Bourgogne-Franche-Comté;58;4;15;164;Mesves-sur-Loire;667;28;695
27;Bourgogne-Franche-Comté;58;2;03;165;Metz-le-Comte;160;7;167
27;Bourgogne-Franche-Comté;58;2;04;166;Mhère;231;2;233
27;Bourgogne-Franche-Comté;58;1;10;168;Millay;441;5;446
27;Bourgogne-Franche-Comté;58;2;03;169;Moissy-Moulinot;15;3;18
27;Bourgogne-Franche-Comté;58;2;03;170;Monceaux-le-Comte;122;2;124
27;Bourgogne-Franche-Comté;58;1;02;171;Montapas;289;2;291
27;Bourgogne-Franche-Comté;58;1;10;172;Montambert;122;2;124
27;Bourgogne-Franche-Comté;58;1;10;173;Montaron;158;0;158
27;Bourgogne-Franche-Comté;58;4;01;174;Montenoison;120;2;122
27;Bourgogne-Franche-Comté;58;1;02;175;Mont-et-Marré;157;1;158
27;Bourgogne-Franche-Comté;58;3;08;176;Montigny-aux-Amognes;634;23;657
27;Bourgogne-Franche-Comté;58;1;02;177;Montigny-en-Morvan;281;1;282
27;Bourgogne-Franche-Comté;58;1;10;178;Montigny-sur-Canne;153;2;155
27;Bourgogne-Franche-Comté;58;2;02;179;Montreuillon;259;7;266
27;Bourgogne-Franche-Comté;58;1;02;180;Montsauche-les-Settons;513;3;516
27;Bourgogne-Franche-Comté;58;2;04;181;Moraches;145;5;150
27;Bourgogne-Franche-Comté;58;1;10;182;Moulins-Engilbert;1445;24;1469
27;Bourgogne-Franche-Comté;58;2;04;183;Mouron-sur-Yonne;97;1;98
27;Bourgogne-Franche-Comté;58;4;01;184;Moussy;103;1;104
27;Bourgogne-Franche-Comté;58;1;02;185;Moux-en-Morvan;529;4;533
27;Bourgogne-Franche-Comté;58;4;01;186;Murlin;69;1;70
27;Bourgogne-Franche-Comté;58;4;05;187;Myennes;518;6;524
27;Bourgogne-Franche-Comté;58;4;01;188;Nannay;114;3;117
27;Bourgogne-Franche-Comté;58;4;01;189;Narcy;478;4;482
27;Bourgogne-Franche-Comté;58;2;03;190;Neuffontaines;105;2;107
27;Bourgogne-Franche-Comté;58;2;04;191;Neuilly;113;3;116
27;Bourgogne-Franche-Comté;58;3;16;192;Neuville-lès-Decize;218;9;227
27;Bourgogne-Franche-Comté;58;4;15;193;Neuvy-sur-Loire;1410;31;1441
27;Bourgogne-Franche-Comté;58;3;99;194;Nevers;33005;1064;34069
27;Bourgogne-Franche-Comté;58;1;10;195;La Nocle-Maulaix;279;1;280
27;Bourgogne-Franche-Comté;58;3;08;196;Nolay;347;3;350
27;Bourgogne-Franche-Comté;58;2;03;197;Nuars;159;1;160
27;Bourgogne-Franche-Comté;58;2;03;198;Oisy;301;5;306
27;Bourgogne-Franche-Comté;58;1;02;199;Onlay;154;4;158
27;Bourgogne-Franche-Comté;58;2;03;200;Ouagne;149;1;150
27;Bourgogne-Franche-Comté;58;2;03;201;Oudan;143;3;146
27;Bourgogne-Franche-Comté;58;1;02;202;Ougny;24;0;24
27;Bourgogne-Franche-Comté;58;4;01;203;Oulon;63;1;64
27;Bourgogne-Franche-Comté;58;3;08;204;Vaux d'Amognes;540;8;548
27;Bourgogne-Franche-Comté;58;1;02;205;Ouroux-en-Morvan;600;7;607
27;Bourgogne-Franche-Comté;58;2;03;206;Parigny-la-Rose;36;0;36
27;Bourgogne-Franche-Comté;58;3;17;207;Parigny-les-Vaux;970;32;1002
27;Bourgogne-Franche-Comté;58;2;04;208;Pazy;296;10;306
27;Bourgogne-Franche-Comté;58;4;15;209;Perroy;150;5;155
27;Bourgogne-Franche-Comté;58;1;02;210;Planchez;301;4;305
27;Bourgogne-Franche-Comté;58;1;10;211;Poil;147;3;150
27;Bourgogne-Franche-Comté;58;3;08;212;Poiseux;328;4;332
27;Bourgogne-Franche-Comté;58;4;05;213;Pougny;467;9;476
27;Bourgogne-Franche-Comté;58;3;17;214;Pougues-les-Eaux;2355;51;2406
27;Bourgogne-Franche-Comté;58;4;15;215;Pouilly-sur-Loire;1606;24;1630
27;Bourgogne-Franche-Comté;58;2;04;216;Pouques-Lormes;158;3;161
27;Bourgogne-Franche-Comté;58;2;03;217;Pousseaux;198;3;201
27;Bourgogne-Franche-Comté;58;4;01;218;Prémery;1823;27;1850
27;Bourgogne-Franche-Comté;58;1;10;219;Préporché;208;4;212
27;Bourgogne-Franche-Comté;58;4;01;220;Raveau;654;10;664
27;Bourgogne-Franche-Comté;58;1;10;221;Rémilly;150;2;152
27;Bourgogne-Franche-Comté;58;2;03;222;Rix;159;1;160
27;Bourgogne-Franche-Comté;58;3;08;223;Rouy;630;8;638
27;Bourgogne-Franche-Comté;58;2;03;224;Ruages;89;4;93
27;Bourgogne-Franche-Comté;58;3;13;225;Saincaize-Meauce;369;7;376
27;Bourgogne-Franche-Comté;58;1;02;226;Saint-Agnan;131;2;133
27;Bourgogne-Franche-Comté;58;4;15;227;Saint-Amand-en-Puisaye;1225;25;1250
27;Bourgogne-Franche-Comté;58;4;15;228;Saint-Andelain;580;4;584
27;Bourgogne-Franche-Comté;58;1;04;229;Saint-André-en-Morvan;311;5;316
27;Bourgogne-Franche-Comté;58;2;03;230;Saint-Aubin-des-Chaumes;71;0;71
27;Bourgogne-Franche-Comté;58;4;01;231;Saint-Aubin-les-Forges;392;8;400
27;Bourgogne-Franche-Comté;58;3;08;232;Saint-Benin-d'Azy;1265;20;1285
27;Bourgogne-Franche-Comté;58;3;08;233;Saint-Benin-des-Bois;166;7;173
27;Bourgogne-Franche-Comté;58;4;01;234;Saint-Bonnot;144;1;145
27;Bourgogne-Franche-Comté;58;1;02;235;Saint-Brisson;260;3;263
27;Bourgogne-Franche-Comté;58;4;15;236;Sainte-Colombe-des-Bois;135;2;137
27;Bourgogne-Franche-Comté;58;2;03;237;Saint-Didier;29;2;31
27;Bourgogne-Franche-Comté;58;3;12;238;Saint-Éloi;2221;50;2271
27;Bourgogne-Franche-Comté;58;3;08;239;Saint-Firmin;159;2;161
27;Bourgogne-Franche-Comté;58;3;08;240;Saint-Franchy;77;2;79
27;Bourgogne-Franche-Comté;58;3;06;241;Saint-Germain-Chassenay;316;4;320
27;Bourgogne-Franche-Comté;58;2;03;242;Saint-Germain-des-Bois;125;0;125
27;Bourgogne-Franche-Comté;58;1;10;243;Saint-Gratien-Savigny;116;3;119
27;Bourgogne-Franche-Comté;58;1;02;244;Saint-Hilaire-en-Morvan;217;7;224
27;Bourgogne-Franche-Comté;58;1;10;245;Saint-Hilaire-Fontaine;166;4;170
27;Bourgogne-Franche-Comté;58;1;10;246;Saint-Honoré-les-Bains;714;13;727
27;Bourgogne-Franche-Comté;58;3;08;247;Saint-Jean-aux-Amognes;484;7;491
27;Bourgogne-Franche-Comté;58;4;15;248;Saint-Laurent-l'Abbaye;214;5;219
27;Bourgogne-Franche-Comté;58;1;02;249;Saint-Léger-de-Fougeret;352;2;354
27;Bourgogne-Franche-Comté;58;3;06;250;Saint-Léger-des-Vignes;1863;46;1909
27;Bourgogne-Franche-Comté;58;4;05;251;Saint-Loup;474;7;481
27;Bourgogne-Franche-Comté;58;4;15;252;Saint-Malo-en-Donziois;127;3;130
27;Bourgogne-Franche-Comté;58;3;08;253;Sainte-Marie;78;5;83
27;Bourgogne-Franche-Comté;58;3;08;254;Saint-Martin-d'Heuille;570;13;583
27;Bourgogne-Franche-Comté;58;1;04;255;Saint-Martin-du-Puy;279;5;284
27;Bourgogne-Franche-Comté;58;4;15;256;Saint-Martin-sur-Nohain;376;13;389
27;Bourgogne-Franche-Comté;58;3;08;257;Saint-Maurice;64;0;64
27;Bourgogne-Franche-Comté;58;3;09;258;Saint-Ouen-sur-Loire;561;6;567
27;Bourgogne-Franche-Comté;58;3;16;259;Saint-Parize-en-Viry;144;3;147
27;Bourgogne-Franche-Comté;58;3;16;260;Saint-Parize-le-Châtel;1246;27;1273
27;Bourgogne-Franche-Comté;58;4;05;261;Saint-Père;1059;20;1079
27;Bourgogne-Franche-Comté;58;1;02;262;Saint-Péreuse;212;7;219
27;Bourgogne-Franche-Comté;58;2;03;263;Saint-Pierre-du-Mont;170;2;172
27;Bourgogne-Franche-Comté;58;3;16;264;Saint-Pierre-le-Moûtier;1879;26;1905
27;Bourgogne-Franche-Comté;58;4;15;265;Saint-Quentin-sur-Nohain;94;3;97
27;Bourgogne-Franche-Comté;58;2;04;266;Saint-Révérien;155;0;155
27;Bourgogne-Franche-Comté;58;3;08;267;Saint-Saulge;724;80;804
27;Bourgogne-Franche-Comté;58;1;10;268;Saint-Seine;196;5;201
27;Bourgogne-Franche-Comté;58;3;08;269;Saint-Sulpice;413;10;423
27;Bourgogne-Franche-Comté;58;4;15;270;Saint-Vérain;351;6;357
27;Bourgogne-Franche-Comté;58;2;03;271;Saizy;187;3;190
27;Bourgogne-Franche-Comté;58;2;04;272;Sardy-lès-Épiry;108;4;112
27;Bourgogne-Franche-Comté;58;3;09;273;Sauvigny-les-Bois;1434;40;1474
27;Bourgogne-Franche-Comté;58;1;10;274;Savigny-Poil-Fol;115;3;118
27;Bourgogne-Franche-Comté;58;3;08;275;Saxi-Bourdon;297;4;301
27;Bourgogne-Franche-Comté;58;1;10;276;Sémelay;221;3;224
27;Bourgogne-Franche-Comté;58;1;10;277;Sermages;191;7;198
27;Bourgogne-Franche-Comté;58;3;12;278;Sermoise-sur-Loire;1482;68;1550
27;Bourgogne-Franche-Comté;58;4;01;279;Sichamps;180;6;186
27;Bourgogne-Franche-Comté;58;3;09;280;Sougy-sur-Loire;598;16;614
27;Bourgogne-Franche-Comté;58;4;15;281;Suilly-la-Tour;596;14;610
27;Bourgogne-Franche-Comté;58;2;03;282;Surgy;333;11;344
27;Bourgogne-Franche-Comté;58;2;04;283;Taconnay;74;2;76
27;Bourgogne-Franche-Comté;58;2;03;284;Talon;38;2;40
27;Bourgogne-Franche-Comté;58;1;02;285;Tamnay-en-Bazois;160;5;165
27;Bourgogne-Franche-Comté;58;2;03;286;Tannay;575;10;585
27;Bourgogne-Franche-Comté;58;1;10;287;Tazilly;191;4;195
27;Bourgogne-Franche-Comté;58;2;03;288;Teigny;102;2;104
27;Bourgogne-Franche-Comté;58;1;10;289;Ternant;189;0;189
27;Bourgogne-Franche-Comté;58;1;10;290;Thaix;46;1;47
27;Bourgogne-Franche-Comté;58;3;09;291;Thianges;176;0;176
27;Bourgogne-Franche-Comté;58;1;02;292;Tintury;167;0;167
27;Bourgogne-Franche-Comté;58;3;16;293;Toury-Lurcy;416;4;420
27;Bourgogne-Franche-Comté;58;3;16;294;Toury-sur-Jour;119;2;121
27;Bourgogne-Franche-Comté;58;4;15;295;Tracy-sur-Loire;986;15;1001
27;Bourgogne-Franche-Comté;58;3;16;296;Tresnay;137;0;137
27;Bourgogne-Franche-Comté;58;3;09;297;Trois-Vèvres;243;1;244
27;Bourgogne-Franche-Comté;58;4;01;298;Tronsanges;398;9;407
27;Bourgogne-Franche-Comté;58;2;03;299;Trucy-l'Orgueilleux;219;3;222
27;Bourgogne-Franche-Comté;58;3;08;300;Urzy;1746;35;1781
27;Bourgogne-Franche-Comté;58;1;10;301;Vandenesse;298;5;303
27;Bourgogne-Franche-Comté;58;4;01;302;Varennes-lès-Narcy;928;5;933
27;Bourgogne-Franche-Comté;58;3;17;303;Varennes-Vauzelles;9201;177;9378
27;Bourgogne-Franche-Comté;58;2;03;304;Varzy;1103;200;1303
27;Bourgogne-Franche-Comté;58;2;04;305;Vauclaix;135;2;137
27;Bourgogne-Franche-Comté;58;3;06;306;Verneuil;296;9;305
27;Bourgogne-Franche-Comté;58;4;15;307;Vielmanay;179;4;183
27;Bourgogne-Franche-Comté;58;2;03;308;Vignol;62;0;62
27;Bourgogne-Franche-Comté;58;1;10;309;Villapourçon;407;8;415
27;Bourgogne-Franche-Comté;58;2;03;310;Villiers-le-Sec;48;1;49
27;Bourgogne-Franche-Comté;58;3;08;311;Ville-Langy;242;6;248
27;Bourgogne-Franche-Comté;58;2;03;312;Villiers-sur-Yonne;269;9;278
27;Bourgogne-Franche-Comté;58;2;04;313;Vitry-Laché;80;4;84
32;Hauts-de-France;59;2;09;001;Abancourt;469;13;482
32;Hauts-de-France;59;6;14;002;Abscon;4309;34;4343
32;Hauts-de-France;59;1;19;003;Aibes;372;6;378
32;Hauts-de-France;59;3;31;004;Aix-en-Pévèle;1320;14;1334
32;Hauts-de-France;59;5;02;005;Allennes-les-Marais;3456;59;3515
32;Hauts-de-France;59;1;05;006;Amfroipret;216;8;224
32;Hauts-de-France;59;3;31;007;Anhiers;890;9;899
32;Hauts-de-France;59;3;01;008;Aniche;10085;83;10168
32;Hauts-de-France;59;5;40;009;Villeneuve-d'Ascq;61957;656;62613
32;Hauts-de-France;59;2;09;010;Anneux;259;2;261
32;Hauts-de-France;59;5;02;011;Annœullin;10471;112;10583
32;Hauts-de-France;59;1;19;012;Anor;3221;45;3266
32;Hauts-de-France;59;5;36;013;Anstaing;1517;16;1533
32;Hauts-de-France;59;6;03;014;Anzin;13329;82;13411
32;Hauts-de-France;59;3;01;015;Arleux;3177;27;3204
32;Hauts-de-France;59;4;12;016;Armbouts-Cappel;2200;47;2247
32;Hauts-de-France;59;5;04;017;Armentières;24909;360;25269
32;Hauts-de-France;59;4;41;018;Arnèke;1570;17;1587
32;Hauts-de-France;59;6;06;019;Artres;1061;12;1073
32;Hauts-de-France;59;1;30;021;Assevent;1815;18;1833
32;Hauts-de-France;59;5;36;022;Attiches;2261;32;2293
32;Hauts-de-France;59;2;09;023;Aubencheul-au-Bac;546;7;553
32;Hauts-de-France;59;3;01;024;Auberchicourt;4551;29;4580
32;Hauts-de-France;59;5;02;025;Aubers;1674;22;1696
32;Hauts-de-France;59;3;01;026;Aubigny-au-Bac;1166;17;1183
32;Hauts-de-France;59;6;06;027;Aubry-du-Hainaut;1705;15;1720
32;Hauts-de-France;59;3;31;028;Auby;7239;34;7273
32;Hauts-de-France;59;3;31;029;Auchy-lez-Orchies;1502;21;1523
32;Hauts-de-France;59;1;05;031;Audignies;372;4;376
32;Hauts-de-France;59;6;06;032;Aulnoy-lez-Valenciennes;7224;71;7295
32;Hauts-de-France;59;1;05;033;Aulnoye-Aymeries;8840;240;9080
32;Hauts-de-France;59;5;36;034;Avelin;2641;44;2685
32;Hauts-de-France;59;1;19;035;Avesnelles;2371;46;2417
32;Hauts-de-France;59;1;07;036;Avesnes-sur-Helpe;4195;138;4333
32;Hauts-de-France;59;2;11;037;Avesnes-les-Aubert;3630;34;3664
32;Hauts-de-France;59;6;14;038;Avesnes-le-Sec;1449;17;1466
32;Hauts-de-France;59;2;10;039;Awoingt;816;18;834
32;Hauts-de-France;59;1;05;041;Bachant;2291;17;2308
32;Hauts-de-France;59;5;36;042;Bachy;1791;29;1820
32;Hauts-de-France;59;4;08;043;Bailleul;15163;241;15404
32;Hauts-de-France;59;5;36;044;Baisieux;4777;49;4826
32;Hauts-de-France;59;1;19;045;Baives;167;4;171
32;Hauts-de-France;59;4;41;046;Bambecque;812;11;823
32;Hauts-de-France;59;2;10;047;Banteux;349;3;352
32;Hauts-de-France;59;2;09;048;Bantigny;523;11;534
32;Hauts-de-France;59;2;10;049;Bantouzelle;437;7;444
32;Hauts-de-France;59;1;19;050;Bas-Lieu;344;8;352
32;Hauts-de-France;59;5;02;051;La Bassée;6509;51;6560
32;Hauts-de-France;59;5;02;052;Bauvin;5086;44;5130
32;Hauts-de-France;59;1;05;053;Bavay;3264;60;3324
32;Hauts-de-France;59;4;41;054;Bavinchove;998;8;1006
32;Hauts-de-France;59;2;10;055;Bazuel;511;11;522
32;Hauts-de-France;59;5;28;056;Beaucamps-Ligny;851;23;874
32;Hauts-de-France;59;1;07;057;Beaudignies;561;14;575
32;Hauts-de-France;59;1;07;058;Beaufort;1014;14;1028
32;Hauts-de-France;59;2;10;059;Beaumont-en-Cambrésis;441;4;445
32;Hauts-de-France;59;2;11;060;Beaurain;234;3;237
32;Hauts-de-France;59;1;07;061;Beaurepaire-sur-Sambre;266;2;268
32;Hauts-de-France;59;1;19;062;Beaurieux;164;6;170
32;Hauts-de-France;59;2;11;063;Beauvois-en-Cambrésis;2004;20;2024
32;Hauts-de-France;59;6;06;064;Bellaing;1261;12;1273
32;Hauts-de-France;59;1;05;065;Bellignies;813;10;823
32;Hauts-de-France;59;1;19;066;Bérelles;156;5;161
32;Hauts-de-France;59;4;12;067;Bergues;3600;44;3644
32;Hauts-de-France;59;1;05;068;Berlaimont;3175;36;3211
32;Hauts-de-France;59;2;11;069;Bermerain;736;12;748
32;Hauts-de-France;59;1;05;070;Bermeries;371;4;375
32;Hauts-de-France;59;5;36;071;Bersée;2263;47;2310
32;Hauts-de-France;59;1;30;072;Bersillies;256;6;262
32;Hauts-de-France;59;4;08;073;Berthen;556;13;569
32;Hauts-de-France;59;2;10;074;Bertry;2168;36;2204
32;Hauts-de-France;59;2;11;075;Béthencourt;755;11;766
32;Hauts-de-France;59;1;30;076;Bettignies;310;5;315
32;Hauts-de-France;59;1;05;077;Bettrechies;257;6;263
32;Hauts-de-France;59;1;19;078;Beugnies;624;6;630
32;Hauts-de-France;59;6;03;079;Beuvrages;6809;34;6843
32;Hauts-de-France;59;3;31;080;Beuvry-la-Forêt;2796;31;2827
32;Hauts-de-France;59;2;11;081;Bévillers;572;6;578
32;Hauts-de-France;59;4;12;082;Bierne;1801;30;1831
32;Hauts-de-France;59;4;41;083;Bissezeele;253;2;255
32;Hauts-de-France;59;4;21;084;Blaringhem;2059;30;2089
32;Hauts-de-France;59;2;09;085;Blécourt;305;6;311
32;Hauts-de-France;59;4;08;086;Boeschepe;2155;30;2185
32;Hauts-de-France;59;4;21;087;Boëseghem;750;13;763
32;Hauts-de-France;59;5;04;088;Bois-Grenier;1739;21;1760
32;Hauts-de-France;59;4;41;089;Bollezeele;1424;30;1454
32;Hauts-de-France;59;5;24;090;Bondues;9808;181;9989
32;Hauts-de-France;59;4;08;091;Borre;578;14;592
32;Hauts-de-France;59;6;14;092;Bouchain;3924;40;3964
32;Hauts-de-France;59;1;07;093;Boulogne-sur-Helpe;341;5;346
32;Hauts-de-France;59;4;20;094;Bourbourg;7152;50;7202
32;Hauts-de-France;59;5;36;096;Bourghelles;1661;39;1700
32;Hauts-de-France;59;2;09;097;Boursies;402;5;407
32;Hauts-de-France;59;5;22;098;Bousbecque;4804;54;4858
32;Hauts-de-France;59;1;07;099;Bousies;1757;14;1771
32;Hauts-de-France;59;6;34;100;Bousignies;348;4;352
32;Hauts-de-France;59;1;19;101;Bousignies-sur-Roc;387;11;398
32;Hauts-de-France;59;2;11;102;Boussières-en-Cambrésis;438;4;442
32;Hauts-de-France;59;1;05;103;Boussières-sur-Sambre;521;9;530
32;Hauts-de-France;59;1;30;104;Boussois;3194;22;3216
32;Hauts-de-France;59;3;31;105;Bouvignies;1532;25;1557
32;Hauts-de-France;59;5;36;106;Bouvines;756;14;770
32;Hauts-de-France;59;4;17;107;Bray-Dunes;4495;45;4540
32;Hauts-de-France;59;2;10;108;Briastre;750;4;754
32;Hauts-de-France;59;6;34;109;Brillon;771;9;780
32;Hauts-de-France;59;4;20;110;Brouckerque;1421;30;1451
32;Hauts-de-France;59;4;41;111;Broxeele;399;4;403
32;Hauts-de-France;59;6;03;112;Bruay-sur-l'Escaut;11258;40;11298
32;Hauts-de-France;59;3;35;113;Bruille-lez-Marchiennes;1361;6;1367
32;Hauts-de-France;59;6;34;114;Bruille-Saint-Amand;1667;15;1682
32;Hauts-de-France;59;3;01;115;Brunémont;709;4;713
32;Hauts-de-France;59;1;05;116;Bry;414;12;426
32;Hauts-de-France;59;3;01;117;Bugnicourt;1049;12;1061
32;Hauts-de-France;59;2;10;118;Busigny;2456;25;2481
32;Hauts-de-France;59;4;41;119;Buysscheure;609;9;618
32;Hauts-de-France;59;4;08;120;Caëstre;2019;32;2051
32;Hauts-de-France;59;2;11;121;Cagnoncles;618;7;625
32;Hauts-de-France;59;2;09;122;Cambrai;32176;618;32794
32;Hauts-de-France;59;5;02;123;Camphin-en-Carembault;1699;23;1722
32;Hauts-de-France;59;5;36;124;Camphin-en-Pévèle;2499;41;2540
32;Hauts-de-France;59;2;10;125;Cantaing-sur-Escaut;404;9;413
32;Hauts-de-France;59;3;01;126;Cantin;1685;14;1699
32;Hauts-de-France;59;2;11;127;Capelle;145;5;150
32;Hauts-de-France;59;5;04;128;Capinghem;2537;30;2567
32;Hauts-de-France;59;5;36;129;Cappelle-en-Pévèle;2268;27;2295
32;Hauts-de-France;59;4;20;130;Cappelle-Brouck;1151;19;1170
32;Hauts-de-France;59;4;12;131;Cappelle-la-Grande;7920;74;7994
32;Hauts-de-France;59;2;11;132;Carnières;1020;13;1033
32;Hauts-de-France;59;5;02;133;Carnin;1033;19;1052
32;Hauts-de-France;59;1;07;134;Cartignies;1246;10;1256
32;Hauts-de-France;59;4;08;135;Cassel;2265;100;2365
32;Hauts-de-France;59;2;10;136;Le Cateau-Cambrésis;7030;141;7171
32;Hauts-de-France;59;2;10;137;Catillon-sur-Sambre;805;8;813
32;Hauts-de-France;59;2;10;138;Cattenières;682;14;696
32;Hauts-de-France;59;2;11;139;Caudry;14121;140;14261
32;Hauts-de-France;59;2;10;140;Caullery;452;10;462
32;Hauts-de-France;59;2;11;141;Cauroir;567;15;582
32;Hauts-de-France;59;1;19;142;Cerfontaine;709;5;714
32;Hauts-de-France;59;5;04;143;La Chapelle-d'Armentières;8577;94;8671
32;Hauts-de-France;59;6;34;144;Château-l'Abbaye;862;10;872
32;Hauts-de-France;59;5;18;145;Chemy;772;12;784
32;Hauts-de-France;59;5;36;146;Chéreng;2973;41;3014
32;Hauts-de-France;59;1;19;147;Choisies;49;2;51
32;Hauts-de-France;59;1;19;148;Clairfayts;361;1;362
32;Hauts-de-France;59;2;10;149;Clary;1088;16;1104
32;Hauts-de-France;59;5;36;150;Cobrieux;526;11;537
32;Hauts-de-France;59;1;19;151;Colleret;1617;17;1634
32;Hauts-de-France;59;5;22;152;Comines;12788;99;12887
32;Hauts-de-France;59;6;29;153;Condé-sur-l'Escaut;9515;54;9569
32;Hauts-de-France;59;4;12;155;Coudekerque-Branche;20851;293;21144
32;Hauts-de-France;59;3;15;156;Courchelettes;2842;32;2874
32;Hauts-de-France;59;1;19;157;Cousolre;2205;20;2225
32;Hauts-de-France;59;3;31;158;Coutiches;3077;45;3122
32;Hauts-de-France;59;4;20;159;Craywick;668;6;674
32;Hauts-de-France;59;6;29;160;Crespin;4495;30;4525
32;Hauts-de-France;59;2;10;161;Crèvecœur-sur-l'Escaut;751;45;796
32;Hauts-de-France;59;4;41;162;Crochte;665;21;686
32;Hauts-de-France;59;5;13;163;Croix;20881;276;21157
32;Hauts-de-France;59;1;07;164;Croix-Caluyau;247;8;255
32;Hauts-de-France;59;3;15;165;Cuincy;6400;98;6498
32;Hauts-de-France;59;6;29;166;Curgies;1337;36;1373
32;Hauts-de-France;59;2;09;167;Cuvillers;198;1;199
32;Hauts-de-France;59;5;36;168;Cysoing;4849;69;4918
32;Hauts-de-France;59;1;19;169;Damousies;202;4;206
32;Hauts-de-France;59;3;01;170;Dechy;5360;33;5393
32;Hauts-de-France;59;2;10;171;Dehéries;37;2;39
32;Hauts-de-France;59;6;14;172;Denain;19877;122;19999
32;Hauts-de-France;59;5;04;173;Deûlémont;1818;25;1843
32;Hauts-de-France;59;1;19;174;Dimechaux;330;2;332
32;Hauts-de-France;59;1;19;175;Dimont;310;9;319
32;Hauts-de-France;59;2;09;176;Doignies;326;3;329
32;Hauts-de-France;59;1;07;177;Dompierre-sur-Helpe;857;14;871
32;Hauts-de-France;59;3;15;178;Douai;39613;858;40471
32;Hauts-de-France;59;6;14;179;Douchy-les-Mines;10293;32;10325
32;Hauts-de-France;59;4;08;180;Le Doulieu;1466;19;1485
32;Hauts-de-France;59;1;07;181;Dourlers;551;6;557
32;Hauts-de-France;59;4;20;182;Drincham;266;6;272
32;Hauts-de-France;59;4;96;183;Dunkerque;86279;1268;87547
32;Hauts-de-France;59;4;21;184;Ebblinghem;658;10;668
32;Hauts-de-France;59;3;01;185;Écaillon;1963;13;1976
32;Hauts-de-France;59;1;19;186;Eccles;80;1;81
32;Hauts-de-France;59;1;07;187;Éclaibes;268;5;273
32;Hauts-de-France;59;1;05;188;Écuélin;140;4;144
32;Hauts-de-France;59;4;08;189;Eecke;1221;26;1247
32;Hauts-de-France;59;1;30;190;Élesmes;986;14;1000
32;Hauts-de-France;59;2;10;191;Élincourt;625;5;630
32;Hauts-de-France;59;6;14;192;Émerchicourt;847;47;894
32;Hauts-de-France;59;5;18;193;Emmerin;3108;25;3133
32;Hauts-de-France;59;1;07;194;Englefontaine;1282;23;1305
32;Hauts-de-France;59;5;28;195;Englos;613;9;622
32;Hauts-de-France;59;5;28;196;Ennetières-en-Weppes;1304;19;1323
32;Hauts-de-France;59;5;36;197;Ennevelin;2236;22;2258
32;Hauts-de-France;59;1;19;198;Eppe-Sauvage;248;0;248
32;Hauts-de-France;59;3;01;199;Erchin;686;11;697
32;Hauts-de-France;59;4;41;200;Eringhem;504;6;510
32;Hauts-de-France;59;5;28;201;Erquinghem-le-Sec;597;11;608
32;Hauts-de-France;59;5;04;202;Erquinghem-Lys;5316;40;5356
32;Hauts-de-France;59;3;35;203;Erre;1587;9;1596
32;Hauts-de-France;59;2;11;204;Escarmain;484;4;488
32;Hauts-de-France;59;6;14;205;Escaudain;9682;43;9725
32;Hauts-de-France;59;2;09;206;Escaudœuvres;3218;28;3246
32;Hauts-de-France;59;6;03;207;Escautpont;4208;28;4236
32;Hauts-de-France;59;5;28;208;Escobecques;304;10;314
32;Hauts-de-France;59;2;10;209;Esnes;674;8;682
32;Hauts-de-France;59;4;41;210;Esquelbecq;2116;39;2155
32;Hauts-de-France;59;3;15;211;Esquerchin;906;19;925
32;Hauts-de-France;59;4;21;212;Estaires;6461;136;6597
32;Hauts-de-France;59;2;11;213;Estourmel;458;15;473
32;Hauts-de-France;59;3;01;214;Estrées;1103;21;1124
32;Hauts-de-France;59;6;29;215;Estreux;959;33;992
32;Hauts-de-France;59;2;09;216;Eswars;350;8;358
32;Hauts-de-France;59;1;05;217;Eth;346;7;353
32;Hauts-de-France;59;1;07;218;Étrœungt;1307;15;1322
32;Hauts-de-France;59;2;09;219;Estrun;712;8;720
32;Hauts-de-France;59;5;18;220;Faches-Thumesnil;18191;122;18313
32;Hauts-de-France;59;6;06;221;Famars;2545;69;2614
32;Hauts-de-France;59;3;31;222;Faumont;2213;45;2258
32;Hauts-de-France;59;1;07;223;Le Favril;504;4;508
32;Hauts-de-France;59;3;01;224;Féchain;1698;14;1712
32;Hauts-de-France;59;1;05;225;Feignies;6809;69;6878
32;Hauts-de-France;59;1;19;226;Felleries;1454;16;1470
32;Hauts-de-France;59;3;35;227;Fenain;5510;50;5560
32;Hauts-de-France;59;3;01;228;Férin;1458;17;1475
32;Hauts-de-France;59;1;19;229;Féron;564;9;573
32;Hauts-de-France;59;1;30;230;Ferrière-la-Grande;5273;52;5325
32;Hauts-de-France;59;1;19;231;Ferrière-la-Petite;1058;13;1071
32;Hauts-de-France;59;1;05;232;La Flamengrie;426;4;430
32;Hauts-de-France;59;1;19;233;Flaumont-Waudrechies;365;3;368
32;Hauts-de-France;59;3;15;234;Flers-en-Escrebieux;5781;43;5824
32;Hauts-de-France;59;2;10;236;Flesquières;261;4;265
32;Hauts-de-France;59;4;08;237;Flêtre;986;23;1009
32;Hauts-de-France;59;6;34;238;Flines-lès-Mortagne;1635;25;1660
32;Hauts-de-France;59;3;31;239;Flines-lez-Raches;5598;93;5691
32;Hauts-de-France;59;1;07;240;Floursies;127;3;130
32;Hauts-de-France;59;1;07;241;Floyon;520;15;535
32;Hauts-de-France;59;1;07;242;Fontaine-au-Bois;674;7;681
32;Hauts-de-France;59;2;10;243;Fontaine-au-Pire;1220;18;1238
32;Hauts-de-France;59;2;09;244;Fontaine-Notre-Dame;1776;31;1807
32;Hauts-de-France;59;1;07;246;Forest-en-Cambrésis;570;4;574
32;Hauts-de-France;59;5;40;247;Forest-sur-Marque;1462;18;1480
32;Hauts-de-France;59;1;19;249;Fourmies;11563;191;11754
32;Hauts-de-France;59;5;02;250;Fournes-en-Weppes;2231;105;2336
32;Hauts-de-France;59;1;05;251;Frasnoy;376;4;380
32;Hauts-de-France;59;5;04;252;Frelinghien;2447;20;2467
32;Hauts-de-France;59;6;03;253;Fresnes-sur-Escaut;7499;41;7540
32;Hauts-de-France;59;3;01;254;Fressain;880;12;892
32;Hauts-de-France;59;2;09;255;Fressies;571;8;579
32;Hauts-de-France;59;5;36;256;Fretin;3290;33;3323
32;Hauts-de-France;59;5;02;257;Fromelles;1041;15;1056
32;Hauts-de-France;59;5;36;258;Genech;2827;642;3469
32;Hauts-de-France;59;1;07;259;Ghissignies;511;20;531
32;Hauts-de-France;59;4;17;260;Ghyvelde;4131;60;4191
32;Hauts-de-France;59;1;19;261;Glageon;1758;29;1787
32;Hauts-de-France;59;4;08;262;Godewaersvelde;2086;38;2124
32;Hauts-de-France;59;3;01;263;Gœulzin;1049;26;1075
32;Hauts-de-France;59;1;30;264;Gognies-Chaussée;730;11;741
32;Hauts-de-France;59;1;05;265;Gommegnies;2308;36;2344
32;Hauts-de-France;59;5;18;266;Gondecourt;4031;42;4073
32;Hauts-de-France;59;2;10;267;Gonnelieu;302;4;306
32;Hauts-de-France;59;4;21;268;La Gorgue;5639;49;5688
32;Hauts-de-France;59;2;10;269;Gouzeaucourt;1475;25;1500
32;Hauts-de-France;59;1;07;270;Grand-Fayt;482;7;489
32;Hauts-de-France;59;4;20;271;Grande-Synthe;22522;209;22731
32;Hauts-de-France;59;4;20;272;Grand-Fort-Philippe;5130;47;5177
32;Hauts-de-France;59;4;20;273;Gravelines;11014;188;11202
32;Hauts-de-France;59;2;10;274;La Groise;482;4;486
32;Hauts-de-France;59;5;36;275;Gruson;1267;36;1303
32;Hauts-de-France;59;3;01;276;Guesnain;4689;34;4723
32;Hauts-de-France;59;1;05;277;Gussignies;332;4;336
32;Hauts-de-France;59;5;28;278;Hallennes-lez-Haubourdin;4676;37;4713
32;Hauts-de-France;59;5;37;279;Halluin;20743;114;20857
32;Hauts-de-France;59;3;01;280;Hamel;788;10;798
32;Hauts-de-France;59;5;02;281;Hantay;1281;12;1293
32;Hauts-de-France;59;4;41;282;Hardifort;407;11;418
32;Hauts-de-France;59;1;05;283;Hargnies;613;10;623
32;Hauts-de-France;59;6;34;284;Hasnon;3918;31;3949
32;Hauts-de-France;59;6;06;285;Haspres;2680;20;2700
32;Hauts-de-France;59;5;18;286;Haubourdin;14725;115;14840
32;Hauts-de-France;59;2;10;287;Haucourt-en-Cambrésis;193;4;197
32;Hauts-de-France;59;6;06;288;Haulchin;2340;26;2366
32;Hauts-de-France;59;2;11;289;Haussy;1521;33;1554
32;Hauts-de-France;59;1;07;290;Haut-Lieu;394;1;395
32;Hauts-de-France;59;1;07;291;Hautmont;14517;97;14614
32;Hauts-de-France;59;6;06;292;Haveluy;3304;6;3310
32;Hauts-de-France;59;4;21;293;Haverskerque;1413;18;1431
32;Hauts-de-France;59;2;09;294;Haynecourt;314;7;321
32;Hauts-de-France;59;4;21;295;Hazebrouck;21408;457;21865
32;Hauts-de-France;59;1;07;296;Hecq;354;10;364
32;Hauts-de-France;59;6;34;297;Hélesmes;1979;9;1988
32;Hauts-de-France;59;5;13;299;Hem;18636;174;18810
32;Hauts-de-France;59;2;09;300;Hem-Lenglet;548;9;557
32;Hauts-de-France;59;6;29;301;Hergnies;4433;27;4460
32;Hauts-de-France;59;6;06;302;Hérin;4127;29;4156
32;Hauts-de-France;59;5;02;303;Herlies;2393;27;2420
32;Hauts-de-France;59;5;18;304;Herrin;418;8;426
32;Hauts-de-France;59;4;41;305;Herzeele;1649;34;1683
32;Hauts-de-France;59;1;19;306;Hestrud;292;3;295
32;Hauts-de-France;59;4;41;307;Holque;903;5;908
32;Hauts-de-France;59;4;08;308;Hondeghem;934;24;958
32;Hauts-de-France;59;4;41;309;Hondschoote;4060;82;4142
32;Hauts-de-France;59;1;05;310;Hon-Hergies;867;10;877
32;Hauts-de-France;59;2;10;311;Honnechy;561;7;568
32;Hauts-de-France;59;2;10;312;Honnecourt-sur-Escaut;760;17;777
32;Hauts-de-France;59;6;14;313;Hordain;1423;9;1432
32;Hauts-de-France;59;3;35;314;Hornaing;3562;21;3583
32;Hauts-de-France;59;1;05;315;Houdain-lez-Bavay;886;12;898
32;Hauts-de-France;59;5;18;316;Houplin-Ancoisne;3337;47;3384
32;Hauts-de-France;59;5;04;317;Houplines;7782;94;7876
32;Hauts-de-France;59;4;41;318;Houtkerque;984;8;992
32;Hauts-de-France;59;4;41;319;Hoymille;3194;202;3396
32;Hauts-de-France;59;5;02;320;Illies;1635;12;1647
32;Hauts-de-France;59;2;10;321;Inchy;676;5;681
32;Hauts-de-France;59;2;11;322;Iwuy;3371;31;3402
32;Hauts-de-France;59;1;05;323;Jenlain;1145;26;1171
32;Hauts-de-France;59;1;30;324;Jeumont;10344;111;10455
32;Hauts-de-France;59;1;07;325;Jolimetz;854;16;870
32;Hauts-de-France;59;4;41;326;Killem;1163;21;1184
32;Hauts-de-France;59;3;35;327;Lallaing;6364;39;6403
32;Hauts-de-France;59;5;22;328;Lambersart;27400;435;27835
32;Hauts-de-France;59;3;15;329;Lambres-lez-Douai;5007;84;5091
32;Hauts-de-France;59;3;31;330;Landas;2392;42;2434
32;Hauts-de-France;59;1;07;331;Landrecies;3482;107;3589
32;Hauts-de-France;59;5;13;332;Lannoy;1819;7;1826
32;Hauts-de-France;59;1;07;333;Larouillies;249;9;258
32;Hauts-de-France;59;3;15;334;Lauwin-Planque;1621;23;1644
32;Hauts-de-France;59;6;34;335;Lecelles;2847;55;2902
32;Hauts-de-France;59;3;01;336;Lécluse;1372;13;1385
32;Hauts-de-France;59;4;41;337;Lederzeele;683;21;704
32;Hauts-de-France;59;4;41;338;Ledringhem;651;27;678
32;Hauts-de-France;59;5;33;339;Leers;9378;80;9458
32;Hauts-de-France;59;4;17;340;Leffrinckoucke;4207;97;4304
32;Hauts-de-France;59;2;10;341;Lesdain;435;7;442
32;Hauts-de-France;59;1;19;342;Lez-Fontaine;225;4;229
32;Hauts-de-France;59;5;36;343;Lesquin;9012;85;9097
32;Hauts-de-France;59;1;05;344;Leval;2516;10;2526
32;Hauts-de-France;59;3;01;345;Lewarde;2430;23;2453
32;Hauts-de-France;59;5;26;346;Lezennes;3050;21;3071
32;Hauts-de-France;59;1;19;347;Liessies;537;16;553
32;Hauts-de-France;59;6;14;348;Lieu-Saint-Amand;1426;15;1441
32;Hauts-de-France;59;2;10;349;Ligny-en-Cambrésis;1916;30;1946
32;Hauts-de-France;59;5;97;350;Lille;234475;1925;236400
32;Hauts-de-France;59;1;07;351;Limont-Fontaine;550;7;557
32;Hauts-de-France;59;5;22;352;Linselles;8275;97;8372
32;Hauts-de-France;59;1;07;353;Locquignol;326;7;333
32;Hauts-de-France;59;3;01;354;Loffre;714;13;727
32;Hauts-de-France;59;5;22;356;Lompret;2230;48;2278
32;Hauts-de-France;59;1;05;357;La Longueville;2082;33;2115
32;Hauts-de-France;59;4;20;358;Looberghe;1190;23;1213
32;Hauts-de-France;59;4;20;359;Loon-Plage;6085;76;6161
32;Hauts-de-France;59;5;28;360;Loos;22866;241;23107
32;Hauts-de-France;59;6;14;361;Lourches;3952;18;3970
32;Hauts-de-France;59;1;07;363;Louvignies-Quesnoy;931;19;950
32;Hauts-de-France;59;5;36;364;Louvil;869;12;881
32;Hauts-de-France;59;1;30;365;Louvroil;6371;39;6410
32;Hauts-de-France;59;4;21;366;Lynde;775;15;790
32;Hauts-de-France;59;5;13;367;Lys-lez-Lannoy;13643;151;13794
32;Hauts-de-France;59;5;23;368;La Madeleine;21856;188;22044
32;Hauts-de-France;59;6;06;369;Maing;4066;40;4106
32;Hauts-de-France;59;1;30;370;Mairieux;711;11;722
32;Hauts-de-France;59;5;02;371;Le Maisnil;639;15;654
32;Hauts-de-France;59;2;10;372;Malincourt;489;6;495
32;Hauts-de-France;59;1;07;374;Marbaix;473;4;477
32;Hauts-de-France;59;3;35;375;Marchiennes;4584;63;4647
32;Hauts-de-France;59;2;10;377;Marcoing;1900;25;1925
32;Hauts-de-France;59;5;24;378;Marcq-en-Barœul;38486;697;39183
32;Hauts-de-France;59;3;01;379;Marcq-en-Ostrevent;748;3;751
32;Hauts-de-France;59;1;07;381;Maresches;812;20;832
32;Hauts-de-France;59;2;10;382;Maretz;1444;15;1459
32;Hauts-de-France;59;6;29;383;Marly;12083;114;12197
32;Hauts-de-France;59;1;07;384;Maroilles;1428;23;1451
32;Hauts-de-France;59;1;30;385;Marpent;2701;21;2722
32;Hauts-de-France;59;5;23;386;Marquette-lez-Lille;10798;69;10867
32;Hauts-de-France;59;6;14;387;Marquette-en-Ostrevant;1897;12;1909
32;Hauts-de-France;59;5;02;388;Marquillies;1998;24;2022
32;Hauts-de-France;59;2;10;389;Masnières;2745;29;2774
32;Hauts-de-France;59;3;01;390;Masny;4109;45;4154
32;Hauts-de-France;59;6;14;391;Mastaing;881;5;886
32;Hauts-de-France;59;1;30;392;Maubeuge;29589;283;29872
32;Hauts-de-France;59;6;34;393;Maulde;1033;12;1045
32;Hauts-de-France;59;2;10;394;Maurois;403;3;406
32;Hauts-de-France;59;2;10;395;Mazinghien;305;4;309
32;Hauts-de-France;59;1;05;396;Mecquignies;720;7;727
32;Hauts-de-France;59;4;41;397;Merckeghem;606;12;618
32;Hauts-de-France;59;5;36;398;Mérignies;3199;136;3335
32;Hauts-de-France;59;4;08;399;Merris;1011;28;1039
32;Hauts-de-France;59;4;21;400;Merville;9641;89;9730
32;Hauts-de-France;59;4;08;401;Méteren;2307;37;2344
32;Hauts-de-France;59;4;41;402;Millam;837;22;859
32;Hauts-de-France;59;6;34;403;Millonfosse;718;12;730
32;Hauts-de-France;59;2;09;405;Mœuvres;481;3;484
32;Hauts-de-France;59;1;05;406;Monceau-Saint-Waast;455;6;461
32;Hauts-de-France;59;6;06;407;Monchaux-sur-Écaillon;538;9;547
32;Hauts-de-France;59;5;36;408;Moncheaux;1632;19;1651
32;Hauts-de-France;59;3;01;409;Monchecourt;2521;20;2541
32;Hauts-de-France;59;5;25;410;Mons-en-Barœul;21277;138;21415
32;Hauts-de-France;59;5;36;411;Mons-en-Pévèle;2115;37;2152
32;Hauts-de-France;59;2;10;412;Montay;276;4;280
32;Hauts-de-France;59;2;10;413;Montigny-en-Cambrésis;557;9;566
32;Hauts-de-France;59;3;01;414;Montigny-en-Ostrevent;4793;40;4833
32;Hauts-de-France;59;2;11;415;Montrécourt;224;1;225
32;Hauts-de-France;59;4;21;416;Morbecque;2524;41;2565
32;Hauts-de-France;59;6;34;418;Mortagne-du-Nord;1595;7;1602
32;Hauts-de-France;59;5;36;419;Mouchin;1408;16;1424
32;Hauts-de-France;59;1;19;420;Moustier-en-Fagne;58;2;60
32;Hauts-de-France;59;5;24;421;Mouvaux;13121;177;13298
32;Hauts-de-France;59;2;11;422;Naves;630;12;642
32;Hauts-de-France;59;4;21;423;Neuf-Berquin;1263;19;1282
32;Hauts-de-France;59;1;05;424;Neuf-Mesnil;1309;5;1314
32;Hauts-de-France;59;1;07;425;Neuville-en-Avesnois;302;8;310
32;Hauts-de-France;59;5;37;426;Neuville-en-Ferrain;10264;68;10332
32;Hauts-de-France;59;5;36;427;La Neuville;640;10;650
32;Hauts-de-France;59;2;09;428;Neuville-Saint-Rémy;3782;40;3822
32;Hauts-de-France;59;6;14;429;Neuville-sur-Escaut;2688;16;2704
32;Hauts-de-France;59;2;10;430;Neuvilly;1088;12;1100
32;Hauts-de-France;59;4;08;431;Nieppe;7512;79;7591
32;Hauts-de-France;59;2;10;432;Niergnies;514;7;521
32;Hauts-de-France;59;4;41;433;Nieurlet;917;13;930
32;Hauts-de-France;59;6;34;434;Nivelle;1351;17;1368
32;Hauts-de-France;59;3;31;435;Nomain;2549;37;2586
32;Hauts-de-France;59;4;41;436;Noordpeene;788;10;798
32;Hauts-de-France;59;5;18;437;Noyelles-lès-Seclin;858;12;870
32;Hauts-de-France;59;2;10;438;Noyelles-sur-Escaut;811;13;824
32;Hauts-de-France;59;1;05;439;Noyelles-sur-Sambre;271;5;276
32;Hauts-de-France;59;6;14;440;Noyelles-sur-Selle;697;6;703
32;Hauts-de-France;59;1;05;441;Obies;660;6;666
32;Hauts-de-France;59;1;19;442;Obrechies;269;6;275
32;Hauts-de-France;59;4;41;443;Ochtezeele;385;5;390
32;Hauts-de-France;59;6;29;444;Odomez;924;11;935
32;Hauts-de-France;59;1;19;445;Ohain;1189;17;1206
32;Hauts-de-France;59;6;06;446;Oisy;649;8;657
32;Hauts-de-France;59;6;03;447;Onnaing;8789;64;8853
32;Hauts-de-France;59;4;41;448;Oost-Cappel;471;5;476
32;Hauts-de-France;59;3;31;449;Orchies;8633;145;8778
32;Hauts-de-France;59;2;10;450;Ors;640;9;649
32;Hauts-de-France;59;1;07;451;Orsinval;553;3;556
32;Hauts-de-France;59;5;02;452;Ostricourt;5454;26;5480
32;Hauts-de-France;59;4;41;453;Oudezeele;677;14;691
32;Hauts-de-France;59;4;08;454;Oxelaëre;517;4;521
32;Hauts-de-France;59;2;09;455;Paillencourt;1009;8;1017
32;Hauts-de-France;59;3;35;456;Pecquencourt;6088;262;6350
32;Hauts-de-France;59;5;04;457;Pérenchies;8542;42;8584
32;Hauts-de-France;59;5;36;458;Péronne-en-Mélantois;918;19;937
32;Hauts-de-France;59;6;06;459;Petite-Forêt;4887;37;4924
32;Hauts-de-France;59;1;07;461;Petit-Fayt;310;2;312
32;Hauts-de-France;59;5;02;462;Phalempin;4820;38;4858
32;Hauts-de-France;59;4;20;463;Pitgam;973;12;985
32;Hauts-de-France;59;1;07;464;Poix-du-Nord;2222;18;2240
32;Hauts-de-France;59;2;10;465;Pommereuil;776;3;779
32;Hauts-de-France;59;5;36;466;Pont-à-Marcq;2911;92;3003
32;Hauts-de-France;59;1;05;467;Pont-sur-Sambre;2469;27;2496
32;Hauts-de-France;59;1;07;468;Potelle;425;4;429
32;Hauts-de-France;59;4;08;469;Pradelles;412;4;416
32;Hauts-de-France;59;5;04;470;Prémesques;2123;24;2147
32;Hauts-de-France;59;6;29;471;Préseau;1993;24;2017
32;Hauts-de-France;59;1;07;472;Preux-au-Bois;837;10;847
32;Hauts-de-France;59;1;05;473;Preux-au-Sart;309;7;316
32;Hauts-de-France;59;1;07;474;Prisches;1036;21;1057
32;Hauts-de-France;59;6;06;475;Prouvy;2220;26;2246
32;Hauts-de-France;59;2;09;476;Proville;3124;75;3199
32;Hauts-de-France;59;5;02;477;Provin;4403;40;4443
32;Hauts-de-France;59;4;41;478;Quaëdypre;1129;26;1155
32;Hauts-de-France;59;6;29;479;Quarouble;3077;26;3103
32;Hauts-de-France;59;6;06;480;Quérénaing;870;20;890
32;Hauts-de-France;59;1;07;481;Le Quesnoy;4870;120;4990
32;Hauts-de-France;59;5;22;482;Quesnoy-sur-Deûle;6931;62;6993
32;Hauts-de-France;59;1;19;483;Quiévelon;136;2;138
32;Hauts-de-France;59;6;29;484;Quiévrechain;6362;33;6395
32;Hauts-de-France;59;2;11;485;Quiévy;1802;21;1823
32;Hauts-de-France;59;3;31;486;Râches;2701;44;2745
32;Hauts-de-France;59;5;02;487;Radinghem-en-Weppes;1401;19;1420
32;Hauts-de-France;59;2;09;488;Raillencourt-Sainte-Olle;2179;40;2219
32;Hauts-de-France;59;3;31;489;Raimbeaucourt;4008;55;4063
32;Hauts-de-France;59;1;19;490;Rainsars;177;2;179
32;Hauts-de-France;59;6;34;491;Raismes;12324;64;12388
32;Hauts-de-France;59;2;09;492;Ramillies;602;7;609
32;Hauts-de-France;59;1;19;493;Ramousies;228;1;229
32;Hauts-de-France;59;1;07;494;Raucourt-au-Bois;162;1;163
32;Hauts-de-France;59;1;19;495;Recquignies;2446;24;2470
32;Hauts-de-France;59;2;10;496;Rejet-de-Beaulieu;242;1;243
32;Hauts-de-France;59;4;21;497;Renescure;2120;30;2150
32;Hauts-de-France;59;2;10;498;Reumont;352;8;360
32;Hauts-de-France;59;4;41;499;Rexpoëde;1977;33;2010
32;Hauts-de-France;59;2;10;500;Ribécourt-la-Tour;373;5;378
32;Hauts-de-France;59;3;35;501;Rieulay;1261;26;1287
32;Hauts-de-France;59;2;11;502;Rieux-en-Cambrésis;1432;9;1441
32;Hauts-de-France;59;1;07;503;Robersart;198;3;201
32;Hauts-de-France;59;6;14;504;Rœulx;3807;21;3828
32;Hauts-de-France;59;6;29;505;Rombies-et-Marchipont;760;3;763
32;Hauts-de-France;59;2;11;506;Romeries;469;7;476
32;Hauts-de-France;59;5;26;507;Ronchin;19294;120;19414
32;Hauts-de-France;59;5;37;508;Roncq;13482;129;13611
32;Hauts-de-France;59;3;31;509;Roost-Warendin;6037;48;6085
32;Hauts-de-France;59;6;34;511;Rosult;1931;27;1958
32;Hauts-de-France;59;5;98;512;Roubaix;98828;466;99294
32;Hauts-de-France;59;3;01;513;Roucourt;456;7;463
32;Hauts-de-France;59;1;19;514;Rousies;4072;53;4125
32;Hauts-de-France;59;6;06;515;Rouvignies;655;6;661
32;Hauts-de-France;59;4;41;516;Rubrouck;928;19;947
32;Hauts-de-France;59;2;10;517;Les Rues-des-Vignes;771;14;785
32;Hauts-de-France;59;1;07;518;Ruesnes;459;7;466
32;Hauts-de-France;59;6;34;519;Rumegies;1758;33;1791
32;Hauts-de-France;59;2;10;520;Rumilly-en-Cambrésis;1436;25;1461
32;Hauts-de-France;59;2;09;521;Sailly-lez-Cambrai;443;8;451
32;Hauts-de-France;59;5;40;522;Sailly-lez-Lannoy;1937;38;1975
32;Hauts-de-France;59;5;36;523;Sainghin-en-Mélantois;2830;27;2857
32;Hauts-de-France;59;5;02;524;Sainghin-en-Weppes;5481;51;5532
32;Hauts-de-France;59;1;19;525;Sains-du-Nord;2799;25;2824
32;Hauts-de-France;59;6;34;526;Saint-Amand-les-Eaux;15870;164;16034
32;Hauts-de-France;59;5;23;527;Saint-André-lez-Lille;13151;117;13268
32;Hauts-de-France;59;2;11;528;Saint-Aubert;1565;17;1582
32;Hauts-de-France;59;1;07;529;Saint-Aubin;354;8;362
32;Hauts-de-France;59;6;29;530;Saint-Aybert;348;1;349
32;Hauts-de-France;59;2;10;531;Saint-Benin;340;3;343
32;Hauts-de-France;59;4;20;532;Saint-Georges-sur-l'Aa;309;8;317
32;Hauts-de-France;59;2;11;533;Saint-Hilaire-lez-Cambrai;1566;14;1580
32;Hauts-de-France;59;1;07;534;Saint-Hilaire-sur-Helpe;827;31;858
32;Hauts-de-France;59;4;08;535;Saint-Jans-Cappel;1706;49;1755
32;Hauts-de-France;59;4;08;536;Sainte-Marie-Cappel;902;22;924
32;Hauts-de-France;59;2;11;537;Saint-Martin-sur-Écaillon;506;9;515
32;Hauts-de-France;59;4;41;538;Saint-Momelin;425;11;436
32;Hauts-de-France;59;4;20;539;Saint-Pierre-Brouck;985;18;1003
32;Hauts-de-France;59;2;11;541;Saint-Python;1027;7;1034
32;Hauts-de-France;59;1;05;542;Saint-Remy-Chaussée;511;12;523
32;Hauts-de-France;59;1;07;543;Saint-Remy-du-Nord;1095;10;1105
32;Hauts-de-France;59;6;39;544;Saint-Saulve;11276;159;11435
32;Hauts-de-France;59;2;10;545;Saint-Souplet;1216;23;1239
32;Hauts-de-France;59;4;08;546;Saint-Sylvestre-Cappel;1160;29;1189
32;Hauts-de-France;59;2;11;547;Saint-Vaast-en-Cambrésis;853;9;862
32;Hauts-de-France;59;1;05;548;Saint-Waast;640;8;648
32;Hauts-de-France;59;1;07;549;Salesches;327;3;330
32;Hauts-de-France;59;5;02;550;Salomé;2945;22;2967
32;Hauts-de-France;59;3;31;551;Saméon;1707;24;1731
32;Hauts-de-France;59;2;09;552;Sancourt;196;6;202
32;Hauts-de-France;59;5;28;553;Santes;5608;50;5658
32;Hauts-de-France;59;6;34;554;Sars-et-Rosières;608;15;623
32;Hauts-de-France;59;1;19;555;Sars-Poteries;1437;18;1455
32;Hauts-de-France;59;1;05;556;Sassegnies;259;3;262
32;Hauts-de-France;59;6;29;557;Saultain;2492;16;2508
32;Hauts-de-France;59;2;11;558;Saulzoir;1688;19;1707
32;Hauts-de-France;59;6;29;559;Sebourg;1974;32;2006
32;Hauts-de-France;59;5;18;560;Seclin;12463;94;12557
32;Hauts-de-France;59;1;19;562;Sémeries;544;7;551
32;Hauts-de-France;59;1;07;563;Semousies;237;3;240
32;Hauts-de-France;59;6;06;564;La Sentinelle;3117;16;3133
32;Hauts-de-France;59;1;07;565;Sepmeries;651;11;662
32;Hauts-de-France;59;5;28;566;Sequedin;4775;37;4812
32;Hauts-de-France;59;2;10;567;Séranvillers-Forenville;414;6;420
32;Hauts-de-France;59;4;21;568;Sercus;476;8;484
32;Hauts-de-France;59;3;35;569;Sin-le-Noble;15428;109;15537
32;Hauts-de-France;59;4;41;570;Socx;923;35;958
32;Hauts-de-France;59;2;11;571;Solesmes;4290;108;4398
32;Hauts-de-France;59;1;19;572;Solre-le-Château;1780;21;1801
32;Hauts-de-France;59;1;19;573;Solrinnes;139;3;142
32;Hauts-de-France;59;3;35;574;Somain;11934;77;12011
32;Hauts-de-France;59;2;11;575;Sommaing;403;4;407
32;Hauts-de-France;59;4;12;576;Spycker;1806;27;1833
32;Hauts-de-France;59;4;08;577;Staple;649;5;654
32;Hauts-de-France;59;4;21;578;Steenbecque;1673;30;1703
32;Hauts-de-France;59;4;12;579;Steene;1371;25;1396
32;Hauts-de-France;59;4;41;580;Steenvoorde;4429;85;4514
32;Hauts-de-France;59;4;08;581;Steenwerck;3672;54;3726
32;Hauts-de-France;59;4;08;582;Strazeele;948;23;971
32;Hauts-de-France;59;1;07;583;Taisnières-en-Thiérache;471;4;475
32;Hauts-de-France;59;1;05;584;Taisnières-sur-Hon;957;12;969
32;Hauts-de-France;59;5;18;585;Templemars;3465;34;3499
32;Hauts-de-France;59;5;36;586;Templeuve-en-Pévèle;6332;87;6419
32;Hauts-de-France;59;4;41;587;Terdeghem;522;14;536
32;Hauts-de-France;59;4;12;588;Téteghem-Coudekerque-Village;8285;220;8505
32;Hauts-de-France;59;6;06;589;Thiant;2999;25;3024
32;Hauts-de-France;59;4;21;590;Thiennes;912;14;926
32;Hauts-de-France;59;6;29;591;Thivencelle;836;3;839
32;Hauts-de-France;59;5;36;592;Thumeries;3884;33;3917
32;Hauts-de-France;59;2;09;593;Thun-l'Évêque;751;11;762
32;Hauts-de-France;59;6;34;594;Thun-Saint-Amand;1119;13;1132
32;Hauts-de-France;59;2;09;595;Thun-Saint-Martin;541;7;548
32;Hauts-de-France;59;3;35;596;Tilloy-lez-Marchiennes;509;17;526
32;Hauts-de-France;59;2;09;597;Tilloy-lez-Cambrai;651;23;674
32;Hauts-de-France;59;5;40;598;Toufflers;3911;29;3940
32;Hauts-de-France;59;5;99;599;Tourcoing;98656;689;99345
32;Hauts-de-France;59;5;36;600;Tourmignies;903;14;917
32;Hauts-de-France;59;1;19;601;Trélon;2771;66;2837
32;Hauts-de-France;59;5;36;602;Tressin;1405;30;1435
32;Hauts-de-France;59;6;06;603;Trith-Saint-Léger;6292;88;6380
32;Hauts-de-France;59;2;10;604;Troisvilles;824;7;831
32;Hauts-de-France;59;4;12;605;Uxem;1443;24;1467
32;Hauts-de-France;59;6;39;606;Valenciennes;43229;448;43677
32;Hauts-de-France;59;1;07;607;Vendegies-au-Bois;488;5;493
32;Hauts-de-France;59;2;11;608;Vendegies-sur-Écaillon;1098;21;1119
32;Hauts-de-France;59;5;18;609;Vendeville;1564;21;1585
32;Hauts-de-France;59;6;06;610;Verchain-Maugré;1073;9;1082
32;Hauts-de-France;59;5;22;611;Verlinghem;2483;55;2538
32;Hauts-de-France;59;2;11;612;Vertain;510;10;520
32;Hauts-de-France;59;6;29;613;Vicq;1464;14;1478
32;Hauts-de-France;59;2;11;614;Viesly;1414;20;1434
32;Hauts-de-France;59;4;08;615;Vieux-Berquin;2512;42;2554
32;Hauts-de-France;59;6;29;616;Vieux-Condé;10465;51;10516
32;Hauts-de-France;59;1;05;617;Vieux-Mesnil;635;7;642
32;Hauts-de-France;59;1;30;618;Vieux-Reng;881;6;887
32;Hauts-de-France;59;1;05;619;Villereau;1046;15;1061
32;Hauts-de-France;59;3;01;620;Villers-au-Tertre;661;6;667
32;Hauts-de-France;59;2;11;622;Villers-en-Cauchies;1187;17;1204
32;Hauts-de-France;59;2;10;623;Villers-Guislain;691;4;695
32;Hauts-de-France;59;2;10;624;Villers-Outréaux;2142;26;2168
32;Hauts-de-France;59;2;10;625;Villers-Plouich;396;4;400
32;Hauts-de-France;59;1;07;626;Villers-Pol;1287;21;1308
32;Hauts-de-France;59;1;30;627;Villers-Sire-Nicole;1008;11;1019
32;Hauts-de-France;59;4;41;628;Volckerinckhove;563;6;569
32;Hauts-de-France;59;3;35;629;Vred;1338;23;1361
32;Hauts-de-France;59;5;02;630;Wahagnies;2636;40;2676
32;Hauts-de-France;59;2;10;631;Walincourt-Selvigny;2153;30;2183
32;Hauts-de-France;59;6;34;632;Wallers;5610;39;5649
32;Hauts-de-France;59;1;19;633;Wallers-en-Fagne;282;7;289
32;Hauts-de-France;59;4;21;634;Wallon-Cappel;794;20;814
32;Hauts-de-France;59;2;10;635;Wambaix;363;6;369
32;Hauts-de-France;59;5;23;636;Wambrechies;10608;104;10712
32;Hauts-de-France;59;3;35;637;Wandignies-Hamage;1319;14;1333
32;Hauts-de-France;59;5;36;638;Wannehain;1330;15;1345
32;Hauts-de-France;59;1;05;639;Wargnies-le-Grand;1102;23;1125
32;Hauts-de-France;59;1;05;640;Wargnies-le-Petit;767;11;778
32;Hauts-de-France;59;4;41;641;Warhem;1996;43;2039
32;Hauts-de-France;59;3;35;642;Warlaing;581;17;598
32;Hauts-de-France;59;5;04;643;Warneton;237;2;239
32;Hauts-de-France;59;6;14;645;Wasnes-au-Bac;595;4;599
32;Hauts-de-France;59;5;13;646;Wasquehal;20860;232;21092
32;Hauts-de-France;59;4;41;647;Watten;2599;29;2628
32;Hauts-de-France;59;5;18;648;Wattignies;15075;193;15268
32;Hauts-de-France;59;1;19;649;Wattignies-la-Victoire;240;5;245
32;Hauts-de-France;59;5;33;650;Wattrelos;40898;172;41070
32;Hauts-de-France;59;6;14;651;Wavrechain-sous-Denain;1637;12;1649
32;Hauts-de-France;59;6;14;652;Wavrechain-sous-Faulx;409;1;410
32;Hauts-de-France;59;5;02;653;Wavrin;7771;64;7835
32;Hauts-de-France;59;3;35;654;Waziers;7402;69;7471
32;Hauts-de-France;59;4;41;655;Wemaers-Cappel;254;4;258
32;Hauts-de-France;59;5;22;656;Wervicq-Sud;5353;50;5403
32;Hauts-de-France;59;4;41;657;West-Cappel;637;7;644
32;Hauts-de-France;59;5;02;658;Wicres;522;7;529
32;Hauts-de-France;59;1;19;659;Wignehies;2855;33;2888
32;Hauts-de-France;59;5;40;660;Willems;3048;40;3088
32;Hauts-de-France;59;1;19;661;Willies;136;2;138
32;Hauts-de-France;59;4;41;662;Winnezeele;1313;23;1336
32;Hauts-de-France;59;4;41;663;Wormhout;5672;83;5755
32;Hauts-de-France;59;4;41;664;Wulverdinghe;317;4;321
32;Hauts-de-France;59;4;41;665;Wylder;296;6;302
32;Hauts-de-France;59;4;41;666;Zegerscappel;1536;25;1561
32;Hauts-de-France;59;4;41;667;Zermezeele;228;6;234
32;Hauts-de-France;59;4;17;668;Zuydcoote;1601;60;1661
32;Hauts-de-France;59;4;41;669;Zuytpeene;518;17;535
32;Hauts-de-France;59;5;02;670;Don;1337;13;1350
32;Hauts-de-France;60;1;11;001;Abancourt;621;8;629
32;Hauts-de-France;60;1;04;002;Abbecourt;807;24;831
32;Hauts-de-France;60;2;19;003;Abbeville-Saint-Lucien;503;13;516
32;Hauts-de-France;60;1;11;004;Achy;405;7;412
32;Hauts-de-France;60;4;15;005;Acy-en-Multien;872;13;885
32;Hauts-de-France;60;2;18;006;Les Ageux;1155;20;1175
32;Hauts-de-France;60;2;05;007;Agnetz;3044;97;3141
32;Hauts-de-France;60;2;19;008;Airion;378;163;541
32;Hauts-de-France;60;1;02;009;Allonne;1622;30;1652
32;Hauts-de-France;60;1;12;010;Amblainville;1747;17;1764
32;Hauts-de-France;60;3;21;011;Amy;404;5;409
32;Hauts-de-France;60;1;12;012;Andeville;3286;49;3335
32;Hauts-de-France;60;2;18;013;Angicourt;1393;29;1422
32;Hauts-de-France;60;2;19;014;Angivillers;172;5;177
32;Hauts-de-France;60;2;14;015;Angy;1154;14;1168
32;Hauts-de-France;60;2;14;016;Ansacq;274;8;282
32;Hauts-de-France;60;2;19;017;Ansauvillers;1208;25;1233
32;Hauts-de-France;60;3;10;019;Antheuil-Portes;414;12;426
32;Hauts-de-France;60;4;15;020;Antilly;256;8;264
32;Hauts-de-France;60;3;17;021;Appilly;549;8;557
32;Hauts-de-France;60;4;03;022;Apremont;644;15;659
32;Hauts-de-France;60;3;07;023;Armancourt;547;17;564
32;Hauts-de-France;60;3;10;024;Arsy;769;8;777
32;Hauts-de-France;60;3;06;025;Attichy;1881;40;1921
32;Hauts-de-France;60;1;19;026;Auchy-la-Montagne;585;13;598
32;Hauts-de-France;60;4;09;027;Auger-Saint-Vincent;537;14;551
32;Hauts-de-France;60;4;20;028;Aumont-en-Halatte;459;25;484
32;Hauts-de-France;60;1;02;029;Auneuil;2836;60;2896
32;Hauts-de-France;60;1;02;030;Auteuil;558;9;567
32;Hauts-de-France;60;4;15;031;Autheuil-en-Valois;270;8;278
32;Hauts-de-France;60;3;06;032;Autrêches;719;14;733
32;Hauts-de-France;60;4;20;033;Avilly-Saint-Léonard;888;39;927
32;Hauts-de-France;60;2;19;034;Avrechy;1156;17;1173
32;Hauts-de-France;60;3;21;035;Avricourt;250;4;254
32;Hauts-de-France;60;2;10;036;Avrigny;384;6;390
32;Hauts-de-France;60;3;17;037;Babœuf;509;7;516
32;Hauts-de-France;60;2;19;039;Bacouël;487;6;493
32;Hauts-de-France;60;2;10;040;Bailleul-le-Soc;646;11;657
32;Hauts-de-France;60;1;14;041;Bailleul-sur-Thérain;2318;55;2373
32;Hauts-de-France;60;2;05;042;Bailleval;1469;46;1515
32;Hauts-de-France;60;3;21;043;Bailly;622;13;635
32;Hauts-de-France;60;4;13;044;Balagny-sur-Thérain;1682;24;1706
32;Hauts-de-France;60;4;18;045;Barbery;578;10;588
32;Hauts-de-France;60;4;15;046;Bargny;339;7;346
32;Hauts-de-France;60;4;15;047;Baron;761;16;777
32;Hauts-de-France;60;3;10;048;Baugy;266;5;271
32;Hauts-de-France;60;1;11;049;Bazancourt;114;3;117
32;Hauts-de-France;60;2;18;050;Bazicourt;348;9;357
32;Hauts-de-France;60;1;11;051;Beaudéduit;180;1;181
32;Hauts-de-France;60;3;17;052;Beaugies-sous-Bois;98;3;101
32;Hauts-de-France;60;3;21;053;Beaulieu-les-Fontaines;595;50;645
32;Hauts-de-France;60;1;04;054;Les Hauts-Talican;867;21;888
32;Hauts-de-France;60;3;17;055;Beaurains-lès-Noyon;338;5;343
32;Hauts-de-France;60;4;18;056;Beaurepaire;66;1;67
32;Hauts-de-France;60;1;98;057;Beauvais;57071;1449;58520
32;Hauts-de-France;60;2;19;058;Beauvoir;216;4;220
32;Hauts-de-France;60;3;17;059;Béhéricourt;206;6;212
32;Hauts-de-France;60;4;12;060;Belle-Église;621;10;631
32;Hauts-de-France;60;3;10;061;Belloy;84;5;89
32;Hauts-de-France;60;3;17;062;Berlancourt;319;4;323
32;Hauts-de-France;60;1;02;063;Berneuil-en-Bray;787;37;824
32;Hauts-de-France;60;3;06;064;Berneuil-sur-Aisne;991;16;1007
32;Hauts-de-France;60;1;04;065;Berthecourt;1633;32;1665
32;Hauts-de-France;60;4;09;066;Béthancourt-en-Valois;205;10;215
32;Hauts-de-France;60;4;09;067;Béthisy-Saint-Martin;1005;20;1025
32;Hauts-de-France;60;4;09;068;Béthisy-Saint-Pierre;3108;40;3148
32;Hauts-de-France;60;4;15;069;Betz;1120;39;1159
32;Hauts-de-France;60;3;06;070;Bienville;453;10;463
32;Hauts-de-France;60;3;10;071;Biermont;173;5;178
32;Hauts-de-France;60;3;06;072;Bitry;316;12;328
32;Hauts-de-France;60;1;11;073;Blacourt;569;6;575
32;Hauts-de-France;60;4;13;074;Blaincourt-lès-Précy;1185;29;1214
32;Hauts-de-France;60;1;19;075;Blancfossé;143;1;144
32;Hauts-de-France;60;1;11;076;Blargies;522;7;529
32;Hauts-de-France;60;1;11;077;Blicourt;356;9;365
32;Hauts-de-France;60;2;10;078;Blincourt;108;2;110
32;Hauts-de-France;60;4;15;079;Boissy-Fresnoy;982;12;994
32;Hauts-de-France;60;1;14;081;Bonlier;476;9;485
32;Hauts-de-France;60;2;19;082;Bonneuil-les-Eaux;790;17;807
32;Hauts-de-France;60;4;09;083;Bonneuil-en-Valois;989;23;1012
32;Hauts-de-France;60;1;11;084;Bonnières;187;1;188
32;Hauts-de-France;60;2;19;085;Bonvillers;198;2;200
32;Hauts-de-France;60;4;03;086;Boran-sur-Oise;2142;44;2186
32;Hauts-de-France;60;4;15;087;Borest;338;18;356
32;Hauts-de-France;60;1;12;088;Bornel;4764;73;4837
32;Hauts-de-France;60;1;04;089;Boubiers;409;11;420
32;Hauts-de-France;60;1;04;090;Bouconvillers;383;7;390
32;Hauts-de-France;60;4;15;091;Bouillancy;407;6;413
32;Hauts-de-France;60;4;15;092;Boullarre;217;5;222
32;Hauts-de-France;60;3;10;093;Boulogne-la-Grasse;460;9;469
32;Hauts-de-France;60;4;15;094;Boursonne;317;6;323
32;Hauts-de-France;60;1;04;095;Boury-en-Vexin;343;7;350
32;Hauts-de-France;60;1;04;097;Boutencourt;206;6;212
32;Hauts-de-France;60;1;11;098;Bouvresse;153;1;154
32;Hauts-de-France;60;3;10;099;Braisnes-sur-Aronde;172;3;175
32;Hauts-de-France;60;4;18;100;Brasseuse;112;0;112
32;Hauts-de-France;60;4;15;101;Brégy;653;13;666
32;Hauts-de-France;60;2;18;102;Brenouille;2011;40;2051
32;Hauts-de-France;60;1;14;103;Bresles;4022;54;4076
32;Hauts-de-France;60;2;19;104;Breteuil;4221;115;4336
32;Hauts-de-France;60;3;17;105;Brétigny;421;8;429
32;Hauts-de-France;60;2;05;106;Breuil-le-Sec;2667;39;2706
32;Hauts-de-France;60;2;05;107;Breuil-le-Vert;3116;146;3262
32;Hauts-de-France;60;1;11;108;Briot;288;8;296
32;Hauts-de-France;60;1;11;109;Brombos;255;4;259
32;Hauts-de-France;60;1;11;110;Broquiers;247;0;247
32;Hauts-de-France;60;2;19;111;Broyes;153;2;155
32;Hauts-de-France;60;2;19;112;Brunvillers-la-Motte;349;1;350
32;Hauts-de-France;60;2;19;113;Bucamps;198;2;200
32;Hauts-de-France;60;1;11;114;Buicourt;148;0;148
32;Hauts-de-France;60;2;19;115;Bulles;878;16;894
32;Hauts-de-France;60;2;14;116;Bury;2961;38;2999
32;Hauts-de-France;60;3;17;117;Bussy;314;13;327
32;Hauts-de-France;60;3;17;118;Caisnes;506;9;515
32;Hauts-de-France;60;3;21;119;Cambronne-lès-Ribécourt;1943;38;1981
32;Hauts-de-France;60;2;14;120;Cambronne-lès-Clermont;1198;24;1222
32;Hauts-de-France;60;3;17;121;Campagne;159;4;163
32;Hauts-de-France;60;1;11;122;Campeaux;488;9;497
32;Hauts-de-France;60;2;19;123;Campremy;480;0;480
32;Hauts-de-France;60;3;21;124;Candor;310;7;317
32;Hauts-de-France;60;3;10;125;Canly;765;19;784
32;Hauts-de-France;60;3;21;126;Cannectancourt;502;6;508
32;Hauts-de-France;60;3;21;127;Canny-sur-Matz;399;3;402
32;Hauts-de-France;60;1;11;128;Canny-sur-Thérain;226;0;226
32;Hauts-de-France;60;3;17;129;Carlepont;1513;20;1533
32;Hauts-de-France;60;2;05;130;Catenoy;1037;23;1060
32;Hauts-de-France;60;1;19;131;Catheux;106;2;108
32;Hauts-de-France;60;3;17;132;Catigny;188;3;191
32;Hauts-de-France;60;2;19;133;Catillon-Fumechon;543;4;547
32;Hauts-de-France;60;2;16;134;Cauffry;2621;25;2646
32;Hauts-de-France;60;1;04;135;Cauvigny;1640;39;1679
32;Hauts-de-France;60;1;11;136;Cempuis;501;13;514
32;Hauts-de-France;60;2;10;137;Cernoy;295;3;298
32;Hauts-de-France;60;4;20;138;Chamant;908;28;936
32;Hauts-de-France;60;4;12;139;Chambly;10147;133;10280
32;Hauts-de-France;60;1;04;140;Chambors;313;4;317
32;Hauts-de-France;60;4;03;141;Chantilly;10950;228;11178
32;Hauts-de-France;60;4;20;142;La Chapelle-en-Serval;3140;90;3230
32;Hauts-de-France;60;1;04;143;Chaumont-en-Vexin;3340;42;3382
32;Hauts-de-France;60;1;04;144;Chavençon;177;3;180
32;Hauts-de-France;60;3;07;145;Chelles;473;13;486
32;Hauts-de-France;60;2;19;146;Chepoix;455;3;458
32;Hauts-de-France;60;3;21;147;Chevincourt;816;34;850
32;Hauts-de-France;60;4;15;148;Chèvreville;416;8;424
32;Hauts-de-France;60;3;10;149;Chevrières;2021;68;2089
32;Hauts-de-France;60;3;21;150;Chiry-Ourscamp;1212;18;1230
32;Hauts-de-France;60;3;06;151;Choisy-au-Bac;3288;105;3393
32;Hauts-de-France;60;2;10;152;Choisy-la-Victoire;245;1;246
32;Hauts-de-France;60;1;19;153;Choqueuse-les-Bénards;102;0;102
32;Hauts-de-France;60;2;18;154;Cinqueux;1588;58;1646
32;Hauts-de-France;60;4;13;155;Cires-lès-Mello;3996;50;4046
32;Hauts-de-France;60;3;06;156;Clairoix;2224;46;2270
32;Hauts-de-France;60;2;05;157;Clermont;10163;235;10398
32;Hauts-de-France;60;2;10;158;Coivrel;244;2;246
32;Hauts-de-France;60;3;99;159;Compiègne;40615;1028;41643
32;Hauts-de-France;60;3;10;160;Conchy-les-Pots;725;13;738
32;Hauts-de-France;60;1;19;161;Conteville;72;0;72
32;Hauts-de-France;60;1;04;162;Corbeil-Cerf;320;8;328
32;Hauts-de-France;60;1;19;163;Cormeilles;406;6;412
32;Hauts-de-France;60;1;11;164;Le Coudray-Saint-Germer;870;10;880
32;Hauts-de-France;60;1;04;165;Le Coudray-sur-Thelle;533;15;548
32;Hauts-de-France;60;3;10;166;Coudun;1067;32;1099
32;Hauts-de-France;60;3;06;167;Couloisy;576;14;590
32;Hauts-de-France;60;2;10;168;Courcelles-Epayelles;211;2;213
32;Hauts-de-France;60;1;04;169;Courcelles-lès-Gisors;809;21;830
32;Hauts-de-France;60;4;20;170;Courteuil;569;35;604
32;Hauts-de-France;60;3;06;171;Courtieux;180;3;183
32;Hauts-de-France;60;4;03;172;Coye-la-Forêt;3976;148;4124
32;Hauts-de-France;60;4;13;173;Cramoisy;810;12;822
32;Hauts-de-France;60;3;21;174;Crapeaumesnil;211;3;214
32;Hauts-de-France;60;4;08;175;Creil;36169;259;36428
32;Hauts-de-France;60;4;09;176;Crépy-en-Valois;14788;266;15054
32;Hauts-de-France;60;2;10;177;Cressonsacq;445;8;453
32;Hauts-de-France;60;1;19;178;Crèvecœur-le-Grand;3503;123;3626
32;Hauts-de-France;60;2;10;179;Crèvecœur-le-Petit;150;1;151
32;Hauts-de-France;60;1;11;180;Crillon;502;4;506
32;Hauts-de-France;60;3;17;181;Crisolles;901;20;921
32;Hauts-de-France;60;1;19;182;Le Crocq;178;4;182
32;Hauts-de-France;60;1;19;183;Croissy-sur-Celle;256;3;259
32;Hauts-de-France;60;3;07;184;Croutoy;207;10;217
32;Hauts-de-France;60;4;03;185;Crouy-en-Thelle;1116;10;1126
32;Hauts-de-France;60;2;19;186;Cuignières;252;4;256
32;Hauts-de-France;60;1;11;187;Cuigy-en-Bray;970;14;984
32;Hauts-de-France;60;3;07;188;Cuise-la-Motte;2216;106;2322
32;Hauts-de-France;60;3;17;189;Cuts;981;21;1002
32;Hauts-de-France;60;4;15;190;Cuvergnon;297;6;303
32;Hauts-de-France;60;3;10;191;Cuvilly;625;5;630
32;Hauts-de-France;60;3;21;192;Cuy;220;5;225
32;Hauts-de-France;60;1;11;193;Daméraucourt;210;2;212
32;Hauts-de-France;60;1;11;194;Dargies;248;2;250
32;Hauts-de-France;60;1;04;195;Delincourt;500;11;511
32;Hauts-de-France;60;1;04;196;La Drenne;1017;16;1033
32;Hauts-de-France;60;4;12;197;Dieudonné;889;7;896
32;Hauts-de-France;60;3;21;198;Dives;395;6;401
32;Hauts-de-France;60;1;19;199;Doméliers;256;8;264
32;Hauts-de-France;60;2;10;200;Domfront;318;2;320
32;Hauts-de-France;60;2;10;201;Dompierre;241;3;244
32;Hauts-de-France;60;4;09;203;Duvy;426;8;434
32;Hauts-de-France;60;3;21;204;Écuvilly;306;4;310
32;Hauts-de-France;60;1;11;205;Élencourt;51;1;52
32;Hauts-de-France;60;3;21;206;Élincourt-Sainte-Marguerite;857;14;871
32;Hauts-de-France;60;4;09;207;Éméville;288;6;294
32;Hauts-de-France;60;1;04;208;Énencourt-Léage;124;7;131
32;Hauts-de-France;60;1;04;209;La Corne-en-Vexin;540;10;550
32;Hauts-de-France;60;2;10;210;Épineuse;260;8;268
32;Hauts-de-France;60;1;04;211;Éragny-sur-Epte;599;5;604
32;Hauts-de-France;60;4;12;212;Ercuis;1606;27;1633
32;Hauts-de-France;60;4;15;213;Ermenonville;996;21;1017
32;Hauts-de-France;60;1;11;214;Ernemont-Boutavent;216;3;219
32;Hauts-de-France;60;2;05;215;Erquery;594;13;607
32;Hauts-de-France;60;2;19;216;Erquinvillers;184;2;186
32;Hauts-de-France;60;1;11;217;Escames;218;4;222
32;Hauts-de-France;60;1;12;218;Esches;1610;13;1623
32;Hauts-de-France;60;1;11;219;Escles-Saint-Pierre;167;2;169
32;Hauts-de-France;60;1;11;220;Espaubourg;502;5;507
32;Hauts-de-France;60;2;19;221;Esquennoy;711;7;718
32;Hauts-de-France;60;2;19;222;Essuiles;554;16;570
32;Hauts-de-France;60;3;10;223;Estrées-Saint-Denis;3759;54;3813
32;Hauts-de-France;60;4;15;224;Étavigny;151;1;152
32;Hauts-de-France;60;2;05;225;Étouy;808;42;850
32;Hauts-de-France;60;4;15;226;Ève;421;6;427
32;Hauts-de-France;60;3;21;227;Évricourt;227;2;229
32;Hauts-de-France;60;1;04;228;Fay-les-Étangs;466;8;474
32;Hauts-de-France;60;3;10;229;Le Fayel;227;4;231
32;Hauts-de-France;60;1;14;230;Le Fay-Saint-Quentin;523;14;537
32;Hauts-de-France;60;4;09;231;Feigneux;424;14;438
32;Hauts-de-France;60;2;10;232;Ferrières;473;3;476
32;Hauts-de-France;60;1;11;233;Feuquières;1366;21;1387
32;Hauts-de-France;60;2;05;234;Fitz-James;2575;28;2603
32;Hauts-de-France;60;1;02;235;Flavacourt;661;20;681
32;Hauts-de-France;60;3;17;236;Flavy-le-Meldeux;217;0;217
32;Hauts-de-France;60;2;19;237;Fléchy;89;1;90
32;Hauts-de-France;60;4;20;238;Fleurines;1886;84;1970
32;Hauts-de-France;60;1;04;239;Fleury;568;12;580
32;Hauts-de-France;60;1;19;240;Fontaine-Bonneleau;238;3;241
32;Hauts-de-France;60;4;15;241;Fontaine-Chaalis;336;15;351
32;Hauts-de-France;60;1;11;242;Fontaine-Lavaganne;505;7;512
32;Hauts-de-France;60;1;14;243;Fontaine-Saint-Lucien;173;6;179
32;Hauts-de-France;60;1;11;244;Fontenay-Torcy;139;1;140
32;Hauts-de-France;60;1;11;245;Formerie;2113;28;2141
32;Hauts-de-France;60;2;05;247;Fouilleuse;146;2;148
32;Hauts-de-France;60;1;11;248;Fouilloy;214;6;220
32;Hauts-de-France;60;4;13;249;Foulangues;199;2;201
32;Hauts-de-France;60;1;01;250;Fouquenies;428;14;442
32;Hauts-de-France;60;1;14;251;Fouquerolles;281;5;286
32;Hauts-de-France;60;2;19;252;Fournival;526;3;529
32;Hauts-de-France;60;1;19;253;Francastel;490;8;498
32;Hauts-de-France;60;3;10;254;Francières;549;16;565
32;Hauts-de-France;60;3;17;255;Fréniches;338;3;341
32;Hauts-de-France;60;1;04;256;Montchevreuil;1321;26;1347
32;Hauts-de-France;60;1;04;257;Fresne-Léguillon;438;10;448
32;Hauts-de-France;60;3;21;258;Fresnières;162;6;168
32;Hauts-de-France;60;4;12;259;Fresnoy-en-Thelle;893;23;916
32;Hauts-de-France;60;4;09;260;Fresnoy-la-Rivière;679;21;700
32;Hauts-de-France;60;4;15;261;Fresnoy-le-Luat;517;12;529
32;Hauts-de-France;60;2;10;262;Le Frestoy-Vaux;246;6;252
32;Hauts-de-France;60;3;17;263;Frétoy-le-Château;261;1;262
32;Hauts-de-France;60;1;02;264;Frocourt;515;15;530
32;Hauts-de-France;60;2;19;265;Froissy;984;13;997
32;Hauts-de-France;60;1;19;267;Le Gallet;177;5;182
32;Hauts-de-France;60;2;19;268;Gannes;338;1;339
32;Hauts-de-France;60;1;11;269;Gaudechart;347;5;352
32;Hauts-de-France;60;3;17;270;Genvry;338;85;423
32;Hauts-de-France;60;1;11;271;Gerberoy;85;2;87
32;Hauts-de-France;60;4;09;272;Gilocourt;631;19;650
32;Hauts-de-France;60;3;10;273;Giraumont;532;19;551
32;Hauts-de-France;60;4;09;274;Glaignes;377;13;390
32;Hauts-de-France;60;1;11;275;Glatigny;223;0;223
32;Hauts-de-France;60;2;10;276;Godenvillers;215;2;217
32;Hauts-de-France;60;1;02;277;Goincourt;1544;39;1583
32;Hauts-de-France;60;3;17;278;Golancourt;398;3;401
32;Hauts-de-France;60;4;15;279;Gondreville;200;5;205
32;Hauts-de-France;60;1;11;280;Gourchelles;109;0;109
32;Hauts-de-France;60;3;10;281;Gournay-sur-Aronde;550;14;564
32;Hauts-de-France;60;4;03;282;Gouvieux;8978;385;9363
32;Hauts-de-France;60;2;19;283;Gouy-les-Groseillers;25;0;25
32;Hauts-de-France;60;3;10;284;Grandfresnoy;1792;59;1851
32;Hauts-de-France;60;2;10;285;Grandvillers-aux-Bois;306;15;321
32;Hauts-de-France;60;1;11;286;Grandvilliers;2820;78;2898
32;Hauts-de-France;60;3;17;287;Grandrû;354;4;358
32;Hauts-de-France;60;1;11;288;Grémévillers;474;5;479
32;Hauts-de-France;60;1;11;289;Grez;265;4;269
32;Hauts-de-France;60;1;14;290;Guignecourt;387;4;391
32;Hauts-de-France;60;3;17;291;Guiscard;1805;24;1829
32;Hauts-de-France;60;3;21;292;Gury;237;7;244
32;Hauts-de-France;60;1;04;293;Hadancourt-le-Haut-Clocher;373;8;381
32;Hauts-de-France;60;3;10;294;Hainvillers;85;1;86
32;Hauts-de-France;60;1;11;295;Halloy;449;9;458
32;Hauts-de-France;60;1;11;296;Hannaches;138;1;139
32;Hauts-de-France;60;1;11;297;Le Hamel;188;2;190
32;Hauts-de-France;60;1;11;298;Hanvoile;645;7;652
32;Hauts-de-France;60;2;19;299;Hardivillers;540;8;548
32;Hauts-de-France;60;1;11;301;Haucourt;136;5;141
32;Hauts-de-France;60;1;14;302;Haudivillers;789;23;812
32;Hauts-de-France;60;1;11;303;Hautbos;196;1;197
32;Hauts-de-France;60;1;11;304;Haute-Épine;273;9;282
32;Hauts-de-France;60;3;07;305;Hautefontaine;334;4;338
32;Hauts-de-France;60;1;11;306;Hécourt;153;3;156
32;Hauts-de-France;60;2;14;307;Heilles;638;10;648
32;Hauts-de-France;60;3;10;308;Hémévillers;468;9;477
32;Hauts-de-France;60;1;04;309;Hénonville;873;21;894
32;Hauts-de-France;60;1;01;310;Herchies;628;27;655
32;Hauts-de-France;60;2;19;311;La Hérelle;238;2;240
32;Hauts-de-France;60;1;11;312;Héricourt-sur-Thérain;115;2;117
32;Hauts-de-France;60;1;14;313;Hermes;2509;41;2550
32;Hauts-de-France;60;1;11;314;Hétomesnil;324;5;329
32;Hauts-de-France;60;1;11;315;Hodenc-en-Bray;496;10;506
32;Hauts-de-France;60;1;04;316;Hodenc-l'Évêque;243;7;250
32;Hauts-de-France;60;2;14;317;Hondainville;719;8;727
32;Hauts-de-France;60;3;10;318;Houdancourt;667;13;680
32;Hauts-de-France;60;1;02;319;La Houssoye;608;6;614
32;Hauts-de-France;60;4;15;320;Ivors;258;3;261
32;Hauts-de-France;60;1;04;321;Ivry-le-Temple;831;7;838
32;Hauts-de-France;60;1;04;322;Jaméricourt;322;5;327
32;Hauts-de-France;60;3;06;323;Janville;650;11;661
32;Hauts-de-France;60;3;06;324;Jaulzy;877;11;888
32;Hauts-de-France;60;3;07;325;Jaux;2300;64;2364
32;Hauts-de-France;60;3;07;326;Jonquières;602;22;624
32;Hauts-de-France;60;1;04;327;Jouy-sous-Thelle;1039;16;1055
32;Hauts-de-France;60;1;14;328;Juvignies;309;9;318
32;Hauts-de-France;60;3;21;329;Laberlière;202;6;208
32;Hauts-de-France;60;1;04;330;Laboissière-en-Thelle;1347;26;1373
32;Hauts-de-France;60;1;02;331;Labosse;442;6;448
32;Hauts-de-France;60;2;05;332;Labruyère;710;9;719
32;Hauts-de-France;60;1;02;333;Lachapelle-aux-Pots;1660;37;1697
32;Hauts-de-France;60;1;04;334;Lachapelle-Saint-Pierre;870;14;884
32;Hauts-de-France;60;1;11;335;Lachapelle-sous-Gerberoy;148;1;149
32;Hauts-de-France;60;1;19;336;Lachaussée-du-Bois-d'Écu;192;3;195
32;Hauts-de-France;60;3;07;337;Lachelle;732;29;761
32;Hauts-de-France;60;3;07;338;Lacroix-Saint-Ouen;4891;163;5054
32;Hauts-de-France;60;1;14;339;Lafraye;363;9;372
32;Hauts-de-France;60;3;21;340;Lagny;531;18;549
32;Hauts-de-France;60;4;15;341;Lagny-le-Sec;2050;55;2105
32;Hauts-de-France;60;2;16;342;Laigneville;4721;52;4773
32;Hauts-de-France;60;1;02;343;Lalande-en-Son;626;23;649
32;Hauts-de-France;60;1;02;344;Lalandelle;501;9;510
32;Hauts-de-France;60;2;05;345;Lamécourt;190;2;192
32;Hauts-de-France;60;4;03;346;Lamorlaye;8784;231;9015
32;Hauts-de-France;60;1;11;347;Lannoy-Cuillère;283;5;288
32;Hauts-de-France;60;3;17;348;Larbroye;514;9;523
32;Hauts-de-France;60;3;21;350;Lassigny;1382;24;1406
32;Hauts-de-France;60;3;10;351;Lataule;119;2;121
32;Hauts-de-France;60;1;04;352;Lattainville;163;2;165
32;Hauts-de-France;60;1;11;353;Lavacquerie;195;1;196
32;Hauts-de-France;60;1;11;354;Laverrière;35;1;36
32;Hauts-de-France;60;1;14;355;Laversines;1175;51;1226
32;Hauts-de-France;60;1;04;356;Lavilletertre;640;17;657
32;Hauts-de-France;60;2;10;357;Léglantiers;551;7;558
32;Hauts-de-France;60;4;15;358;Lévignen;1008;26;1034
32;Hauts-de-France;60;1;11;359;Lhéraule;196;3;199
32;Hauts-de-France;60;2;05;360;Liancourt;7010;65;7075
32;Hauts-de-France;60;1;04;361;Liancourt-Saint-Pierre;591;20;611
32;Hauts-de-France;60;3;17;362;Libermont;177;6;183
32;Hauts-de-France;60;1;04;363;Lierville;221;1;222
32;Hauts-de-France;60;2;19;364;Lieuvillers;705;8;713
32;Hauts-de-France;60;1;11;365;Lihus;422;5;427
32;Hauts-de-France;60;2;14;366;Litz;363;5;368
32;Hauts-de-France;60;1;04;367;Loconville;333;8;341
32;Hauts-de-France;60;3;21;368;Longueil-Annel;2604;59;2663
32;Hauts-de-France;60;3;10;369;Longueil-Sainte-Marie;2004;36;2040
32;Hauts-de-France;60;1;12;370;Lormaison;1311;14;1325
32;Hauts-de-France;60;1;11;371;Loueuse;151;1;152
32;Hauts-de-France;60;1;19;372;Luchy;662;16;678
32;Hauts-de-France;60;3;21;373;Machemont;777;19;796
32;Hauts-de-France;60;2;10;374;Maignelay-Montigny;2678;31;2709
32;Hauts-de-France;60;2;05;375;Maimbeville;399;10;409
32;Hauts-de-France;60;1;14;376;Maisoncelle-Saint-Pierre;165;1;166
32;Hauts-de-France;60;2;19;377;Maisoncelle-Tuilerie;290;8;298
32;Hauts-de-France;60;3;21;378;Marest-sur-Matz;394;5;399
32;Hauts-de-France;60;3;21;379;Mareuil-la-Motte;614;15;629
32;Hauts-de-France;60;4;15;380;Mareuil-sur-Ourcq;1604;24;1628
32;Hauts-de-France;60;3;21;381;Margny-aux-Cerises;256;3;259
32;Hauts-de-France;60;3;06;382;Margny-lès-Compiègne;8676;177;8853
32;Hauts-de-France;60;3;10;383;Margny-sur-Matz;538;12;550
32;Hauts-de-France;60;4;15;385;Marolles;668;13;681
32;Hauts-de-France;60;3;10;386;Marquéglise;480;8;488
32;Hauts-de-France;60;1;11;387;Marseille-en-Beauvaisis;1475;10;1485
32;Hauts-de-France;60;1;11;388;Martincourt;133;6;139
32;Hauts-de-France;60;3;17;389;Maucourt;245;2;247
32;Hauts-de-France;60;1;19;390;Maulers;327;6;333
32;Hauts-de-France;60;4;13;391;Maysel;230;3;233
32;Hauts-de-France;60;3;21;392;Mélicocq;772;17;789
32;Hauts-de-France;60;4;13;393;Mello;613;13;626
32;Hauts-de-France;60;2;10;394;Ménévillers;105;1;106
32;Hauts-de-France;60;1;12;395;Méru;14452;182;14634
32;Hauts-de-France;60;2;10;396;Méry-la-Bataille;631;5;636
32;Hauts-de-France;60;1;11;397;Le Mesnil-Conteville;77;1;78
32;Hauts-de-France;60;4;03;398;Le Mesnil-en-Thelle;2207;30;2237
32;Hauts-de-France;60;2;19;399;Le Mesnil-Saint-Firmin;239;18;257
32;Hauts-de-France;60;2;19;400;Le Mesnil-sur-Bulles;270;7;277
32;Hauts-de-France;60;1;04;401;Le Mesnil-Théribus;787;33;820
32;Hauts-de-France;60;3;07;402;Le Meux;2327;62;2389
32;Hauts-de-France;60;1;01;403;Milly-sur-Thérain;1814;31;1845
32;Hauts-de-France;60;2;16;404;Mogneville;1474;36;1510
32;Hauts-de-France;60;1;11;405;Moliens;1147;16;1163
32;Hauts-de-France;60;2;18;406;Monceaux;830;16;846
32;Hauts-de-France;60;1;11;407;Monceaux-l'Abbaye;218;2;220
32;Hauts-de-France;60;3;10;408;Monchy-Humières;787;13;800
32;Hauts-de-France;60;2;16;409;Monchy-Saint-Éloi;2181;39;2220
32;Hauts-de-France;60;3;17;410;Mondescourt;247;8;255
32;Hauts-de-France;60;1;04;411;Monneville;775;12;787
32;Hauts-de-France;60;1;04;412;Montagny-en-Vexin;677;12;689
32;Hauts-de-France;60;4;15;413;Montagny-Sainte-Félicité;412;9;421
32;Hauts-de-France;60;4;13;414;Montataire;13645;166;13811
32;Hauts-de-France;60;4;18;415;Montépilloy;137;9;146
32;Hauts-de-France;60;2;10;416;Montgérain;174;2;176
32;Hauts-de-France;60;2;10;418;Montiers;412;13;425
32;Hauts-de-France;60;1;04;420;Montjavoult;481;11;492
32;Hauts-de-France;60;4;20;421;Mont-l'Évêque;401;7;408
32;Hauts-de-France;60;4;15;422;Montlognon;199;11;210
32;Hauts-de-France;60;3;21;423;Montmacq;1126;26;1152
32;Hauts-de-France;60;3;10;424;Montmartin;264;4;268
32;Hauts-de-France;60;2;19;425;Montreuil-sur-Brêche;477;17;494
32;Hauts-de-France;60;1;04;426;Montreuil-sur-Thérain;245;2;247
32;Hauts-de-France;60;1;04;427;Monts;178;1;179
32;Hauts-de-France;60;1;01;428;Le Mont-Saint-Adrien;643;27;670
32;Hauts-de-France;60;4;03;429;Morangles;416;16;432
32;Hauts-de-France;60;4;09;430;Morienval;1088;13;1101
32;Hauts-de-France;60;3;17;431;Morlincourt;542;11;553
32;Hauts-de-France;60;4;20;432;Mortefontaine;868;29;897
32;Hauts-de-France;60;1;04;433;Mortefontaine-en-Thelle;987;20;1007
32;Hauts-de-France;60;3;10;434;Mortemer;223;6;229
32;Hauts-de-France;60;1;11;435;Morvillers;490;4;494
32;Hauts-de-France;60;2;19;436;Mory-Montcrux;76;2;78
32;Hauts-de-France;60;1;04;437;Mouchy-le-Châtel;82;0;82
32;Hauts-de-France;60;3;06;438;Moulin-sous-Touvent;196;5;201
32;Hauts-de-France;60;2;14;439;Mouy;5237;74;5311
32;Hauts-de-France;60;2;10;440;Moyenneville;609;16;625
32;Hauts-de-France;60;3;10;441;Moyvillers;696;7;703
32;Hauts-de-France;60;1;19;442;Muidorge;147;2;149
32;Hauts-de-France;60;3;17;443;Muirancourt;582;4;586
32;Hauts-de-France;60;1;11;444;Mureaumont;159;5;164
32;Hauts-de-France;60;3;06;445;Nampcel;317;3;320
32;Hauts-de-France;60;4;15;446;Nanteuil-le-Haudouin;4201;61;4262
32;Hauts-de-France;60;4;09;447;Néry;656;14;670
32;Hauts-de-France;60;4;15;448;Neufchelles;388;6;394
32;Hauts-de-France;60;3;10;449;Neufvy-sur-Aronde;280;4;284
32;Hauts-de-France;60;4;12;450;Neuilly-en-Thelle;3970;44;4014
32;Hauts-de-France;60;2;14;451;Neuilly-sous-Clermont;1645;28;1673
32;Hauts-de-France;60;1;04;452;Neuville-Bosc;490;14;504
32;Hauts-de-France;60;2;14;454;La Neuville-en-Hez;959;31;990
32;Hauts-de-France;60;2;10;456;La Neuville-Roy;927;28;955
32;Hauts-de-France;60;2;19;457;La Neuville-Saint-Pierre;155;2;157
32;Hauts-de-France;60;1;11;458;La Neuville-sur-Oudeuil;317;15;332
32;Hauts-de-France;60;3;10;459;La Neuville-sur-Ressons;206;3;209
32;Hauts-de-France;60;1;11;460;La Neuville-Vault;199;8;207
32;Hauts-de-France;60;1;14;461;Nivillers;189;24;213
32;Hauts-de-France;60;1;04;462;Noailles;2829;44;2873
32;Hauts-de-France;60;4;16;463;Nogent-sur-Oise;20780;362;21142
32;Hauts-de-France;60;2;05;464;Nointel;1092;16;1108
32;Hauts-de-France;60;2;19;465;Noirémont;183;6;189
32;Hauts-de-France;60;2;19;466;Noroy;250;3;253
32;Hauts-de-France;60;2;19;468;Nourard-le-Franc;311;4;315
32;Hauts-de-France;60;1;04;469;Novillers;363;9;372
32;Hauts-de-France;60;2;19;470;Noyers-Saint-Martin;890;14;904
32;Hauts-de-France;60;3;17;471;Noyon;13190;260;13450
32;Hauts-de-France;60;1;11;472;Offoy;119;1;120
32;Hauts-de-France;60;4;15;473;Ognes;289;1;290
32;Hauts-de-France;60;3;21;474;Ognolles;285;5;290
32;Hauts-de-France;60;1;11;476;Omécourt;199;8;207
32;Hauts-de-France;60;1;02;477;Ons-en-Bray;1399;23;1422
32;Hauts-de-France;60;4;15;478;Ormoy-le-Davien;356;9;365
32;Hauts-de-France;60;4;15;479;Ormoy-Villers;677;10;687
32;Hauts-de-France;60;1;14;480;Oroër;551;17;568
32;Hauts-de-France;60;4;09;481;Orrouy;605;13;618
32;Hauts-de-France;60;4;20;482;Orry-la-Ville;3351;90;3441
32;Hauts-de-France;60;3;10;483;Orvillers-Sorel;528;52;580
32;Hauts-de-France;60;1;11;484;Oudeuil;277;6;283
32;Hauts-de-France;60;2;19;485;Oursel-Maison;240;5;245
32;Hauts-de-France;60;2;19;486;Paillart;575;10;585
32;Hauts-de-France;60;1;04;487;Parnes;332;15;347
32;Hauts-de-France;60;3;17;488;Passel;273;6;279
32;Hauts-de-France;60;4;15;489;Péroy-les-Gombries;1174;14;1188
32;Hauts-de-France;60;1;01;490;Pierrefitte-en-Beauvaisis;372;14;386
32;Hauts-de-France;60;3;07;491;Pierrefonds;1833;210;2043
32;Hauts-de-France;60;3;21;492;Pimprez;853;19;872
32;Hauts-de-France;60;1;11;493;Pisseleu;506;11;517
32;Hauts-de-France;60;4;20;494;Plailly;1882;41;1923
32;Hauts-de-France;60;2;19;495;Plainval;409;5;414
32;Hauts-de-France;60;2;19;496;Plainville;162;1;163
32;Hauts-de-France;60;2;19;497;Le Plessier-sur-Bulles;212;0;212
32;Hauts-de-France;60;2;19;498;Le Plessier-sur-Saint-Just;528;3;531
32;Hauts-de-France;60;3;21;499;Plessis-de-Roye;231;5;236
32;Hauts-de-France;60;4;15;500;Le Plessis-Belleville;3833;55;3888
32;Hauts-de-France;60;3;21;501;Le Plessis-Brion;1351;31;1382
32;Hauts-de-France;60;3;17;502;Le Plessis-Patte-d'Oie;99;4;103
32;Hauts-de-France;60;2;10;503;Le Ployron;112;3;115
32;Hauts-de-France;60;1;04;504;Ponchon;1125;16;1141
32;Hauts-de-France;60;4;20;505;Pontarmé;849;21;870
32;Hauts-de-France;60;3;17;506;Pont-l'Évêque;681;12;693
32;Hauts-de-France;60;3;17;507;Pontoise-lès-Noyon;451;10;461
32;Hauts-de-France;60;4;18;508;Pontpoint;3242;74;3316
32;Hauts-de-France;60;4;18;509;Pont-Sainte-Maxence;12602;122;12724
32;Hauts-de-France;60;1;02;510;Porcheux;645;16;661
32;Hauts-de-France;60;3;17;511;Porquéricourt;398;12;410
32;Hauts-de-France;60;1;04;512;Pouilly;159;2;161
32;Hauts-de-France;60;4;13;513;Précy-sur-Oise;3220;70;3290
32;Hauts-de-France;60;1;11;514;Prévillers;242;1;243
32;Hauts-de-France;60;2;10;515;Pronleroy;377;12;389
32;Hauts-de-France;60;1;11;516;Puiseux-en-Bray;411;3;414
32;Hauts-de-France;60;4;12;517;Puiseux-le-Hauberger;852;12;864
32;Hauts-de-France;60;2;19;518;Puits-la-Vallée;207;4;211
32;Hauts-de-France;60;3;17;519;Quesmy;176;5;181
32;Hauts-de-France;60;2;19;520;Le Quesnel-Aubry;222;8;230
32;Hauts-de-France;60;1;11;521;Quincampoix-Fleuzy;401;16;417
32;Hauts-de-France;60;2;19;522;Quinquempoix;316;3;319
32;Hauts-de-France;60;1;02;523;Rainvillers;918;25;943
32;Hauts-de-France;60;2;05;524;Rantigny;2541;23;2564
32;Hauts-de-France;60;4;18;525;Raray;127;5;132
32;Hauts-de-France;60;2;19;526;Ravenel;1071;13;1084
32;Hauts-de-France;60;4;15;527;Réez-Fosse-Martin;145;1;146
32;Hauts-de-France;60;1;04;528;Reilly;129;2;131
32;Hauts-de-France;60;2;05;529;Rémécourt;76;0;76
32;Hauts-de-France;60;2;14;530;Rémérangles;217;9;226
32;Hauts-de-France;60;3;10;531;Remy;1920;39;1959
32;Hauts-de-France;60;3;10;533;Ressons-sur-Matz;1700;28;1728
32;Hauts-de-France;60;3;06;534;Rethondes;630;23;653
32;Hauts-de-France;60;2;19;535;Reuil-sur-Brêche;331;6;337
32;Hauts-de-France;60;4;18;536;Rhuis;136;8;144
32;Hauts-de-France;60;3;21;537;Ribécourt-Dreslincourt;3705;174;3879
32;Hauts-de-France;60;3;10;538;Ricquebourg;306;4;310
32;Hauts-de-France;60;2;18;539;Rieux;1548;21;1569
32;Hauts-de-France;60;3;10;540;Rivecourt;625;15;640
32;Hauts-de-France;60;4;18;541;Roberval;356;12;368
32;Hauts-de-France;60;1;14;542;Rochy-Condé;992;16;1008
32;Hauts-de-France;60;4;09;543;Rocquemont;119;1;120
32;Hauts-de-France;60;2;19;544;Rocquencourt;195;1;196
32;Hauts-de-France;60;1;11;545;Romescamps;531;8;539
32;Hauts-de-France;60;4;15;546;Rosières;139;4;143
32;Hauts-de-France;60;2;05;547;Rosoy;627;17;644
32;Hauts-de-France;60;4;15;548;Rosoy-en-Multien;603;7;610
32;Hauts-de-France;60;1;19;549;Rotangy;220;6;226
32;Hauts-de-France;60;1;11;550;Rothois;222;0;222
32;Hauts-de-France;60;2;13;551;Rousseloy;299;7;306
32;Hauts-de-France;60;4;15;552;Rouville;246;9;255
32;Hauts-de-France;60;2;10;553;Rouvillers;273;7;280
32;Hauts-de-France;60;4;15;554;Rouvres-en-Multien;472;9;481
32;Hauts-de-France;60;2;19;555;Rouvroy-les-Merles;53;0;53
32;Hauts-de-France;60;2;10;556;Royaucourt;205;3;208
32;Hauts-de-France;60;1;11;557;Roy-Boissy;308;6;314
32;Hauts-de-France;60;3;21;558;Roye-sur-Matz;461;18;479
32;Hauts-de-France;60;2;14;559;La Rue-Saint-Pierre;829;9;838
32;Hauts-de-France;60;4;18;560;Rully;727;33;760
32;Hauts-de-France;60;4;09;561;Russy-Bémont;196;6;202
32;Hauts-de-France;60;2;18;562;Sacy-le-Grand;1594;27;1621
32;Hauts-de-France;60;2;18;563;Sacy-le-Petit;595;6;601
32;Hauts-de-France;60;2;10;564;Sains-Morainvillers;280;3;283
32;Hauts-de-France;60;2;19;565;Saint-André-Farivillers;518;4;522
32;Hauts-de-France;60;1;11;566;Saint-Arnoult;205;3;208
32;Hauts-de-France;60;1;02;567;Saint-Aubin-en-Bray;1165;29;1194
32;Hauts-de-France;60;2;05;568;Saint-Aubin-sous-Erquery;332;8;340
32;Hauts-de-France;60;3;06;569;Saint-Crépin-aux-Bois;188;9;197
32;Hauts-de-France;60;1;04;570;Saint-Crépin-Ibouvillers;1563;24;1587
32;Hauts-de-France;60;1;11;571;Saint-Deniscourt;83;3;86
32;Hauts-de-France;60;3;07;572;Saint-Étienne-Roilaye;296;9;305
32;Hauts-de-France;60;2;19;573;Sainte-Eusoye;332;2;334
32;Hauts-de-France;60;2;14;574;Saint-Félix;623;16;639
32;Hauts-de-France;60;1;04;575;Sainte-Geneviève;3344;44;3388
32;Hauts-de-France;60;1;01;576;Saint-Germain-la-Poterie;485;13;498
32;Hauts-de-France;60;1;11;577;Saint-Germer-de-Fly;1709;35;1744
32;Hauts-de-France;60;4;09;578;Saintines;1080;17;1097
32;Hauts-de-France;60;3;07;579;Saint-Jean-aux-Bois;322;7;329
32;Hauts-de-France;60;2;19;581;Saint-Just-en-Chaussée;6055;46;6101
32;Hauts-de-France;60;3;21;582;Saint-Léger-aux-Bois;771;20;791
32;Hauts-de-France;60;1;02;583;Saint-Léger-en-Bray;356;9;365
32;Hauts-de-France;60;4;13;584;Saint-Leu-d'Esserent;4678;99;4777
32;Hauts-de-France;60;2;10;585;Saint-Martin-aux-Bois;283;5;288
32;Hauts-de-France;60;1;02;586;Saint-Martin-le-Nœud;1033;22;1055
32;Hauts-de-France;60;2;18;587;Saint-Martin-Longueau;1463;28;1491
32;Hauts-de-France;60;1;11;588;Saint-Maur;375;6;381
32;Hauts-de-France;60;4;03;589;Saint-Maximin;2847;115;2962
32;Hauts-de-France;60;1;11;590;Saint-Omer-en-Chaussée;1243;24;1267
32;Hauts-de-France;60;1;02;591;Saint-Paul;1556;63;1619
32;Hauts-de-France;60;1;11;592;Saint-Pierre-es-Champs;708;8;716
32;Hauts-de-France;60;3;06;593;Saint-Pierre-lès-Bitry;139;2;141
32;Hauts-de-France;60;1;11;594;Saint-Quentin-des-Prés;279;6;285
32;Hauts-de-France;60;2;19;595;Saint-Remy-en-l'Eau;438;3;441
32;Hauts-de-France;60;1;11;596;Saint-Samson-la-Poterie;247;2;249
32;Hauts-de-France;60;3;07;597;Saint-Sauveur;1732;32;1764
32;Hauts-de-France;60;1;04;598;Saint-Sulpice;1043;86;1129
32;Hauts-de-France;60;1;11;599;Saint-Thibault;291;5;296
32;Hauts-de-France;60;4;09;600;Saint-Vaast-de-Longmont;639;7;646
32;Hauts-de-France;60;4;13;601;Saint-Vaast-lès-Mello;1041;16;1057
32;Hauts-de-France;60;1;11;602;Saint-Valery;59;6;65
32;Hauts-de-France;60;3;17;603;Salency;897;22;919
32;Hauts-de-France;60;1;11;604;Sarcus;267;2;269
32;Hauts-de-France;60;1;11;605;Sarnois;349;6;355
32;Hauts-de-France;60;1;19;608;Le Saulchoy;104;1;105
32;Hauts-de-France;60;1;01;609;Savignies;887;23;910
32;Hauts-de-France;60;3;17;610;Sempigny;768;13;781
32;Hauts-de-France;60;1;11;611;Senantes;597;14;611
32;Hauts-de-France;60;4;20;612;Senlis;14760;626;15386
32;Hauts-de-France;60;1;04;613;Senots;344;7;351
32;Hauts-de-France;60;1;04;614;Serans;205;6;211
32;Hauts-de-France;60;2;19;615;Sérévillers;134;1;135
32;Hauts-de-France;60;1;02;616;Sérifontaine;2739;33;2772
32;Hauts-de-France;60;3;17;617;Sermaize;269;4;273
32;Hauts-de-France;60;4;09;618;Séry-Magneval;283;10;293
32;Hauts-de-France;60;4;15;619;Silly-le-Long;1166;26;1192
32;Hauts-de-France;60;1;04;620;Silly-Tillard;450;9;459
32;Hauts-de-France;60;3;21;621;Solente;142;1;143
32;Hauts-de-France;60;1;11;622;Sommereux;482;5;487
32;Hauts-de-France;60;1;11;623;Songeons;982;80;1062
32;Hauts-de-France;60;1;11;624;Sully;173;4;177
32;Hauts-de-France;60;3;17;625;Suzoy;570;12;582
32;Hauts-de-France;60;1;11;626;Talmontiers;669;18;687
32;Hauts-de-France;60;2;19;627;Tartigny;259;3;262
32;Hauts-de-France;60;1;14;628;Therdonne;1067;22;1089
32;Hauts-de-France;60;1;11;629;Thérines;196;9;205
32;Hauts-de-France;60;1;04;630;Thibivillers;186;3;189
32;Hauts-de-France;60;4;20;631;Thiers-sur-Thève;1077;24;1101
32;Hauts-de-France;60;3;21;632;Thiescourt;757;16;773
32;Hauts-de-France;60;1;11;633;Thieuloy-Saint-Antoine;418;2;420
32;Hauts-de-France;60;2;19;634;Thieux;437;11;448
32;Hauts-de-France;60;4;13;635;Thiverny;1075;10;1085
32;Hauts-de-France;60;3;21;636;Thourotte;4484;74;4558
32;Hauts-de-France;60;4;15;637;Thury-en-Valois;513;5;518
32;Hauts-de-France;60;2;14;638;Thury-sous-Clermont;672;9;681
32;Hauts-de-France;60;1;14;639;Tillé;1234;24;1258
32;Hauts-de-France;60;1;04;640;Tourly;172;1;173
32;Hauts-de-France;60;3;06;641;Tracy-le-Mont;1725;49;1774
32;Hauts-de-France;60;3;21;642;Tracy-le-Val;1068;32;1100
32;Hauts-de-France;60;2;10;643;Tricot;1371;14;1385
32;Hauts-de-France;60;1;04;644;Trie-Château;1935;31;1966
32;Hauts-de-France;60;1;04;645;Trie-la-Ville;306;5;311
32;Hauts-de-France;60;1;14;646;Troissereux;1308;32;1340
32;Hauts-de-France;60;3;06;647;Trosly-Breuil;2063;54;2117
32;Hauts-de-France;60;2;19;648;Troussencourt;324;4;328
32;Hauts-de-France;60;4;09;650;Trumilly;532;25;557
32;Hauts-de-France;60;4;13;651;Ully-Saint-Georges;1890;31;1921
32;Hauts-de-France;60;1;04;652;Valdampierre;929;10;939
32;Hauts-de-France;60;2;19;653;Valescourt;301;2;303
32;Hauts-de-France;60;3;21;654;Vandélicourt;267;5;272
32;Hauts-de-France;60;3;17;655;Varesnes;365;10;375
32;Hauts-de-France;60;4;15;656;Varinfroy;286;3;289
32;Hauts-de-France;60;3;17;657;Vauchelles;253;5;258
32;Hauts-de-France;60;4;09;658;Vauciennes;691;10;701
32;Hauts-de-France;60;1;04;659;Vaudancourt;171;2;173
32;Hauts-de-France;60;1;02;660;Le Vaumain;403;11;414
32;Hauts-de-France;60;4;09;661;Vaumoise;987;83;1070
32;Hauts-de-France;60;1;02;662;Le Vauroux;505;13;518
32;Hauts-de-France;60;1;14;663;Velennes;257;3;260
32;Hauts-de-France;60;2;19;664;Vendeuil-Caply;453;11;464
32;Hauts-de-France;60;3;07;665;Venette;2884;62;2946
32;Hauts-de-France;60;4;15;666;Ver-sur-Launette;1135;26;1161
32;Hauts-de-France;60;4;09;667;Verberie;3813;53;3866
32;Hauts-de-France;60;1;14;668;Verderel-lès-Sauqueuse;740;24;764
32;Hauts-de-France;60;2;05;669;Verderonne;489;13;502
32;Hauts-de-France;60;4;08;670;Verneuil-en-Halatte;4707;115;4822
32;Hauts-de-France;60;4;15;671;Versigny;360;20;380
32;Hauts-de-France;60;4;09;672;Vez;273;13;286
32;Hauts-de-France;60;1;19;673;Viefvillers;209;1;210
32;Hauts-de-France;60;3;07;674;Vieux-Moulin;615;31;646
32;Hauts-de-France;60;3;10;675;Vignemont;433;6;439
32;Hauts-de-France;60;3;17;676;Ville;758;16;774
32;Hauts-de-France;60;1;11;677;Villembray;255;4;259
32;Hauts-de-France;60;1;12;678;Villeneuve-les-Sablons;1165;22;1187
32;Hauts-de-France;60;4;15;679;La Villeneuve-sous-Thury;155;6;161
32;Hauts-de-France;60;4;18;680;Villeneuve-sur-Verberie;664;17;681
32;Hauts-de-France;60;1;02;681;Villers-Saint-Barthélemy;466;18;484
32;Hauts-de-France;60;4;18;682;Villers-Saint-Frambourg-Ognon;708;38;746
32;Hauts-de-France;60;4;15;683;Villers-Saint-Genest;394;16;410
32;Hauts-de-France;60;4;16;684;Villers-Saint-Paul;6434;64;6498
32;Hauts-de-France;60;1;04;685;Villers-Saint-Sépulcre;1012;9;1021
32;Hauts-de-France;60;4;13;686;Villers-sous-Saint-Leu;2318;57;2375
32;Hauts-de-France;60;1;11;687;Villers-sur-Auchy;372;9;381
32;Hauts-de-France;60;1;11;688;Villers-sur-Bonnières;161;1;162
32;Hauts-de-France;60;3;10;689;Villers-sur-Coudun;1390;58;1448
32;Hauts-de-France;60;1;11;691;Villers-Vermont;118;1;119
32;Hauts-de-France;60;2;19;692;Villers-Vicomte;146;2;148
32;Hauts-de-France;60;3;17;693;Villeselve;425;4;429
32;Hauts-de-France;60;4;20;695;Vineuil-Saint-Firmin;1402;50;1452
32;Hauts-de-France;60;1;11;697;Vrocourt;34;1;35
32;Hauts-de-France;60;2;10;698;Wacquemoulin;280;9;289
32;Hauts-de-France;60;1;11;699;Wambez;165;5;170
32;Hauts-de-France;60;1;02;700;Warluis;1187;21;1208
32;Hauts-de-France;60;2;19;701;Wavignies;1283;8;1291
32;Hauts-de-France;60;2;10;702;Welles-Pérennes;248;3;251
32;Hauts-de-France;60;1;02;703;Aux Marais;870;17;887
28;Normandie;61;1;97;001;Alençon;25870;752;26622
28;Normandie;61;1;19;002;Almenêches;669;10;679
28;Normandie;61;3;09;005;Appenai-sous-Bellême;281;6;287
28;Normandie;61;2;98;006;Argentan;13395;353;13748
28;Normandie;61;2;06;007;Athis-Val de Rouvre;4217;85;4302
28;Normandie;61;3;18;008;Aube;1268;45;1313
28;Normandie;61;3;21;010;Aubry-le-Panthou;120;6;126
28;Normandie;61;2;14;011;Aubusson;416;14;430
28;Normandie;61;3;20;012;Auguaise;217;5;222
28;Normandie;61;1;17;013;Aunay-les-Bois;136;0;136
28;Normandie;61;2;04;014;Aunou-le-Faucon;247;9;256
28;Normandie;61;1;19;015;Aunou-sur-Orne;262;7;269
28;Normandie;61;3;18;017;Les Authieux-du-Puits;79;0;79
28;Normandie;61;3;21;018;Avernes-Saint-Gourgon;62;1;63
28;Normandie;61;2;15;020;Avoine;214;7;221
28;Normandie;61;2;11;021;Avrilly;102;4;106
28;Normandie;61;2;05;023;Bailleul;611;24;635
28;Normandie;61;2;12;024;Banvou;600;14;614
28;Normandie;61;1;17;026;Barville;185;8;193
28;Normandie;61;2;06;028;Bazoches-au-Houlme;457;11;468
28;Normandie;61;3;16;029;Bazoches-sur-Hoëne;840;23;863
28;Normandie;61;2;13;030;La Bazoque;272;4;276
28;Normandie;61;3;18;032;Beaufai;334;8;342
28;Normandie;61;3;20;034;Beaulieu;204;7;211
28;Normandie;61;1;12;035;Beauvain;274;2;276
28;Normandie;61;1;19;036;Belfonds;204;0;204
28;Normandie;61;3;16;037;Bellavilliers;132;3;135
28;Normandie;61;3;09;038;Bellême;1468;19;1487
28;Normandie;61;1;19;039;La Bellière;129;1;130
28;Normandie;61;2;12;040;Bellou-en-Houlme;1074;30;1104
28;Normandie;61;3;09;041;Bellou-le-Trichard;209;3;212
28;Normandie;61;3;08;043;Berd'huis;1096;21;1117
28;Normandie;61;2;06;044;Berjou;451;16;467
28;Normandie;61;3;20;046;Bizou;133;0;133
28;Normandie;61;3;16;048;Boëcé;125;4;129
28;Normandie;61;1;19;049;Boissei-la-Lande;128;2;130
28;Normandie;61;3;08;050;Cour-Maugis sur Huisne;592;22;614
28;Normandie;61;1;19;051;Boitron;358;6;364
28;Normandie;61;3;20;052;Bonnefoi;188;4;192
28;Normandie;61;3;20;053;Bonsmoulins;235;7;242
28;Normandie;61;3;21;054;Le Bosc-Renoult;253;4;257
28;Normandie;61;2;15;055;Boucé;614;11;625
28;Normandie;61;1;19;056;Le Bouillon;166;1;167
28;Normandie;61;3;20;060;Brethel;166;1;167
28;Normandie;61;3;08;061;Bretoncelles;1478;31;1509
28;Normandie;61;2;04;062;Brieux;91;2;93
28;Normandie;61;2;06;063;Briouze;1517;41;1558
28;Normandie;61;1;17;064;Brullemail;93;3;96
28;Normandie;61;1;17;066;Buré;107;5;112
28;Normandie;61;1;17;067;Bures;161;4;165
28;Normandie;61;1;17;068;Bursard;207;1;208
28;Normandie;61;2;06;069;Cahan;170;7;177
28;Normandie;61;2;13;070;Caligny;815;26;841
28;Normandie;61;3;21;071;Camembert;176;7;183
28;Normandie;61;3;21;072;Canapville;203;4;207
28;Normandie;61;1;15;074;Carrouges;643;7;650
28;Normandie;61;1;07;075;Ceaucé;1172;26;1198
28;Normandie;61;1;19;076;Le Cercueil;134;6;140
28;Normandie;61;1;02;077;Cerisé;866;16;882
28;Normandie;61;2;13;078;Cerisy-Belle-Étoile;714;48;762
28;Normandie;61;3;09;079;Ceton;1770;24;1794
28;Normandie;61;1;15;080;Chahains;83;2;85
28;Normandie;61;1;19;081;Chailloué;889;25;914
28;Normandie;61;1;17;082;Le Chalange;88;4;92
28;Normandie;61;2;06;084;Champcerie;170;4;174
28;Normandie;61;1;15;085;Le Champ-de-la-Pierre;33;0;33
28;Normandie;61;3;21;086;Les Champeaux;107;0;107
28;Normandie;61;3;16;087;Champeaux-sur-Sarthe;162;4;166
28;Normandie;61;3;18;088;Champ-Haut;46;1;47
28;Normandie;61;3;21;089;Champosoult;96;0;96
28;Normandie;61;2;11;091;Champsecret;892;22;914
28;Normandie;61;3;01;092;Chandai;677;6;683
28;Normandie;61;2;11;093;Chanu;1259;17;1276
28;Normandie;61;2;13;094;La Chapelle-au-Moine;589;17;606
28;Normandie;61;2;13;095;La Chapelle-Biche;530;8;538
28;Normandie;61;1;07;096;Rives d'Andaine;3051;110;3161
28;Normandie;61;3;16;097;La Chapelle-Montligeon;517;15;532
28;Normandie;61;1;19;098;La Chapelle-près-Sées;448;31;479
28;Normandie;61;3;09;099;La Chapelle-Souëf;247;8;255
28;Normandie;61;3;20;100;La Chapelle-Viel;282;17;299
28;Normandie;61;1;19;101;Le Château-d'Almenêches;202;9;211
28;Normandie;61;2;13;102;Le Châtellier;405;10;415
28;Normandie;61;3;21;103;Chaumont;173;1;174
28;Normandie;61;1;15;104;La Chaux;51;1;52
28;Normandie;61;3;09;105;Chemilli;186;7;193
28;Normandie;61;1;15;107;Ciral;393;11;404
28;Normandie;61;3;21;108;Cisai-Saint-Aubin;168;4;172
28;Normandie;61;1;10;111;Colombiers;329;13;342
28;Normandie;61;3;16;113;Comblot;63;1;64
28;Normandie;61;2;04;114;Commeaux;154;5;159
28;Normandie;61;3;08;116;Sablons sur Huisne;2058;40;2098
28;Normandie;61;1;10;117;Condé-sur-Sarthe;2490;48;2538
28;Normandie;61;3;16;118;Corbon;123;5;128
28;Normandie;61;2;05;120;Coudehard;75;0;75
28;Normandie;61;3;16;121;Coulimer;293;8;301
28;Normandie;61;3;21;122;Coulmer;83;6;89
28;Normandie;61;2;05;123;Coulonces;221;5;226
28;Normandie;61;2;12;124;La Coulonche;500;5;505
28;Normandie;61;1;17;126;Coulonges-sur-Sarthe;509;10;519
28;Normandie;61;3;16;129;Courgeon;366;11;377
28;Normandie;61;3;16;130;Courgeoût;458;13;471
28;Normandie;61;1;17;133;Courtomer;707;18;725
28;Normandie;61;2;06;137;Craménil;132;5;137
28;Normandie;61;3;21;138;Croisilles;209;4;213
28;Normandie;61;3;21;139;Crouttes;303;11;314
28;Normandie;61;3;20;140;Crulai;847;16;863
28;Normandie;61;1;10;141;Cuissai;410;17;427
28;Normandie;61;3;09;142;Dame-Marie;138;4;142
28;Normandie;61;1;10;143;Damigny;2464;63;2527
28;Normandie;61;2;11;145;Domfront en Poiraie;4196;124;4320
28;Normandie;61;2;12;146;Dompierre;398;5;403
28;Normandie;61;2;06;148;Durcet;299;11;310
28;Normandie;61;2;12;149;Échalou;387;8;395
28;Normandie;61;3;18;150;Échauffour;742;13;755
28;Normandie;61;3;18;151;Écorcei;394;11;405
28;Normandie;61;2;05;152;Écorches;98;0;98
28;Normandie;61;2;15;153;Écouché-les-Vallées;2190;49;2239
28;Normandie;61;1;17;156;Essay;537;14;551
28;Normandie;61;2;06;158;Faverolles;148;2;150
28;Normandie;61;3;18;159;Fay;70;1;71
28;Normandie;61;3;16;160;Feings;186;5;191
28;Normandie;61;3;20;162;La Ferrière-au-Doyen;160;3;163
28;Normandie;61;2;12;163;La Ferrière-aux-Étangs;1545;22;1567
28;Normandie;61;1;19;164;La Ferrière-Béchet;241;2;243
28;Normandie;61;1;10;165;La Ferrière-Bochard;746;14;760
28;Normandie;61;1;17;166;Ferrières-la-Verrerie;141;3;144
28;Normandie;61;3;18;167;La Ferté-en-Ouche;3092;62;3154
28;Normandie;61;2;12;168;La Ferté Macé;5186;402;5588
28;Normandie;61;2;99;169;Flers;14762;364;15126
28;Normandie;61;2;15;170;Fleuré;196;3;199
28;Normandie;61;2;05;171;Fontaine-les-Bassets;103;1;104
28;Normandie;61;1;19;176;Francheville;143;2;145
28;Normandie;61;3;21;178;La Fresnaie-Fayel;54;2;56
28;Normandie;61;3;21;180;Fresnay-le-Samson;84;1;85
28;Normandie;61;3;21;181;Gacé;1811;59;1870
28;Normandie;61;1;10;182;Gandelain;418;5;423
28;Normandie;61;1;17;183;Gâprée;141;3;144
28;Normandie;61;3;20;187;Les Genettes;194;7;201
28;Normandie;61;3;18;188;La Genevraie;91;5;96
28;Normandie;61;2;06;189;Giel-Courteilles;458;216;674
28;Normandie;61;2;05;190;Ginai;74;1;75
28;Normandie;61;3;18;192;Godisson;107;3;110
28;Normandie;61;3;18;193;La Gonfrière;282;3;285
28;Normandie;61;2;15;194;Monts-sur-Orne;883;14;897
28;Normandie;61;2;06;195;Le Grais;192;4;196
28;Normandie;61;3;09;196;Belforêt-en-Perche;1565;51;1616
28;Normandie;61;2;05;197;Guêprei;135;4;139
28;Normandie;61;3;21;198;Guerquesalles;134;0;134
28;Normandie;61;2;06;199;Habloville;328;7;335
28;Normandie;61;1;17;202;Hauterive;464;11;475
28;Normandie;61;1;10;203;Héloup;902;26;928
28;Normandie;61;3;20;206;L'Hôme-Chamondot;252;4;256
28;Normandie;61;3;09;207;Igé;606;23;629
28;Normandie;61;3;20;208;Irai;617;15;632
28;Normandie;61;1;15;209;Joué-du-Bois;420;2;422
28;Normandie;61;2;15;210;Joué-du-Plain;248;9;257
28;Normandie;61;1;07;211;Juvigny Val d'Andaine;2162;54;2216
28;Normandie;61;2;04;212;Juvigny-sur-Orne;126;4;130
28;Normandie;61;1;10;213;Lalacelle;275;10;285
28;Normandie;61;3;01;214;L'Aigle;7961;239;8200
28;Normandie;61;1;17;215;Laleu;356;7;363
28;Normandie;61;1;15;216;La Lande-de-Goult;192;3;195
28;Normandie;61;2;15;217;La Lande-de-Lougé;53;1;54
28;Normandie;61;2;13;218;La Lande-Patry;1793;54;1847
28;Normandie;61;2;06;219;La Lande-Saint-Siméon;158;1;159
28;Normandie;61;2;14;221;Landigou;450;8;458
28;Normandie;61;2;13;222;Landisacq;759;20;779
28;Normandie;61;1;17;224;Larré;452;6;458
28;Normandie;61;3;18;225;Lignères;29;0;29
28;Normandie;61;2;06;227;Lignou;145;3;148
28;Normandie;61;1;15;228;L'Orée-d'Écouves;770;16;786
28;Normandie;61;3;16;229;Loisail;126;4;130
28;Normandie;61;3;20;230;Longny les Villages;2985;50;3035
28;Normandie;61;2;11;232;Lonlay-l'Abbaye;1118;39;1157
28;Normandie;61;2;12;233;Lonlay-le-Tesson;228;7;235
28;Normandie;61;1;10;234;Lonrai;1129;37;1166
28;Normandie;61;2;15;237;Lougé-sur-Maire;316;1;317
28;Normandie;61;2;05;238;Louvières-en-Auge;88;1;89
28;Normandie;61;1;19;240;Macé;368;4;372
28;Normandie;61;3;08;241;La Madeleine-Bouvet;411;11;422
28;Normandie;61;3;20;242;Le Mage;223;10;233
28;Normandie;61;1;15;243;Magny-le-Désert;1388;43;1431
28;Normandie;61;3;18;244;Mahéru;269;12;281
28;Normandie;61;1;07;248;Mantilly;520;8;528
28;Normandie;61;1;17;251;Marchemaisons;155;6;161
28;Normandie;61;3;21;252;Mardilly;136;4;140
28;Normandie;61;3;16;255;Mauves-sur-Huisne;533;12;545
28;Normandie;61;1;19;256;Médavy;153;5;158
28;Normandie;61;1;15;257;Méhoudin;119;2;121
28;Normandie;61;1;17;258;Le Mêle-sur-Sarthe;670;11;681
28;Normandie;61;3;20;259;Le Ménil-Bérard;73;0;73
28;Normandie;61;2;06;260;Le Ménil-de-Briouze;539;10;549
28;Normandie;61;1;17;261;Le Ménil-Broût;169;3;172
28;Normandie;61;2;11;262;Le Ménil-Ciboult;112;1;113
28;Normandie;61;1;17;263;Ménil-Erreux;207;7;214
28;Normandie;61;3;18;264;Ménil-Froger;54;1;55
28;Normandie;61;2;06;265;Ménil-Gondouin;165;4;169
28;Normandie;61;1;17;266;Le Ménil-Guyon;76;0;76
28;Normandie;61;2;06;267;Ménil-Hermei;205;3;208
28;Normandie;61;3;21;268;Ménil-Hubert-en-Exmes;110;5;115
28;Normandie;61;2;06;269;Ménil-Hubert-sur-Orne;484;8;492
28;Normandie;61;1;15;271;Le Ménil-Scelleur;86;0;86
28;Normandie;61;3;18;272;Le Ménil-Vicomte;22;1;23
28;Normandie;61;2;06;273;Ménil-Vin;52;3;55
28;Normandie;61;3;20;274;Les Menus;238;6;244
28;Normandie;61;3;18;275;Le Merlerault;772;19;791
28;Normandie;61;2;05;276;Merri;156;6;162
28;Normandie;61;3;16;277;La Mesnière;281;6;287
28;Normandie;61;2;12;278;Messei;1854;54;1908
28;Normandie;61;1;10;279;Mieuxcé;611;15;626
28;Normandie;61;2;13;281;Moncy;255;7;262
28;Normandie;61;2;04;283;Montabard;283;9;292
28;Normandie;61;1;17;284;Montchevrel;222;2;224
28;Normandie;61;3;16;286;Montgaudry;79;0;79
28;Normandie;61;2;14;287;Montilly-sur-Noireau;720;19;739
28;Normandie;61;1;19;288;Montmerrei;519;7;526
28;Normandie;61;2;05;289;Mont-Ormel;50;0;50
28;Normandie;61;2;06;290;Montreuil-au-Houlme;131;4;135
28;Normandie;61;2;05;291;Montreuil-la-Cambe;63;0;63
28;Normandie;61;2;11;292;Montsecret-Clairefougère;654;9;663
28;Normandie;61;3;16;293;Mortagne-au-Perche;3775;296;4071
28;Normandie;61;1;19;294;Mortrée;1153;27;1180
28;Normandie;61;1;15;295;La Motte-Fouquet;162;2;164
28;Normandie;61;3;20;297;Moulins-la-Marche;732;10;742
28;Normandie;61;2;04;298;Moulins-sur-Orne;314;11;325
28;Normandie;61;3;08;300;Moutiers-au-Perche;383;8;391
28;Normandie;61;1;19;301;Neauphe-sous-Essai;212;1;213
28;Normandie;61;2;05;302;Neauphe-sur-Dive;136;3;139
28;Normandie;61;2;04;303;Nécy;517;13;530
28;Normandie;61;1;17;304;Neuilly-le-Bisson;301;6;307
28;Normandie;61;3;21;307;Neuville-sur-Touques;227;2;229
28;Normandie;61;2;06;308;Neuvy-au-Houlme;206;4;210
28;Normandie;61;3;08;309;Perche en Nocé;2022;63;2085
28;Normandie;61;3;18;310;Nonant-le-Pin;446;30;476
28;Normandie;61;2;04;314;Occagnes;669;17;686
28;Normandie;61;2;05;316;Ommoy;115;3;118
28;Normandie;61;3;21;317;Orgères;179;5;184
28;Normandie;61;3;09;319;Origny-le-Roux;263;7;270
28;Normandie;61;1;10;321;Pacé;420;6;426
28;Normandie;61;3;16;322;Parfondeval;108;2;110
28;Normandie;61;3;20;323;Le Pas-Saint-l'Homer;128;2;130
28;Normandie;61;1;07;324;Passais Villages;1162;14;1176
28;Normandie;61;1;07;326;Perrou;308;6;314
28;Normandie;61;3;16;327;Pervenchères;341;11;352
28;Normandie;61;2;05;328;Le Pin-au-Haras;268;5;273
28;Normandie;61;3;16;329;Le Pin-la-Garenne;639;11;650
28;Normandie;61;3;18;330;Planches;185;3;188
28;Normandie;61;1;17;331;Le Plantis;137;2;139
28;Normandie;61;2;06;332;Pointel;315;43;358
28;Normandie;61;3;21;333;Pontchardon;174;4;178
28;Normandie;61;3;09;336;Pouvrai;103;7;110
28;Normandie;61;2;06;339;Putanges-le-Lac;2140;32;2172
28;Normandie;61;1;17;341;Écouves;1647;55;1702
28;Normandie;61;3;18;342;Rai;1406;30;1436
28;Normandie;61;2;15;344;Rânes;1036;13;1049
28;Normandie;61;3;08;345;Rémalard en Perche;1903;42;1945
28;Normandie;61;3;21;346;Le Renouard;203;6;209
28;Normandie;61;3;21;347;Résenlieu;176;0;176
28;Normandie;61;3;16;348;Réveillon;372;6;378
28;Normandie;61;2;04;349;Ri;161;3;164
28;Normandie;61;1;10;350;La Roche-Mabile;160;8;168
28;Normandie;61;3;21;351;Roiville;133;4;137
28;Normandie;61;2;04;352;Rônai;175;5;180
28;Normandie;61;1;15;357;Rouperroux;200;3;203
28;Normandie;61;2;04;358;Sai;225;5;230
28;Normandie;61;1;17;360;Saint-Agnan-sur-Sarthe;91;2;93
28;Normandie;61;2;06;361;Saint-André-de-Briouze;173;6;179
28;Normandie;61;2;12;362;Saint-André-de-Messei;543;19;562
28;Normandie;61;3;16;363;Saint-Aquilin-de-Corbion;58;2;60
28;Normandie;61;1;17;365;Saint-Aubin-d'Appenai;406;9;415
28;Normandie;61;3;21;366;Saint-Aubin-de-Bonneval;134;2;136
28;Normandie;61;3;16;367;Saint-Aubin-de-Courteraie;131;2;133
28;Normandie;61;2;11;369;Saint-Bômer-les-Forges;1026;37;1063
28;Normandie;61;2;11;370;Saint-Brice;150;2;152
28;Normandie;61;2;15;371;Saint-Brice-sous-Rânes;135;2;137
28;Normandie;61;1;10;372;Saint-Céneri-le-Gérei;115;4;119
28;Normandie;61;3;16;373;Sainte-Céronne-lès-Mortagne;245;8;253
28;Normandie;61;2;11;374;Saint-Christophe-de-Chaulieu;96;4;100
28;Normandie;61;2;04;375;Boischampré;1190;36;1226
28;Normandie;61;2;13;376;Saint-Clair-de-Halouze;864;18;882
28;Normandie;61;3;08;379;Saint-Cyr-la-Rosière;233;5;238
28;Normandie;61;3;16;381;Saint-Denis-sur-Huisne;59;5;64
28;Normandie;61;1;10;382;Saint-Denis-sur-Sarthon;1128;19;1147
28;Normandie;61;1;15;384;Saint-Ellier-les-Bois;256;2;258
28;Normandie;61;3;21;385;Saint-Evroult-de-Montfort;338;8;346
28;Normandie;61;3;18;386;Saint-Evroult-Notre-Dame-du-Bois;442;31;473
28;Normandie;61;1;07;387;Saint-Fraimbault;539;18;557
28;Normandie;61;3;09;388;Saint-Fulgent-des-Ormes;157;2;159
28;Normandie;61;3;18;389;Sainte-Gauburge-Sainte-Colombe;1041;23;1064
28;Normandie;61;2;15;390;Saint-Georges-d'Annebecq;158;1;159
28;Normandie;61;2;14;391;Saint-Georges-des-Groseillers;3152;113;3265
28;Normandie;61;3;21;392;Saint-Germain-d'Aunay;142;4;146
28;Normandie;61;3;18;393;Saint-Germain-de-Clairefeuille;135;5;140
28;Normandie;61;3;09;394;Saint-Germain-de-la-Coudre;797;20;817
28;Normandie;61;3;08;395;Saint-Germain-des-Grois;238;7;245
28;Normandie;61;3;16;396;Saint-Germain-de-Martigny;80;5;85
28;Normandie;61;1;03;397;Saint-Germain-du-Corbéis;3780;132;3912
28;Normandie;61;1;17;398;Saint-Germain-le-Vieux;59;1;60
28;Normandie;61;2;05;399;Saint-Gervais-des-Sablons;73;3;76
28;Normandie;61;1;19;400;Saint-Gervais-du-Perron;361;7;368
28;Normandie;61;2;11;401;Saint-Gilles-des-Marais;106;4;110
28;Normandie;61;2;06;402;Saint-Hilaire-de-Briouze;307;8;315
28;Normandie;61;3;16;404;Saint-Hilaire-le-Châtel;629;21;650
28;Normandie;61;3;09;405;Saint-Hilaire-sur-Erre;531;12;543
28;Normandie;61;3;20;406;Saint-Hilaire-sur-Risle;316;5;321
28;Normandie;61;2;06;407;Sainte-Honorine-la-Chardonne;698;13;711
28;Normandie;61;2;06;408;Sainte-Honorine-la-Guillaume;329;9;338
28;Normandie;61;3;16;411;Saint-Jouin-de-Blavou;280;11;291
28;Normandie;61;1;17;412;Saint-Julien-sur-Sarthe;676;15;691
28;Normandie;61;2;05;413;Saint-Lambert-sur-Dive;138;4;142
28;Normandie;61;3;16;414;Saint-Langis-lès-Mortagne;888;21;909
28;Normandie;61;1;17;415;Saint-Léger-sur-Sarthe;319;6;325
28;Normandie;61;1;17;416;Saint-Léonard-des-Parcs;77;1;78
28;Normandie;61;3;16;418;Saint-Mard-de-Réno;417;11;428
28;Normandie;61;1;15;419;Sainte-Marguerite-de-Carrouges;216;7;223
28;Normandie;61;1;15;420;Sainte-Marie-la-Robert;88;1;89
28;Normandie;61;1;07;421;Saint-Mars-d'Égrenne;661;18;679
28;Normandie;61;3;20;422;Les Aspres;617;15;632
28;Normandie;61;3;01;423;Saint-Martin-d'Écublei;642;27;669
28;Normandie;61;1;15;424;Saint-Martin-des-Landes;199;4;203
28;Normandie;61;3;16;425;Saint-Martin-des-Pézerits;145;2;147
28;Normandie;61;3;09;426;Saint-Martin-du-Vieux-Bellême;562;17;579
28;Normandie;61;1;15;427;Saint-Martin-l'Aiguillon;194;4;198
28;Normandie;61;3;20;429;Charencey;784;16;800
28;Normandie;61;3;01;432;Saint-Michel-Tubœuf;607;22;629
28;Normandie;61;1;10;433;Saint-Nicolas-des-Bois;284;8;292
28;Normandie;61;3;18;435;Saint-Nicolas-de-Sommaire;272;4;276
28;Normandie;61;2;06;436;Sainte-Opportune;235;2;237
28;Normandie;61;3;16;438;Saint-Ouen-de-Sécherouvre;174;5;179
28;Normandie;61;1;15;439;Saint-Ouen-le-Brisoult;121;4;125
28;Normandie;61;3;01;440;Saint-Ouen-sur-Iton;828;35;863
28;Normandie;61;1;15;442;Saint-Patrice-du-Désert;218;6;224
28;Normandie;61;2;13;443;Saint-Paul;689;15;704
28;Normandie;61;2;06;444;Saint-Philbert-sur-Orne;119;3;122
28;Normandie;61;2;13;445;Saint-Pierre-d'Entremont;668;10;678
28;Normandie;61;3;18;446;Saint-Pierre-des-Loges;155;5;160
28;Normandie;61;2;14;447;Saint-Pierre-du-Regard;1404;20;1424
28;Normandie;61;3;08;448;Saint-Pierre-la-Bruyère;431;6;437
28;Normandie;61;1;17;450;Saint-Quentin-de-Blavou;72;1;73
28;Normandie;61;2;11;451;Saint-Quentin-les-Chardonnets;311;6;317
28;Normandie;61;1;07;452;Saint-Roch-sur-Égrenne;175;0;175
28;Normandie;61;1;15;453;Saint-Sauveur-de-Carrouges;245;7;252
28;Normandie;61;1;17;454;Sainte-Scolasse-sur-Sarthe;598;16;614
28;Normandie;61;3;01;456;Saint-Sulpice-sur-Risle;1670;49;1719
28;Normandie;61;3;18;457;Saint-Symphorien-des-Bruyères;479;8;487
28;Normandie;61;2;12;459;Saires-la-Verrerie;308;6;314
28;Normandie;61;3;21;460;Sap-en-Auge;960;10;970
28;Normandie;61;3;21;461;Le Sap-André;127;3;130
28;Normandie;61;2;04;462;Sarceaux;1039;34;1073
28;Normandie;61;2;12;463;Les Monts d'Andaine;1726;34;1760
28;Normandie;61;1;19;464;Sées;4198;444;4642
28;Normandie;61;2;14;466;La Selle-la-Forge;1478;39;1517
28;Normandie;61;1;17;467;Semallé;338;11;349
28;Normandie;61;2;04;472;Sévigny;305;12;317
28;Normandie;61;2;15;473;Sevrai;267;6;273
28;Normandie;61;2;05;474;Gouffern en Auge;3700;80;3780
28;Normandie;61;3;16;475;Soligny-la-Trappe;668;15;683
28;Normandie;61;3;09;476;Suré;276;5;281
28;Normandie;61;2;15;479;Tanques;157;4;161
28;Normandie;61;1;19;480;Tanville;232;5;237
28;Normandie;61;1;17;481;Tellières-le-Plessis;75;3;78
28;Normandie;61;1;07;482;Tessé-Froulay;381;9;390
28;Normandie;61;1;07;483;Bagnoles de l'Orne Normandie;2732;51;2783
28;Normandie;61;3;09;484;Val-au-Perche;3432;73;3505
28;Normandie;61;3;21;485;Ticheville;198;7;205
28;Normandie;61;2;11;486;Tinchebray-Bocage;4882;87;4969
28;Normandie;61;1;07;487;Torchamp;299;4;303
28;Normandie;61;3;18;488;Touquettes;90;2;92
28;Normandie;61;2;05;490;Tournai-sur-Dive;302;1;303
28;Normandie;61;3;20;491;Tourouvre au Perche;3092;50;3142
28;Normandie;61;1;17;492;Trémont;119;4;123
28;Normandie;61;3;21;493;La Trinité-des-Laitiers;60;5;65
28;Normandie;61;2;05;494;Trun;1235;66;1301
28;Normandie;61;1;10;497;Valframbert;1768;29;1797
28;Normandie;61;3;09;498;Vaunoise;101;4;105
28;Normandie;61;1;17;499;Les Ventes-de-Bourse;146;3;149
28;Normandie;61;3;20;500;La Ventrouze;124;4;128
28;Normandie;61;3;08;501;Verrières;423;5;428
28;Normandie;61;1;17;502;Vidai;99;0;99
28;Normandie;61;2;15;503;Vieux-Pont;196;4;200
28;Normandie;61;2;05;505;Villedieu-lès-Bailleul;214;6;220
28;Normandie;61;3;16;507;Villiers-sous-Mortagne;282;5;287
28;Normandie;61;3;21;508;Vimoutiers;3116;87;3203
28;Normandie;61;3;01;510;Vitrai-sous-Laigle;231;4;235
28;Normandie;61;2;06;512;Les Yveteaux;106;3;109
32;Hauts-de-France;62;7;17;001;Ablain-Saint-Nazaire;1877;38;1915
32;Hauts-de-France;62;1;09;002;Ablainzevelle;229;3;232
32;Hauts-de-France;62;7;08;003;Acheville;604;22;626
32;Hauts-de-France;62;1;04;004;Achicourt;7957;108;8065
32;Hauts-de-France;62;1;09;005;Achiet-le-Grand;971;5;976
32;Hauts-de-France;62;1;09;006;Achiet-le-Petit;311;5;316
32;Hauts-de-France;62;1;02;007;Acq;798;5;803
32;Hauts-de-France;62;5;33;008;Acquin-Westbécourt;808;11;819
32;Hauts-de-France;62;1;07;009;Adinfer;274;7;281
32;Hauts-de-France;62;5;33;010;Affringues;250;0;250
32;Hauts-de-France;62;1;07;011;Agnez-lès-Duisans;654;16;670
32;Hauts-de-France;62;1;07;012;Agnières;255;4;259
32;Hauts-de-France;62;1;04;013;Agny;1899;35;1934
32;Hauts-de-France;62;5;01;014;Aire-sur-la-Lys;9691;265;9956
32;Hauts-de-France;62;4;10;015;Airon-Notre-Dame;238;2;240
32;Hauts-de-France;62;4;10;016;Airon-Saint-Vaast;190;5;195
32;Hauts-de-France;62;4;33;017;Aix-en-Ergny;203;1;204
32;Hauts-de-France;62;4;06;018;Aix-en-Issart;267;5;272
32;Hauts-de-France;62;7;17;019;Aix-Noulette;3923;42;3965
32;Hauts-de-France;62;6;19;020;Alembon;624;11;635
32;Hauts-de-France;62;4;33;021;Alette;383;1;384
32;Hauts-de-France;62;3;22;022;Alincthun;314;10;324
32;Hauts-de-France;62;2;31;023;Allouagne;2890;30;2920
32;Hauts-de-France;62;5;33;024;Alquines;984;12;996
32;Hauts-de-France;62;3;22;025;Ambleteuse;1946;30;1976
32;Hauts-de-France;62;4;25;026;Ambricourt;117;9;126
32;Hauts-de-France;62;1;07;027;Ambrines;221;0;221
32;Hauts-de-France;62;2;31;028;Ames;628;8;636
32;Hauts-de-France;62;2;31;029;Amettes;467;1;468
32;Hauts-de-France;62;1;07;030;Amplier;300;4;304
32;Hauts-de-France;62;6;19;031;Andres;1554;23;1577
32;Hauts-de-France;62;7;17;032;Angres;4698;57;4755
32;Hauts-de-France;62;7;29;033;Annay;4377;25;4402
32;Hauts-de-France;62;2;23;034;Annequin;2143;14;2157
32;Hauts-de-France;62;2;11;035;Annezin;5836;46;5882
32;Hauts-de-France;62;1;38;036;Anvin;748;17;765
32;Hauts-de-France;62;1;02;037;Anzin-Saint-Aubin;2751;87;2838
32;Hauts-de-France;62;6;19;038;Ardres;4403;47;4450
32;Hauts-de-France;62;1;15;039;Arleux-en-Gohelle;862;17;879
32;Hauts-de-France;62;5;32;040;Arques;9584;127;9711
32;Hauts-de-France;62;1;96;041;Arras;41694;788;42482
32;Hauts-de-France;62;1;03;042;Athies;1045;13;1058
32;Hauts-de-France;62;6;19;043;Les Attaques;2027;28;2055
32;Hauts-de-France;62;4;10;044;Attin;784;8;792
32;Hauts-de-France;62;1;07;045;Aubigny-en-Artois;1472;19;1491
32;Hauts-de-France;62;4;06;046;Aubin-Saint-Vaast;742;6;748
32;Hauts-de-France;62;1;38;047;Aubrometz;151;1;152
32;Hauts-de-France;62;2;05;048;Auchel;10272;44;10316
32;Hauts-de-France;62;2;31;049;Auchy-au-Bois;530;2;532
32;Hauts-de-France;62;4;06;050;Auchy-lès-Hesdin;1562;16;1578
32;Hauts-de-France;62;2;23;051;Auchy-les-Mines;4678;32;4710
32;Hauts-de-France;62;3;22;052;Audembert;454;13;467
32;Hauts-de-France;62;5;25;053;Audincthun;662;6;668
32;Hauts-de-France;62;3;22;054;Audinghen;588;7;595
32;Hauts-de-France;62;5;33;055;Audrehem;534;8;542
32;Hauts-de-France;62;3;22;056;Audresselles;634;5;639
32;Hauts-de-France;62;6;34;057;Audruicq;5434;53;5487
32;Hauts-de-France;62;1;38;058;Aumerval;199;5;204
32;Hauts-de-France;62;6;19;059;Autingues;289;14;303
32;Hauts-de-France;62;1;06;060;Auxi-le-Château;2572;24;2596
32;Hauts-de-France;62;1;38;061;Averdoingt;292;7;299
32;Hauts-de-France;62;4;33;062;Avesnes;54;1;55
32;Hauts-de-France;62;1;07;063;Avesnes-le-Comte;1833;31;1864
32;Hauts-de-France;62;1;09;064;Avesnes-lès-Bapaume;166;2;168
32;Hauts-de-France;62;7;08;065;Avion;17625;139;17764
32;Hauts-de-France;62;4;25;066;Avondance;35;2;37
32;Hauts-de-France;62;5;25;067;Avroult;619;4;623
32;Hauts-de-France;62;1;09;068;Ayette;325;7;332
32;Hauts-de-France;62;4;06;069;Azincourt;310;8;318
32;Hauts-de-France;62;1;07;070;Bailleul-aux-Cornailles;260;5;265
32;Hauts-de-France;62;1;38;071;Bailleul-lès-Pernes;405;7;412
32;Hauts-de-France;62;1;07;072;Bailleulmont;227;3;230
32;Hauts-de-France;62;1;03;073;Bailleul-Sir-Berthoult;1423;25;1448
32;Hauts-de-France;62;1;07;074;Bailleulval;232;8;240
32;Hauts-de-France;62;3;14;075;Baincthun;1294;30;1324
32;Hauts-de-France;62;6;19;076;Bainghen;218;1;219
32;Hauts-de-France;62;2;16;077;Bajus;366;6;372
32;Hauts-de-France;62;6;19;078;Balinghem;1227;10;1237
32;Hauts-de-France;62;1;09;079;Bancourt;88;0;88
32;Hauts-de-France;62;1;09;080;Bapaume;3748;319;4067
32;Hauts-de-France;62;1;09;081;Baralle;477;10;487
32;Hauts-de-France;62;1;09;082;Barastre;312;4;316
32;Hauts-de-France;62;2;35;083;Barlin;7544;44;7588
32;Hauts-de-France;62;1;07;084;Barly;212;8;220
32;Hauts-de-France;62;1;07;085;Basseux;135;5;140
32;Hauts-de-France;62;1;07;086;Bavincourt;385;7;392
32;Hauts-de-France;62;5;37;087;Bayenghem-lès-Éperlecques;1002;22;1024
32;Hauts-de-France;62;5;33;088;Bayenghem-lès-Seninghem;328;6;334
32;Hauts-de-France;62;3;22;089;Bazinghen;394;13;407
32;Hauts-de-France;62;4;06;090;Béalencourt;129;5;134
32;Hauts-de-France;62;1;07;091;Beaudricourt;87;1;88
32;Hauts-de-France;62;1;07;092;Beaufort-Blavincourt;403;3;406
32;Hauts-de-France;62;1;09;093;Beaulencourt;229;0;229
32;Hauts-de-France;62;4;10;094;Beaumerie-Saint-Martin;409;4;413
32;Hauts-de-France;62;5;25;095;Beaumetz-lès-Aire;241;1;242
32;Hauts-de-France;62;1;09;096;Beaumetz-lès-Cambrai;571;3;574
32;Hauts-de-France;62;1;02;097;Beaumetz-lès-Loges;1002;14;1016
32;Hauts-de-France;62;1;04;099;Beaurains;5552;62;5614
32;Hauts-de-France;62;4;06;100;Beaurainville;2089;27;2116
32;Hauts-de-France;62;1;38;101;Beauvois;138;1;139
32;Hauts-de-France;62;4;33;102;Bécourt;275;3;278
32;Hauts-de-France;62;1;09;103;Béhagnies;130;2;132
32;Hauts-de-France;62;3;22;104;Bellebrune;432;7;439
32;Hauts-de-France;62;3;22;105;Belle-et-Houllefort;566;16;582
32;Hauts-de-France;62;1;15;106;Bellonne;203;6;209
32;Hauts-de-France;62;7;39;107;Bénifontaine;356;9;365
32;Hauts-de-France;62;4;10;108;Berck;13482;331;13813
32;Hauts-de-France;62;1;38;109;Bergueneuse;220;1;221
32;Hauts-de-France;62;1;07;111;Berlencourt-le-Cauroy;283;79;362
32;Hauts-de-France;62;1;07;112;Berles-au-Bois;516;8;524
32;Hauts-de-France;62;1;07;113;Berles-Monchel;487;12;499
32;Hauts-de-France;62;1;38;114;Bermicourt;168;4;172
32;Hauts-de-France;62;1;07;115;Berneville;467;18;485
32;Hauts-de-France;62;4;10;116;Bernieulles;184;1;185
32;Hauts-de-France;62;1;09;117;Bertincourt;916;14;930
32;Hauts-de-France;62;1;07;118;Béthonsart;143;4;147
32;Hauts-de-France;62;2;11;119;Béthune;25039;349;25388
32;Hauts-de-France;62;2;16;120;Beugin;467;8;475
32;Hauts-de-France;62;1;09;121;Beugnâtre;173;4;177
32;Hauts-de-France;62;1;09;122;Beugny;357;4;361
32;Hauts-de-France;62;4;33;123;Beussent;539;4;543
32;Hauts-de-France;62;4;10;124;Beutin;453;5;458
32;Hauts-de-France;62;3;22;125;Beuvrequen;460;14;474
32;Hauts-de-France;62;2;12;126;Beuvry;9219;160;9379
32;Hauts-de-France;62;4;33;127;Bezinghem;388;11;399
32;Hauts-de-France;62;1;15;128;Biache-Saint-Vaast;4305;47;4352
32;Hauts-de-France;62;1;09;129;Biefvillers-lès-Bapaume;97;2;99
32;Hauts-de-France;62;1;07;130;Bienvillers-au-Bois;651;13;664
32;Hauts-de-France;62;1;09;131;Bihucourt;343;3;346
32;Hauts-de-France;62;2;23;132;Billy-Berclau;4885;40;4925
32;Hauts-de-France;62;7;26;133;Billy-Montigny;8177;41;8218
32;Hauts-de-France;62;4;33;134;Bimont;111;2;113
32;Hauts-de-France;62;1;07;135;Blairville;307;3;310
32;Hauts-de-France;62;1;38;137;Blangerval-Blangermont;98;1;99
32;Hauts-de-France;62;4;06;138;Blangy-sur-Ternoise;716;13;729
32;Hauts-de-France;62;5;32;139;Blendecques;4944;133;5077
32;Hauts-de-France;62;5;33;140;Bléquin;501;5;506
32;Hauts-de-France;62;2;01;141;Blessy;877;13;890
32;Hauts-de-France;62;4;06;142;Blingel;160;7;167
32;Hauts-de-France;62;1;06;143;Boffles;49;1;50
32;Hauts-de-France;62;1;04;144;Boiry-Becquerelle;465;7;472
32;Hauts-de-France;62;1;15;145;Boiry-Notre-Dame;444;6;450
32;Hauts-de-France;62;1;07;146;Boiry-Saint-Martin;274;0;274
32;Hauts-de-France;62;1;07;147;Boiry-Sainte-Rictrude;410;5;415
32;Hauts-de-France;62;7;26;148;Bois-Bernard;819;9;828
32;Hauts-de-France;62;5;33;149;Boisdinghem;245;8;253
32;Hauts-de-France;62;4;06;150;Boisjean;499;7;506
32;Hauts-de-France;62;1;04;151;Boisleux-au-Mont;512;10;522
32;Hauts-de-France;62;1;04;152;Boisleux-Saint-Marc;244;3;247
32;Hauts-de-France;62;5;25;153;Bomy;645;7;652
32;Hauts-de-France;62;1;38;154;Bonnières;676;14;690
32;Hauts-de-France;62;5;33;155;Bonningues-lès-Ardres;639;14;653
32;Hauts-de-France;62;6;18;156;Bonningues-lès-Calais;559;13;572
32;Hauts-de-France;62;4;06;157;Boubers-lès-Hesmond;79;3;82
32;Hauts-de-France;62;1;38;158;Boubers-sur-Canche;582;13;595
32;Hauts-de-France;62;3;97;160;Boulogne-sur-Mer;40251;436;40687
32;Hauts-de-France;62;6;19;161;Bouquehault;786;5;791
32;Hauts-de-France;62;2;31;162;Bourecq;606;6;612
32;Hauts-de-France;62;1;38;163;Bouret-sur-Canche;248;3;251
32;Hauts-de-France;62;1;09;164;Bourlon;1141;18;1159
32;Hauts-de-France;62;3;22;165;Bournonville;233;5;238
32;Hauts-de-France;62;1;38;166;Bours;624;7;631
32;Hauts-de-France;62;6;19;167;Boursin;253;4;257
32;Hauts-de-France;62;4;33;168;Bourthes;845;12;857
32;Hauts-de-France;62;5;33;169;Bouvelinghem;238;6;244
32;Hauts-de-France;62;7;17;170;Bouvigny-Boyeffles;2372;93;2465
32;Hauts-de-France;62;1;38;171;Boyaval;131;2;133
32;Hauts-de-France;62;1;04;172;Boyelles;360;3;363
32;Hauts-de-France;62;1;15;173;Brebières;5088;63;5151
32;Hauts-de-France;62;6;19;174;Brêmes;1290;13;1303
32;Hauts-de-France;62;4;06;175;Brévillers;159;5;164
32;Hauts-de-France;62;4;24;176;Bréxent-Énocq;655;18;673
32;Hauts-de-France;62;4;06;177;Brimeux;855;22;877
32;Hauts-de-France;62;2;16;178;Bruay-la-Buissière;21903;367;22270
32;Hauts-de-France;62;3;22;179;Brunembert;412;7;419
32;Hauts-de-France;62;1;38;180;Brias;291;6;297
32;Hauts-de-France;62;1;09;181;Bucquoy;1445;90;1535
32;Hauts-de-France;62;1;06;182;Buire-au-Bois;235;7;242
32;Hauts-de-France;62;4;06;183;Buire-le-Sec;765;4;769
32;Hauts-de-France;62;1;09;184;Buissy;282;3;285
32;Hauts-de-France;62;1;09;185;Bullecourt;235;1;236
32;Hauts-de-France;62;7;17;186;Bully-les-Mines;12156;77;12233
32;Hauts-de-France;62;1;38;187;Buneville;183;2;185
32;Hauts-de-France;62;2;31;188;Burbure;2833;31;2864
32;Hauts-de-France;62;1;09;189;Bus;133;2;135
32;Hauts-de-France;62;2;31;190;Busnes;1257;19;1276
32;Hauts-de-France;62;6;19;191;Caffiers;732;3;735
32;Hauts-de-France;62;1;15;192;Cagnicourt;431;7;438
32;Hauts-de-France;62;6;98;193;Calais;72509;625;73134
32;Hauts-de-France;62;2;05;194;Calonne-Ricouart;5507;33;5540
32;Hauts-de-France;62;2;31;195;Calonne-sur-la-Lys;1540;20;1560
32;Hauts-de-France;62;4;10;196;La Calotterie;614;11;625
32;Hauts-de-France;62;2;05;197;Camblain-Châtelain;1779;16;1795
32;Hauts-de-France;62;1;07;198;Cambligneul;342;10;352
32;Hauts-de-France;62;1;07;199;Camblain-l'Abbé;663;126;789
32;Hauts-de-France;62;2;23;200;Cambrin;1229;13;1242
32;Hauts-de-France;62;4;24;201;Camiers;2730;40;2770
32;Hauts-de-France;62;4;33;202;Campagne-lès-Boulonnais;667;98;765
32;Hauts-de-France;62;6;19;203;Campagne-lès-Guines;449;11;460
32;Hauts-de-France;62;4;06;204;Campagne-lès-Hesdin;1942;37;1979
32;Hauts-de-France;62;5;32;205;Campagne-lès-Wardrecques;1273;27;1300
32;Hauts-de-France;62;4;10;206;Campigneulles-les-Grandes;289;15;304
32;Hauts-de-France;62;4;10;207;Campigneulles-les-Petites;551;22;573
32;Hauts-de-France;62;1;07;208;Canettemont;71;2;73
32;Hauts-de-France;62;4;25;209;Canlers;154;10;164
32;Hauts-de-France;62;1;07;211;Capelle-Fermont;220;4;224
32;Hauts-de-France;62;4;06;212;Capelle-lès-Hesdin;505;11;516
32;Hauts-de-France;62;7;17;213;Carency;780;11;791
32;Hauts-de-France;62;3;22;214;Carly;588;11;599
32;Hauts-de-France;62;7;21;215;Carvin;17557;103;17660
32;Hauts-de-France;62;1;07;216;La Cauchie;207;2;209
32;Hauts-de-France;62;2;05;217;Cauchy-à-la-Tour;2744;15;2759
32;Hauts-de-France;62;2;16;218;Caucourt;337;8;345
32;Hauts-de-France;62;4;06;219;Caumont;159;4;163
32;Hauts-de-France;62;4;06;220;Cavron-Saint-Martin;449;6;455
32;Hauts-de-France;62;1;07;221;Chelers;249;5;254
32;Hauts-de-France;62;4;06;222;Chériennes;159;2;161
32;Hauts-de-France;62;1;09;223;Chérisy;291;5;296
32;Hauts-de-France;62;2;11;224;Chocques;2831;27;2858
32;Hauts-de-France;62;5;37;225;Clairmarais;606;11;617
32;Hauts-de-France;62;4;33;227;Clenleu;188;2;190
32;Hauts-de-France;62;5;33;228;Clerques;327;3;330
32;Hauts-de-France;62;5;33;229;Cléty;793;16;809
32;Hauts-de-France;62;3;22;230;Colembert;971;13;984
32;Hauts-de-France;62;4;10;231;Colline-Beaumont;131;0;131
32;Hauts-de-France;62;2;16;232;La Comté;904;15;919
32;Hauts-de-France;62;4;10;233;Conchil-le-Temple;1125;14;1139
32;Hauts-de-France;62;1;38;234;Conchy-sur-Canche;222;4;226
32;Hauts-de-France;62;3;36;235;Condette;2485;89;2574
32;Hauts-de-France;62;4;06;236;Contes;341;9;350
32;Hauts-de-France;62;3;13;237;Conteville-lès-Boulogne;505;10;515
32;Hauts-de-France;62;1;38;238;Conteville-en-Ternois;84;1;85
32;Hauts-de-France;62;6;18;239;Coquelles;2602;34;2636
32;Hauts-de-France;62;1;15;240;Corbehem;2302;17;2319
32;Hauts-de-France;62;4;24;241;Cormont;310;5;315
32;Hauts-de-France;62;1;07;242;Couin;96;5;101
32;Hauts-de-France;62;1;07;243;Coullemont;125;3;128
32;Hauts-de-France;62;6;19;244;Coulogne;5430;206;5636
32;Hauts-de-France;62;5;33;245;Coulomby;760;7;767
32;Hauts-de-France;62;4;25;246;Coupelle-Neuve;154;0;154
32;Hauts-de-France;62;4;25;247;Coupelle-Vieille;604;11;615
32;Hauts-de-France;62;1;09;248;Courcelles-le-Comte;469;6;475
32;Hauts-de-France;62;7;28;249;Courcelles-lès-Lens;8104;39;8143
32;Hauts-de-France;62;7;21;250;Courrières;10554;96;10650
32;Hauts-de-France;62;3;22;251;Courset;512;191;703
32;Hauts-de-France;62;2;12;252;La Couture;2677;71;2748
32;Hauts-de-France;62;1;07;253;Couturelle;71;0;71
32;Hauts-de-France;62;5;25;254;Coyecques;602;15;617
32;Hauts-de-France;62;3;22;255;Crémarest;793;15;808
32;Hauts-de-France;62;4;25;256;Crépy;152;2;154
32;Hauts-de-France;62;4;25;257;Créquy;470;10;480
32;Hauts-de-France;62;1;38;258;Croisette;266;5;271
32;Hauts-de-France;62;1;09;259;Croisilles;1970;24;1994
32;Hauts-de-France;62;1;38;260;Croix-en-Ternois;330;3;333
32;Hauts-de-France;62;4;24;261;Cucq;5059;93;5152
32;Hauts-de-France;62;2;23;262;Cuinchy;1746;23;1769
32;Hauts-de-France;62;1;02;263;Dainville;5681;112;5793
32;Hauts-de-France;62;3;36;264;Dannes;1346;4;1350
32;Hauts-de-France;62;5;25;265;Delettes;1183;16;1199
32;Hauts-de-France;62;1;07;266;Denier;89;2;91
32;Hauts-de-France;62;5;25;267;Dennebrœucq;395;6;401
32;Hauts-de-France;62;3;22;268;Desvres;4875;39;4914
32;Hauts-de-France;62;2;05;269;Diéval;733;11;744
32;Hauts-de-France;62;2;05;270;Divion;6963;40;7003
32;Hauts-de-France;62;5;33;271;Dohem;834;17;851
32;Hauts-de-France;62;1;09;272;Douchy-lès-Ayette;311;2;313
32;Hauts-de-France;62;3;22;273;Doudeauville;618;9;627
32;Hauts-de-France;62;7;27;274;Dourges;5928;44;5972
32;Hauts-de-France;62;4;06;275;Douriez;303;7;310
32;Hauts-de-France;62;2;23;276;Douvrin;5680;46;5726
32;Hauts-de-France;62;7;28;277;Drocourt;2926;12;2938
32;Hauts-de-France;62;2;35;278;Drouvin-le-Marais;615;19;634
32;Hauts-de-France;62;1;07;279;Duisans;1347;125;1472
32;Hauts-de-France;62;1;15;280;Dury;329;2;331
32;Hauts-de-France;62;3;14;281;Echinghen;387;6;393
32;Hauts-de-France;62;4;06;282;Éclimeux;180;0;180
32;Hauts-de-France;62;1;38;283;Écoivres;134;0;134
32;Hauts-de-France;62;1;09;284;Écourt-Saint-Quentin;1685;19;1704
32;Hauts-de-France;62;1;09;285;Écoust-Saint-Mein;492;9;501
32;Hauts-de-France;62;2;31;286;Ecquedecques;506;4;510
32;Hauts-de-France;62;5;25;288;Ecques;2165;44;2209
32;Hauts-de-France;62;4;10;289;Écuires;704;21;725
32;Hauts-de-France;62;1;02;290;Écurie;381;7;388
32;Hauts-de-France;62;7;30;291;Éleu-dit-Leauwette;2840;31;2871
32;Hauts-de-France;62;5;33;292;Elnes;876;15;891
32;Hauts-de-France;62;4;25;293;Embry;234;5;239
32;Hauts-de-France;62;5;25;295;Enquin-lez-Guinegatte;1623;27;1650
32;Hauts-de-France;62;4;33;296;Enquin-sur-Baillons;281;2;283
32;Hauts-de-France;62;5;37;297;Éperlecques;3696;46;3742
32;Hauts-de-France;62;1;09;298;Épinoy;548;10;558
32;Hauts-de-France;62;1;38;299;Eps;248;5;253
32;Hauts-de-France;62;3;36;300;Équihen-Plage;2662;35;2697
32;Hauts-de-France;62;1;38;301;Équirre;80;1;81
32;Hauts-de-France;62;4;33;302;Ergny;234;2;236
32;Hauts-de-France;62;1;38;303;Érin;245;6;251
32;Hauts-de-France;62;5;25;304;Erny-Saint-Julien;332;2;334
32;Hauts-de-France;62;1;09;306;Ervillers;392;3;395
32;Hauts-de-France;62;6;18;307;Escalles;217;9;226
32;Hauts-de-France;62;5;33;308;Escœuilles;476;10;486
32;Hauts-de-France;62;5;33;309;Esquerdes;1632;21;1653
32;Hauts-de-France;62;2;12;310;Essars;1755;19;1774
32;Hauts-de-France;62;7;39;311;Estevelles;2039;10;2049
32;Hauts-de-France;62;4;10;312;Estrée;292;6;298
32;Hauts-de-France;62;2;01;313;Estrée-Blanche;917;6;923
32;Hauts-de-France;62;2;16;314;Estrée-Cauchy;364;2;366
32;Hauts-de-France;62;4;10;315;Estréelles;348;9;357
32;Hauts-de-France;62;1;07;316;Estrée-Wamin;196;6;202
32;Hauts-de-France;62;1;15;317;Étaing;454;3;457
32;Hauts-de-France;62;4;24;318;Étaples;10912;113;11025
32;Hauts-de-France;62;1;15;319;Éterpigny;258;3;261
32;Hauts-de-France;62;1;02;320;Étrun;311;8;319
32;Hauts-de-France;62;7;28;321;Évin-Malmaison;4625;26;4651
32;Hauts-de-France;62;1;07;322;Famechon;114;1;115
32;Hauts-de-France;62;1;03;323;Fampoux;1203;21;1224
32;Hauts-de-France;62;1;03;324;Farbus;590;14;604
32;Hauts-de-France;62;5;25;325;Fauquembergues;961;20;981
32;Hauts-de-France;62;1;09;326;Favreuil;244;5;249
32;Hauts-de-France;62;5;25;327;Febvin-Palfart;609;4;613
32;Hauts-de-France;62;2;31;328;Ferfay;909;10;919
32;Hauts-de-France;62;3;22;329;Ferques;1768;20;1788
32;Hauts-de-France;62;2;23;330;Festubert;1283;24;1307
32;Hauts-de-France;62;1;03;331;Feuchy;1024;20;1044
32;Hauts-de-France;62;1;07;332;Ficheux;508;10;518
32;Hauts-de-France;62;1;38;333;Fiefs;387;6;393
32;Hauts-de-France;62;6;19;334;Fiennes;868;16;884
32;Hauts-de-France;62;4;06;335;Fillièvres;516;5;521
32;Hauts-de-France;62;5;25;336;Fléchin;480;7;487
32;Hauts-de-France;62;1;38;337;Flers;222;5;227
32;Hauts-de-France;62;2;12;338;Fleurbaix;2698;55;2753
32;Hauts-de-France;62;1;38;339;Fleury;111;1;112
32;Hauts-de-France;62;1;38;340;Floringhem;883;7;890
32;Hauts-de-France;62;1;07;341;Foncquevillers;420;8;428
32;Hauts-de-France;62;1;38;342;Fontaine-lès-Boulans;105;1;106
32;Hauts-de-France;62;1;09;343;Fontaine-lès-Croisilles;265;2;267
32;Hauts-de-France;62;1;38;344;Fontaine-lès-Hermans;108;3;111
32;Hauts-de-France;62;1;06;345;Fontaine-l'Étalon;99;1;100
32;Hauts-de-France;62;1;38;346;Fortel-en-Artois;214;4;218
32;Hauts-de-France;62;1;07;347;Fosseux;129;3;132
32;Hauts-de-France;62;1;38;348;Foufflin-Ricametz;165;2;167
32;Hauts-de-France;62;2;35;349;Fouquereuil;1609;23;1632
32;Hauts-de-France;62;2;35;350;Fouquières-lès-Béthune;1131;20;1151
32;Hauts-de-France;62;7;26;351;Fouquières-lès-Lens;6434;38;6472
32;Hauts-de-France;62;1;38;352;Framecourt;106;2;108
32;Hauts-de-France;62;1;09;353;Frémicourt;236;6;242
32;Hauts-de-France;62;4;24;354;Frencq;870;17;887
32;Hauts-de-France;62;1;15;355;Fresnes-lès-Montauban;581;5;586
32;Hauts-de-France;62;2;16;356;Fresnicourt-le-Dolmen;797;8;805
32;Hauts-de-France;62;4;06;357;Fresnoy;71;1;72
32;Hauts-de-France;62;1;15;358;Fresnoy-en-Gohelle;228;6;234
32;Hauts-de-France;62;4;25;359;Fressin;580;13;593
32;Hauts-de-France;62;6;18;360;Fréthun;1389;14;1403
32;Hauts-de-France;62;1;38;361;Frévent;3423;56;3479
32;Hauts-de-France;62;1;07;362;Frévillers;240;3;243
32;Hauts-de-France;62;1;07;363;Frévin-Capelle;382;9;391
32;Hauts-de-France;62;4;25;364;Fruges;2352;242;2594
32;Hauts-de-France;62;4;06;365;Galametz;201;0;201
32;Hauts-de-France;62;2;16;366;Gauchin-Légal;312;7;319
32;Hauts-de-France;62;1;38;367;Gauchin-Verloingt;830;37;867
32;Hauts-de-France;62;1;07;368;Gaudiempré;203;0;203
32;Hauts-de-France;62;1;03;369;Gavrelle;784;17;801
32;Hauts-de-France;62;1;06;370;Gennes-Ivergny;125;1;126
32;Hauts-de-France;62;7;30;371;Givenchy-en-Gohelle;2030;45;2075
32;Hauts-de-France;62;1;07;372;Givenchy-le-Noble;150;3;153
32;Hauts-de-France;62;2;23;373;Givenchy-lès-la-Bassée;1040;11;1051
32;Hauts-de-France;62;1;09;374;Gomiécourt;153;8;161
32;Hauts-de-France;62;1;07;375;Gommecourt;91;1;92
32;Hauts-de-France;62;2;31;376;Gonnehem;2508;38;2546
32;Hauts-de-France;62;2;35;377;Gosnay;956;7;963
32;Hauts-de-France;62;1;07;378;Gouves;200;4;204
32;Hauts-de-France;62;1;07;379;Gouy-en-Artois;326;8;334
32;Hauts-de-France;62;7;17;380;Gouy-Servins;347;1;348
32;Hauts-de-France;62;1;38;381;Gouy-en-Ternois;132;2;134
32;Hauts-de-France;62;4;06;382;Gouy-Saint-André;652;13;665
32;Hauts-de-France;62;1;15;383;Gouy-sous-Bellonne;1386;19;1405
32;Hauts-de-France;62;1;09;384;Graincourt-lès-Havrincourt;646;8;654
32;Hauts-de-France;62;1;07;385;Grand-Rullecourt;385;5;390
32;Hauts-de-France;62;7;39;386;Grenay;6799;32;6831
32;Hauts-de-France;62;1;09;387;Grévillers;360;10;370
32;Hauts-de-France;62;4;06;388;Grigny;297;1;298
32;Hauts-de-France;62;1;07;389;Grincourt-lès-Pas;30;2;32
32;Hauts-de-France;62;4;10;390;Groffliers;1531;44;1575
32;Hauts-de-France;62;2;01;391;Guarbecque;1399;14;1413
32;Hauts-de-France;62;1;04;392;Guémappe;361;9;370
32;Hauts-de-France;62;6;34;393;Guemps;1097;21;1118
32;Hauts-de-France;62;4;06;395;Guigny;133;4;137
32;Hauts-de-France;62;1;38;396;Guinecourt;15;1;16
32;Hauts-de-France;62;6;19;397;Guînes;5618;79;5697
32;Hauts-de-France;62;4;06;398;Guisy;273;12;285
32;Hauts-de-France;62;1;07;399;Habarcq;659;14;673
32;Hauts-de-France;62;2;35;400;Haillicourt;4837;37;4874
32;Hauts-de-France;62;2;23;401;Haisnes;4398;33;4431
32;Hauts-de-France;62;3;22;402;Halinghen;313;6;319
32;Hauts-de-France;62;5;32;403;Hallines;1206;15;1221
32;Hauts-de-France;62;1;07;404;Halloy;203;2;205
32;Hauts-de-France;62;1;15;405;Hamblain-les-Prés;481;10;491
32;Hauts-de-France;62;1;09;406;Hamelincourt;263;8;271
32;Hauts-de-France;62;2;31;407;Ham-en-Artois;959;13;972
32;Hauts-de-France;62;6;18;408;Hames-Boucres;1457;18;1475
32;Hauts-de-France;62;1;07;409;Hannescamps;195;3;198
32;Hauts-de-France;62;1;09;410;Haplincourt;182;6;188
32;Hauts-de-France;62;1;06;411;Haravesnes;53;0;53
32;Hauts-de-France;62;6;19;412;Hardinghen;1209;6;1215
32;Hauts-de-France;62;7;26;413;Harnes;12237;92;12329
32;Hauts-de-France;62;1;15;414;Haucourt;219;2;221
32;Hauts-de-France;62;1;07;415;Haute-Avesnes;435;9;444
32;Hauts-de-France;62;1;38;416;Hautecloque;216;1;217
32;Hauts-de-France;62;1;07;418;Hauteville;312;8;320
32;Hauts-de-France;62;5;33;419;Haut-Loquin;179;1;180
32;Hauts-de-France;62;1;09;421;Havrincourt;405;11;416
32;Hauts-de-France;62;1;07;422;Hébuterne;520;6;526
32;Hauts-de-France;62;5;32;423;Helfaut;1720;30;1750
32;Hauts-de-France;62;1;15;424;Hendecourt-lès-Cagnicourt;314;11;325
32;Hauts-de-France;62;1;07;425;Hendecourt-lès-Ransart;137;4;141
32;Hauts-de-France;62;1;04;426;Héninel;183;2;185
32;Hauts-de-France;62;7;99;427;Hénin-Beaumont;25992;374;26366
32;Hauts-de-France;62;1;04;428;Hénin-sur-Cojeul;524;7;531
32;Hauts-de-France;62;3;22;429;Henneveux;287;4;291
32;Hauts-de-France;62;1;07;430;Hénu;166;2;168
32;Hauts-de-France;62;6;19;432;Herbinghen;398;8;406
32;Hauts-de-France;62;1;38;433;Héricourt;87;6;93
32;Hauts-de-France;62;1;07;434;La Herlière;141;5;146
32;Hauts-de-France;62;1;38;435;Herlincourt;106;1;107
32;Hauts-de-France;62;1;38;436;Herlin-le-Sec;164;3;167
32;Hauts-de-France;62;4;33;437;Herly;307;7;314
32;Hauts-de-France;62;1;07;438;Hermaville;533;8;541
32;Hauts-de-France;62;6;19;439;Hermelinghen;424;3;427
32;Hauts-de-France;62;1;09;440;Hermies;1200;21;1221
32;Hauts-de-France;62;2;16;441;Hermin;209;2;211
32;Hauts-de-France;62;1;38;442;Hernicourt;565;5;570
32;Hauts-de-France;62;2;35;443;Hersin-Coupigny;6245;41;6286
32;Hauts-de-France;62;3;22;444;Hervelinghen;228;6;234
32;Hauts-de-France;62;2;35;445;Hesdigneul-lès-Béthune;823;17;840
32;Hauts-de-France;62;3;36;446;Hesdigneul-lès-Boulogne;718;22;740
32;Hauts-de-France;62;4;06;447;Hesdin;2216;14;2230
32;Hauts-de-France;62;3;36;448;Hesdin-l'Abbé;1902;28;1930
32;Hauts-de-France;62;4;06;449;Hesmond;159;6;165
32;Hauts-de-France;62;1;38;450;Hestrus;231;6;237
32;Hauts-de-France;62;1;38;451;Heuchin;498;10;508
32;Hauts-de-France;62;5;25;452;Heuringhem;1360;36;1396
32;Hauts-de-France;62;4;25;453;Hézecques;126;3;129
32;Hauts-de-France;62;2;12;454;Hinges;2400;47;2447
32;Hauts-de-France;62;6;19;455;Hocquinghen;112;1;113
32;Hauts-de-France;62;2;35;456;Houchin;710;12;722
32;Hauts-de-France;62;2;16;457;Houdain;7110;57;7167
32;Hauts-de-France;62;5;37;458;Houlle;1147;13;1160
32;Hauts-de-France;62;1;07;459;Houvin-Houvigneul;238;4;242
32;Hauts-de-France;62;4;10;460;Hubersent;272;7;279
32;Hauts-de-France;62;4;06;461;Huby-Saint-Leu;884;10;894
32;Hauts-de-France;62;1;38;462;Huclier;144;5;149
32;Hauts-de-France;62;4;33;463;Hucqueliers;443;37;480
32;Hauts-de-France;62;7;39;464;Hulluch;3405;18;3423
32;Hauts-de-France;62;1;07;465;Humbercamps;222;0;222
32;Hauts-de-France;62;4;33;466;Humbert;232;1;233
32;Hauts-de-France;62;1;38;467;Humerœuille;180;0;180
32;Hauts-de-France;62;1;38;468;Humières;218;2;220
32;Hauts-de-France;62;1;09;469;Inchy-en-Artois;593;7;600
32;Hauts-de-France;62;4;06;470;Incourt;86;0;86
32;Hauts-de-France;62;5;25;471;Bellinghem;1066;22;1088
32;Hauts-de-France;62;4;10;472;Inxent;161;6;167
32;Hauts-de-France;62;2;01;473;Isbergues;8717;78;8795
32;Hauts-de-France;62;3;36;474;Isques;1160;21;1181
32;Hauts-de-France;62;1;07;475;Ivergny;248;3;251
32;Hauts-de-France;62;1;15;476;Izel-lès-Équerchin;1049;11;1060
32;Hauts-de-France;62;1;07;477;Izel-lès-Hameau;729;17;746
32;Hauts-de-France;62;5;33;478;Journy;279;5;284
32;Hauts-de-France;62;2;11;479;Labeuvrière;1660;14;1674
32;Hauts-de-France;62;2;35;480;Labourse;2893;22;2915
32;Hauts-de-France;62;4;06;481;Labroye;154;3;157
32;Hauts-de-France;62;3;22;483;Lacres;247;2;249
32;Hauts-de-France;62;1;09;484;Lagnicourt-Marcel;323;6;329
32;Hauts-de-France;62;5;25;485;Laires;369;1;370
32;Hauts-de-France;62;2;01;486;Lambres;1062;14;1076
32;Hauts-de-France;62;3;22;487;Landrethun-le-Nord;1268;22;1290
32;Hauts-de-France;62;6;19;488;Landrethun-lès-Ardres;769;20;789
32;Hauts-de-France;62;2;11;489;Lapugnoy;3471;29;3500
32;Hauts-de-France;62;1;07;490;Lattre-Saint-Quentin;276;3;279
32;Hauts-de-France;62;2;12;491;Laventie;4979;83;5062
32;Hauts-de-France;62;4;25;492;Lebiez;243;3;246
32;Hauts-de-France;62;1;09;493;Lebucquière;233;4;237
32;Hauts-de-France;62;1;09;494;Léchelle;47;1;48
32;Hauts-de-France;62;5;33;495;Ledinghem;331;6;337
32;Hauts-de-France;62;4;24;496;Lefaux;234;6;240
32;Hauts-de-France;62;7;28;497;Leforest;7248;50;7298
32;Hauts-de-France;62;7;29;498;Lens;31461;187;31648
32;Hauts-de-France;62;4;10;499;Lépine;287;8;295
32;Hauts-de-France;62;2;31;500;Lespesses;409;3;412
32;Hauts-de-France;62;4;06;501;Lespinoy;219;2;221
32;Hauts-de-France;62;2;31;502;Lestrem;4728;73;4801
32;Hauts-de-France;62;3;22;503;Leubringhen;293;6;299
32;Hauts-de-France;62;5;33;504;Leulinghem;256;7;263
32;Hauts-de-France;62;3;22;505;Leulinghen-Bernes;498;9;507
32;Hauts-de-France;62;6;19;506;Licques;1625;20;1645
32;Hauts-de-France;62;1;07;507;Liencourt;295;6;301
32;Hauts-de-France;62;2;31;508;Lières;380;10;390
32;Hauts-de-France;62;2;01;509;Liettres;330;5;335
32;Hauts-de-France;62;7;30;510;Liévin;30112;363;30475
32;Hauts-de-France;62;1;07;511;Lignereuil;141;1;142
32;Hauts-de-France;62;2;01;512;Ligny-lès-Aire;574;15;589
32;Hauts-de-France;62;1;38;513;Ligny-sur-Canche;190;6;196
32;Hauts-de-France;62;1;38;514;Ligny-Saint-Flochel;247;3;250
32;Hauts-de-France;62;1;09;515;Ligny-Thilloy;521;17;538
32;Hauts-de-France;62;2;31;516;Lillers;9810;88;9898
32;Hauts-de-France;62;2;01;517;Linghem;196;6;202
32;Hauts-de-France;62;1;38;518;Linzeux;165;1;166
32;Hauts-de-France;62;1;38;519;Lisbourg;605;8;613
32;Hauts-de-France;62;2;12;520;Locon;2396;58;2454
32;Hauts-de-France;62;4;06;521;La Loge;206;4;210
32;Hauts-de-France;62;4;06;522;Loison-sur-Créquoise;271;3;274
32;Hauts-de-France;62;7;29;523;Loison-sous-Lens;5366;52;5418
32;Hauts-de-France;62;3;22;524;Longfossé;1487;18;1505
32;Hauts-de-France;62;5;32;525;Longuenesse;10563;519;11082
32;Hauts-de-France;62;3;22;526;Longueville;144;2;146
32;Hauts-de-France;62;4;24;527;Longvilliers;253;6;259
32;Hauts-de-France;62;7;39;528;Loos-en-Gohelle;6879;62;6941
32;Hauts-de-France;62;2;23;529;Lorgies;1568;18;1586
32;Hauts-de-France;62;3;22;530;Lottinghen;535;9;544
32;Hauts-de-France;62;6;19;531;Louches;950;19;969
32;Hauts-de-France;62;2;05;532;Lozinghem;1291;13;1304
32;Hauts-de-France;62;4;25;533;Lugy;146;3;149
32;Hauts-de-France;62;5;33;534;Lumbres;3601;74;3675
32;Hauts-de-France;62;4;10;535;La Madelaine-sous-Montreuil;154;8;162
32;Hauts-de-France;62;1;07;536;Magnicourt-en-Comte;643;5;648
32;Hauts-de-France;62;1;07;537;Magnicourt-sur-Canche;108;4;112
32;Hauts-de-France;62;4;06;538;Maintenay;444;9;453
32;Hauts-de-France;62;1;38;539;Maisnil;242;3;245
32;Hauts-de-France;62;2;16;540;Maisnil-lès-Ruitz;1707;15;1722
32;Hauts-de-France;62;4;06;541;Maisoncelle;121;4;125
32;Hauts-de-France;62;1;07;542;Maizières;202;4;206
32;Hauts-de-France;62;5;25;543;Mametz;2004;32;2036
32;Hauts-de-France;62;1;07;544;Manin;182;1;183
32;Hauts-de-France;62;4;33;545;Maninghem;147;0;147
32;Hauts-de-France;62;3;22;546;Maninghen-Henne;296;16;312
32;Hauts-de-France;62;4;06;547;Marant;62;1;63
32;Hauts-de-France;62;6;34;548;Marck;10529;125;10654
32;Hauts-de-France;62;4;06;549;Marconne;1079;64;1143
32;Hauts-de-France;62;4;06;550;Marconnelle;1099;20;1119
32;Hauts-de-France;62;4;06;551;Marenla;237;2;239
32;Hauts-de-France;62;4;06;552;Maresquel-Ecquemicourt;1030;8;1038
32;Hauts-de-France;62;1;38;553;Marest;284;6;290
32;Hauts-de-France;62;4;24;554;Maresville;105;0;105
32;Hauts-de-France;62;2;05;555;Marles-les-Mines;5542;26;5568
32;Hauts-de-France;62;4;06;556;Marles-sur-Canche;308;4;312
32;Hauts-de-France;62;1;02;557;Marœuil;2457;55;2512
32;Hauts-de-France;62;1;38;558;Marquay;176;1;177
32;Hauts-de-France;62;1;09;559;Marquion;964;14;978
32;Hauts-de-France;62;3;22;560;Marquise;5083;61;5144
32;Hauts-de-France;62;1;09;561;Martinpuich;194;1;195
32;Hauts-de-France;62;4;25;562;Matringhem;174;3;177
32;Hauts-de-France;62;7;17;563;Mazingarbe;8033;42;8075
32;Hauts-de-France;62;2;01;564;Mazinghem;469;9;478
32;Hauts-de-France;62;4;25;565;Mencas;77;0;77
32;Hauts-de-France;62;3;22;566;Menneville;670;17;687
32;Hauts-de-France;62;5;37;567;Mentque-Nortbécourt;637;9;646
32;Hauts-de-France;62;1;04;568;Mercatel;716;10;726
32;Hauts-de-France;62;5;25;569;Merck-Saint-Liévin;662;6;668
32;Hauts-de-France;62;7;08;570;Méricourt;11267;69;11336
32;Hauts-de-France;62;4;24;571;Merlimont;3401;70;3471
32;Hauts-de-France;62;1;09;572;Metz-en-Couture;624;10;634
32;Hauts-de-France;62;7;39;573;Meurchin;3748;23;3771
32;Hauts-de-France;62;1;07;574;Mingoval;232;5;237
32;Hauts-de-France;62;1;38;576;Moncheaux-lès-Frévent;144;0;144
32;Hauts-de-France;62;1;38;577;Monchel-sur-Canche;81;2;83
32;Hauts-de-France;62;1;07;578;Monchiet;95;2;97
32;Hauts-de-France;62;1;07;579;Monchy-au-Bois;550;5;555
32;Hauts-de-France;62;1;38;580;Monchy-Breton;515;11;526
32;Hauts-de-France;62;1;38;581;Monchy-Cayeux;298;3;301
32;Hauts-de-France;62;1;03;582;Monchy-le-Preux;647;37;684
32;Hauts-de-France;62;1;07;583;Mondicourt;568;9;577
32;Hauts-de-France;62;2;31;584;Mont-Bernanchon;1337;33;1370
32;Hauts-de-France;62;4;10;585;Montcavrel;399;5;404
32;Hauts-de-France;62;1;07;586;Montenescourt;451;5;456
32;Hauts-de-France;62;7;27;587;Montigny-en-Gohelle;10180;54;10234
32;Hauts-de-France;62;4;10;588;Montreuil;1935;124;2059
32;Hauts-de-France;62;1;02;589;Mont-Saint-Éloi;1014;20;1034
32;Hauts-de-France;62;1;38;590;Monts-en-Ternois;61;0;61
32;Hauts-de-France;62;1;09;591;Morchies;209;5;214
32;Hauts-de-France;62;5;37;592;Moringhem;557;12;569
32;Hauts-de-France;62;1;09;593;Morval;91;0;91
32;Hauts-de-France;62;1;09;594;Mory;307;3;310
32;Hauts-de-France;62;5;37;595;Moulle;1131;29;1160
32;Hauts-de-France;62;4;06;596;Mouriez;243;5;248
32;Hauts-de-France;62;1;09;597;Moyenneville;283;3;286
32;Hauts-de-France;62;6;34;598;Muncq-Nieurlet;727;7;734
32;Hauts-de-France;62;3;22;599;Nabringhen;223;7;230
32;Hauts-de-France;62;1;38;600;Nédon;150;3;153
32;Hauts-de-France;62;1;38;601;Nédonchel;351;5;356
32;Hauts-de-France;62;4;10;602;Nempont-Saint-Firmin;203;2;205
32;Hauts-de-France;62;3;36;603;Nesles;1029;8;1037
32;Hauts-de-France;62;3;36;604;Neufchâtel-Hardelot;3745;72;3817
32;Hauts-de-France;62;4;06;605;Neulette;27;0;27
32;Hauts-de-France;62;2;12;606;Neuve-Chapelle;1450;12;1462
32;Hauts-de-France;62;1;38;607;Neuville-au-Cornet;66;3;69
32;Hauts-de-France;62;1;09;608;Neuville-Bourjonval;168;1;169
32;Hauts-de-France;62;1;02;609;Neuville-Saint-Vaast;1571;37;1608
32;Hauts-de-France;62;4;10;610;Neuville-sous-Montreuil;649;9;658
32;Hauts-de-France;62;1;04;611;Neuville-Vitasse;502;8;510
32;Hauts-de-France;62;1;15;612;Neuvireuil;581;12;593
32;Hauts-de-France;62;5;33;613;Nielles-lès-Bléquin;890;9;899
32;Hauts-de-France;62;6;19;614;Nielles-lès-Ardres;580;14;594
32;Hauts-de-France;62;6;18;615;Nielles-lès-Calais;288;5;293
32;Hauts-de-France;62;1;06;616;Nœux-lès-Auxi;182;2;184
32;Hauts-de-France;62;2;35;617;Nœux-les-Mines;11575;70;11645
32;Hauts-de-France;62;5;37;618;Nordausques;1315;14;1329
32;Hauts-de-France;62;1;09;619;Noreuil;147;2;149
32;Hauts-de-France;62;2;31;620;Norrent-Fontes;1384;22;1406
32;Hauts-de-France;62;6;34;621;Nortkerque;1700;30;1730
32;Hauts-de-France;62;5;37;622;Nort-Leulinghem;258;3;261
32;Hauts-de-France;62;6;34;623;Nouvelle-Église;704;8;712
32;Hauts-de-France;62;7;28;624;Noyelles-Godault;5773;32;5805
32;Hauts-de-France;62;4;06;625;Noyelles-lès-Humières;56;2;58
32;Hauts-de-France;62;2;23;626;Noyelles-lès-Vermelles;2329;20;2349
32;Hauts-de-France;62;1;15;627;Noyelles-sous-Bellonne;820;20;840
32;Hauts-de-France;62;7;26;628;Noyelles-sous-Lens;6632;47;6679
32;Hauts-de-France;62;1;07;629;Noyellette;165;1;166
32;Hauts-de-France;62;1;07;630;Noyelle-Vion;299;5;304
32;Hauts-de-France;62;1;38;631;Nuncq-Hautecôte;496;8;504
32;Hauts-de-France;62;2;11;632;Oblinghem;380;6;386
32;Hauts-de-France;62;1;38;633;Œuf-en-Ternois;251;3;254
32;Hauts-de-France;62;6;34;634;Offekerque;1178;19;1197
32;Hauts-de-France;62;4;06;635;Offin;200;2;202
32;Hauts-de-France;62;3;22;636;Offrethun;267;14;281
32;Hauts-de-France;62;7;27;637;Oignies;9993;48;10041
32;Hauts-de-France;62;1;09;638;Oisy-le-Verger;1195;14;1209
32;Hauts-de-France;62;1;15;639;Oppy;388;9;397
32;Hauts-de-France;62;1;07;640;Orville;381;1;382
32;Hauts-de-France;62;1;38;641;Ostreville;220;3;223
32;Hauts-de-France;62;2;05;642;Ourton;763;9;772
32;Hauts-de-France;62;3;36;643;Outreau;13378;170;13548
32;Hauts-de-France;62;5;33;644;Ouve-Wirquin;503;7;510
32;Hauts-de-France;62;6;34;645;Oye-Plage;5583;84;5667
32;Hauts-de-France;62;1;09;646;Palluel;570;7;577
32;Hauts-de-France;62;4;06;647;Le Parcq;745;15;760
32;Hauts-de-France;62;4;33;648;Parenty;508;11;519
32;Hauts-de-France;62;1;07;649;Pas-en-Artois;756;10;766
32;Hauts-de-France;62;1;15;650;Pelves;754;8;762
32;Hauts-de-France;62;1;07;651;Penin;486;6;492
32;Hauts-de-France;62;1;38;652;Pernes;1633;29;1662
32;Hauts-de-France;62;3;13;653;Pernes-lès-Boulogne;418;19;437
32;Hauts-de-France;62;6;18;654;Peuplingues;782;11;793
32;Hauts-de-France;62;1;38;655;Pierremont;308;7;315
32;Hauts-de-France;62;5;33;656;Pihem;947;27;974
32;Hauts-de-France;62;6;18;657;Pihen-lès-Guînes;499;7;506
32;Hauts-de-France;62;3;13;658;Pittefaux;119;9;128
32;Hauts-de-France;62;4;25;659;Planques;95;3;98
32;Hauts-de-France;62;1;15;660;Plouvain;460;7;467
32;Hauts-de-France;62;4;06;661;Bouin-Plumoison;506;9;515
32;Hauts-de-France;62;6;34;662;Polincove;864;21;885
32;Hauts-de-France;62;1;07;663;Pommera;305;4;309
32;Hauts-de-France;62;1;07;664;Pommier;236;5;241
32;Hauts-de-France;62;1;06;665;Le Ponchel;215;6;221
32;Hauts-de-France;62;7;39;666;Pont-à-Vendin;3134;17;3151
32;Hauts-de-France;62;3;14;667;Le Portel;9071;114;9185
32;Hauts-de-France;62;1;38;668;Prédefin;190;2;192
32;Hauts-de-France;62;1;38;669;Pressy;314;5;319
32;Hauts-de-France;62;4;33;670;Preures;618;7;625
32;Hauts-de-France;62;1;09;671;Pronville-en-Artois;321;4;325
32;Hauts-de-France;62;1;07;672;Puisieux;652;5;657
32;Hauts-de-France;62;1;09;673;Quéant;647;8;655
32;Hauts-de-France;62;5;33;674;Quelmes;555;18;573
32;Hauts-de-France;62;5;33;675;Quercamps;275;2;277
32;Hauts-de-France;62;2;01;676;Quernes;451;7;458
32;Hauts-de-France;62;4;06;677;Le Quesnoy-en-Artois;347;5;352
32;Hauts-de-France;62;3;22;678;Quesques;691;3;694
32;Hauts-de-France;62;3;22;679;Questrecques;318;8;326
32;Hauts-de-France;62;1;15;680;Quiéry-la-Motte;731;13;744
32;Hauts-de-France;62;5;25;681;Quiestède;627;23;650
32;Hauts-de-France;62;4;33;682;Quilen;64;0;64
32;Hauts-de-France;62;1;06;683;Quœux-Haut-Maînil;236;3;239
32;Hauts-de-France;62;5;25;684;Racquinghem;2234;31;2265
32;Hauts-de-France;62;4;25;685;Radinghem;270;163;433
32;Hauts-de-France;62;1;38;686;Ramecourt;359;6;365
32;Hauts-de-France;62;4;10;688;Rang-du-Fliers;4307;117;4424
32;Hauts-de-France;62;1;07;689;Ransart;393;2;395
32;Hauts-de-France;62;4;06;690;Raye-sur-Authie;239;7;246
32;Hauts-de-France;62;5;25;691;Saint-Augustin;813;13;826
32;Hauts-de-France;62;5;33;692;Rebergues;367;4;371
32;Hauts-de-France;62;2;16;693;Rebreuve-Ranchicourt;1076;22;1098
32;Hauts-de-France;62;1;07;694;Rebreuve-sur-Canche;188;2;190
32;Hauts-de-France;62;1;07;695;Rebreuviette;263;2;265
32;Hauts-de-France;62;5;25;696;Reclinghem;236;3;239
32;Hauts-de-France;62;1;15;697;Récourt;229;0;229
32;Hauts-de-France;62;4;10;698;Recques-sur-Course;273;5;278
32;Hauts-de-France;62;6;34;699;Recques-sur-Hem;644;13;657
32;Hauts-de-France;62;4;06;700;Regnauville;215;1;216
32;Hauts-de-France;62;2;01;701;Rely;451;2;453
32;Hauts-de-France;62;5;33;702;Remilly-Wirquin;357;6;363
32;Hauts-de-France;62;1;15;703;Rémy;384;3;387
32;Hauts-de-France;62;5;25;704;Renty;598;18;616
32;Hauts-de-France;62;3;22;705;Rety;2092;16;2108
32;Hauts-de-France;62;2;12;706;Richebourg;2646;57;2703
32;Hauts-de-France;62;1;09;708;Riencourt-lès-Bapaume;32;1;33
32;Hauts-de-France;62;1;15;709;Riencourt-lès-Cagnicourt;253;5;258
32;Hauts-de-France;62;4;25;710;Rimboval;169;4;173
32;Hauts-de-France;62;3;22;711;Rinxent;3038;30;3068
32;Hauts-de-France;62;1;07;712;Rivière;1127;29;1156
32;Hauts-de-France;62;2;31;713;Robecq;1342;23;1365
32;Hauts-de-France;62;1;02;714;Roclincourt;784;18;802
32;Hauts-de-France;62;1;09;715;Rocquigny;287;0;287
32;Hauts-de-France;62;6;19;716;Rodelinghem;540;6;546
32;Hauts-de-France;62;1;38;717;Roëllecourt;534;10;544
32;Hauts-de-France;62;1;15;718;Rœux;1413;22;1435
32;Hauts-de-France;62;4;06;719;Rollancourt;281;35;316
32;Hauts-de-France;62;2;01;720;Rombly;44;2;46
32;Hauts-de-France;62;5;01;721;Roquetoire;1936;49;1985
32;Hauts-de-France;62;1;06;722;Rougefay;89;3;92
32;Hauts-de-France;62;4;06;723;Roussent;239;1;240
32;Hauts-de-France;62;7;26;724;Rouvroy;8945;37;8982
32;Hauts-de-France;62;4;25;725;Royon;139;0;139
32;Hauts-de-France;62;4;25;726;Ruisseauville;203;5;208
32;Hauts-de-France;62;2;35;727;Ruitz;1542;23;1565
32;Hauts-de-France;62;1;09;728;Rumaucourt;683;11;694
32;Hauts-de-France;62;4;33;729;Rumilly;250;6;256
32;Hauts-de-France;62;6;34;730;Ruminghem;1626;22;1648
32;Hauts-de-France;62;1;09;731;Ruyaulcourt;283;3;286
32;Hauts-de-France;62;1;38;732;Sachin;330;2;332
32;Hauts-de-France;62;1;07;733;Sailly-au-Bois;310;2;312
32;Hauts-de-France;62;1;15;734;Sailly-en-Ostrevent;689;8;697
32;Hauts-de-France;62;2;23;735;Sailly-Labourse;2404;17;2421
32;Hauts-de-France;62;2;12;736;Sailly-sur-la-Lys;3910;72;3982
32;Hauts-de-France;62;7;17;737;Sains-en-Gohelle;6060;34;6094
32;Hauts-de-France;62;4;25;738;Sains-lès-Fressin;157;4;161
32;Hauts-de-France;62;1;09;739;Sains-lès-Marquion;325;3;328
32;Hauts-de-France;62;1;38;740;Sains-lès-Pernes;304;9;313
32;Hauts-de-France;62;1;07;741;Saint-Amand;119;3;122
32;Hauts-de-France;62;4;24;742;Saint-Aubin;269;6;275
32;Hauts-de-France;62;4;06;743;Sainte-Austreberthe;389;8;397
32;Hauts-de-France;62;1;02;744;Sainte-Catherine;3562;58;3620
32;Hauts-de-France;62;4;06;745;Saint-Denœux;159;1;160
32;Hauts-de-France;62;3;36;746;Saint-Étienne-au-Mont;5130;65;5195
32;Hauts-de-France;62;2;31;747;Saint-Floris;619;16;635
32;Hauts-de-France;62;6;34;748;Saint-Folquin;2292;41;2333
32;Hauts-de-France;62;4;06;749;Saint-Georges;334;6;340
32;Hauts-de-France;62;2;01;750;Saint-Hilaire-Cottes;810;9;819
32;Hauts-de-France;62;3;22;751;Saint-Inglevert;796;9;805
32;Hauts-de-France;62;4;24;752;Saint-Josse;1130;26;1156
32;Hauts-de-France;62;1;03;753;Saint-Laurent-Blangy;6542;64;6606
32;Hauts-de-France;62;1;09;754;Saint-Léger;474;4;478
32;Hauts-de-France;62;3;36;755;Saint-Léonard;3410;52;3462
32;Hauts-de-France;62;6;34;756;Sainte-Marie-Kerque;1649;30;1679
32;Hauts-de-France;62;5;37;757;Saint-Martin-lez-Tatinghem;5923;134;6057
32;Hauts-de-France;62;3;14;758;Saint-Martin-Boulogne;11136;182;11318
32;Hauts-de-France;62;3;22;759;Saint-Martin-Choquel;473;8;481
32;Hauts-de-France;62;5;25;760;Saint-Martin-d'Hardinghem;279;7;286
32;Hauts-de-France;62;1;04;761;Saint-Martin-sur-Cojeul;210;4;214
32;Hauts-de-France;62;4;33;762;Saint-Michel-sous-Bois;121;5;126
32;Hauts-de-France;62;1;38;763;Saint-Michel-sur-Ternoise;863;16;879
32;Hauts-de-France;62;1;03;764;Saint-Nicolas;4687;53;4740
32;Hauts-de-France;62;5;37;765;Saint-Omer;14903;656;15559
32;Hauts-de-France;62;6;34;766;Saint-Omer-Capelle;1115;12;1127
32;Hauts-de-France;62;1;38;767;Saint-Pol-sur-Ternoise;4909;161;5070
32;Hauts-de-France;62;4;06;768;Saint-Rémy-au-Bois;105;2;107
32;Hauts-de-France;62;6;18;769;Saint-Tricat;760;14;774
32;Hauts-de-France;62;2;31;770;Saint-Venant;3062;86;3148
32;Hauts-de-France;62;7;08;771;Sallaumines;9594;41;9635
32;Hauts-de-France;62;5;37;772;Salperwick;479;25;504
32;Hauts-de-France;62;3;22;773;Samer;4666;147;4813
32;Hauts-de-France;62;6;18;774;Sangatte;4845;128;4973
32;Hauts-de-France;62;6;19;775;Sanghen;349;2;351
32;Hauts-de-France;62;1;09;776;Sapignies;195;4;199
32;Hauts-de-France;62;1;09;777;Le Sars;167;1;168
32;Hauts-de-France;62;1;07;778;Sars-le-Bois;78;1;79
32;Hauts-de-France;62;1;07;779;Sarton;187;1;188
32;Hauts-de-France;62;1;09;780;Sauchy-Cauchy;364;3;367
32;Hauts-de-France;62;1;09;781;Sauchy-Lestrée;461;3;464
32;Hauts-de-France;62;1;15;782;Saudemont;435;8;443
32;Hauts-de-France;62;4;06;783;Saulchoy;317;5;322
32;Hauts-de-France;62;1;07;784;Saulty;775;12;787
32;Hauts-de-France;62;1;07;785;Savy-Berlette;895;185;1080
32;Hauts-de-France;62;3;22;786;Selles;329;3;332
32;Hauts-de-France;62;4;06;787;Sempy;317;3;320
32;Hauts-de-France;62;5;33;788;Seninghem;693;16;709
32;Hauts-de-France;62;3;22;789;Senlecques;281;1;282
32;Hauts-de-France;62;4;25;790;Senlis;162;4;166
32;Hauts-de-France;62;1;38;791;Séricourt;51;0;51
32;Hauts-de-France;62;5;37;792;Serques;1151;32;1183
32;Hauts-de-France;62;7;17;793;Servins;1120;19;1139
32;Hauts-de-France;62;5;33;794;Setques;595;11;606
32;Hauts-de-France;62;1;38;795;Sibiville;112;2;114
32;Hauts-de-France;62;1;07;796;Simencourt;557;12;569
32;Hauts-de-France;62;1;38;797;Siracourt;272;3;275
32;Hauts-de-France;62;1;07;798;Sombrin;239;7;246
32;Hauts-de-France;62;4;10;799;Sorrus;882;27;909
32;Hauts-de-France;62;1;07;800;Souastre;377;3;380
32;Hauts-de-France;62;7;17;801;Souchez;2594;49;2643
32;Hauts-de-France;62;1;07;802;Le Souich;175;2;177
32;Hauts-de-France;62;5;33;803;Surques;637;5;642
32;Hauts-de-France;62;1;07;804;Sus-Saint-Léger;369;5;374
32;Hauts-de-France;62;1;38;805;Tangry;269;1;270
32;Hauts-de-France;62;3;22;806;Tardinghen;151;4;155
32;Hauts-de-France;62;1;38;808;Teneur;257;0;257
32;Hauts-de-France;62;1;38;809;Ternas;137;3;140
32;Hauts-de-France;62;1;03;810;Thélus;1207;36;1243
32;Hauts-de-France;62;5;25;811;Thérouanne;1099;25;1124
32;Hauts-de-France;62;5;25;812;Thiembronne;831;7;838
32;Hauts-de-France;62;1;38;813;La Thieuloye;506;2;508
32;Hauts-de-France;62;1;07;814;Thièvres;101;1;102
32;Hauts-de-France;62;4;10;815;Tigny-Noyelle;174;0;174
32;Hauts-de-France;62;1;07;816;Tilloy-lès-Hermaville;220;5;225
32;Hauts-de-France;62;1;04;817;Tilloy-lès-Mofflaines;1435;119;1554
32;Hauts-de-France;62;1;38;818;Tilly-Capelle;154;1;155
32;Hauts-de-France;62;5;37;819;Tilques;1084;30;1114
32;Hauts-de-France;62;1;07;820;Tincques;816;19;835
32;Hauts-de-France;62;3;22;821;Tingry;294;7;301
32;Hauts-de-France;62;1;06;822;Tollent;92;3;95
32;Hauts-de-France;62;4;25;823;Torcy;173;5;178
32;Hauts-de-France;62;4;06;824;Tortefontaine;212;5;217
32;Hauts-de-France;62;1;15;825;Tortequesne;838;8;846
32;Hauts-de-France;62;4;24;826;Le Touquet-Paris-Plage;4227;274;4501
32;Hauts-de-France;62;5;37;827;Tournehem-sur-la-Hem;1400;17;1417
32;Hauts-de-France;62;4;06;828;Tramecourt;59;0;59
32;Hauts-de-France;62;1;09;829;Le Transloy;433;3;436
32;Hauts-de-France;62;1;09;830;Trescault;176;2;178
32;Hauts-de-France;62;1;38;831;Troisvaux;300;7;307
32;Hauts-de-France;62;4;24;832;Tubersent;563;18;581
32;Hauts-de-France;62;1;38;833;Vacquerie-le-Boucq;77;2;79
32;Hauts-de-France;62;4;06;834;Vacqueriette-Erquières;249;4;253
32;Hauts-de-France;62;1;38;835;Valhuon;554;19;573
32;Hauts-de-France;62;2;35;836;Vaudricourt;1054;29;1083
32;Hauts-de-France;62;5;33;837;Vaudringhem;506;8;514
32;Hauts-de-France;62;1;06;838;Vaulx;90;3;93
32;Hauts-de-France;62;1;09;839;Vaulx-Vraucourt;1023;9;1032
32;Hauts-de-France;62;1;09;840;Vélu;133;0;133
32;Hauts-de-France;62;2;11;841;Vendin-lès-Béthune;2436;24;2460
32;Hauts-de-France;62;7;39;842;Vendin-le-Vieil;8479;44;8523
32;Hauts-de-France;62;4;25;843;Verchin;236;2;238
32;Hauts-de-France;62;4;33;844;Verchocq;634;14;648
32;Hauts-de-France;62;3;22;845;Verlincthun;483;4;487
32;Hauts-de-France;62;2;23;846;Vermelles;4765;41;4806
32;Hauts-de-France;62;2;12;847;Verquigneul;2019;24;2043
32;Hauts-de-France;62;2;12;848;Verquin;3501;34;3535
32;Hauts-de-France;62;4;10;849;Verton;2491;54;2545
32;Hauts-de-France;62;4;06;850;Vieil-Hesdin;344;6;350
32;Hauts-de-France;62;2;12;851;Vieille-Chapelle;805;19;824
32;Hauts-de-France;62;6;34;852;Vieille-Église;1420;11;1431
32;Hauts-de-France;62;3;22;853;Vieil-Moutier;381;10;391
32;Hauts-de-France;62;7;17;854;Villers-au-Bois;599;10;609
32;Hauts-de-France;62;1;09;855;Villers-au-Flos;255;1;256
32;Hauts-de-France;62;1;07;856;Villers-Brûlin;366;4;370
32;Hauts-de-France;62;1;07;857;Villers-Châtel;130;9;139
32;Hauts-de-France;62;1;15;858;Villers-lès-Cagnicourt;257;5;262
32;Hauts-de-France;62;1;06;859;Villers-l'Hôpital;261;4;265
32;Hauts-de-France;62;1;07;860;Villers-Sir-Simon;121;3;124
32;Hauts-de-France;62;7;30;861;Vimy;4358;79;4437
32;Hauts-de-France;62;4;25;862;Vincly;156;3;159
32;Hauts-de-France;62;2;23;863;Violaines;3773;33;3806
32;Hauts-de-France;62;1;15;864;Vis-en-Artois;649;15;664
32;Hauts-de-France;62;1;15;865;Vitry-en-Artois;4675;52;4727
32;Hauts-de-France;62;4;10;866;Waben;438;15;453
32;Hauts-de-France;62;3;22;867;Wacquinghen;269;7;276
32;Hauts-de-France;62;4;06;868;Wail;259;6;265
32;Hauts-de-France;62;1;02;869;Wailly;1083;32;1115
32;Hauts-de-France;62;4;10;870;Wailly-Beaucamp;1029;24;1053
32;Hauts-de-France;62;4;06;871;Wambercourt;256;1;257
32;Hauts-de-France;62;4;06;872;Wamin;233;5;238
32;Hauts-de-France;62;1;04;873;Wancourt;642;10;652
32;Hauts-de-France;62;1;07;874;Wanquetin;716;15;731
32;Hauts-de-France;62;5;25;875;Wardrecques;1363;23;1386
32;Hauts-de-France;62;1;09;876;Warlencourt-Eaucourt;134;2;136
32;Hauts-de-France;62;1;07;877;Warlincourt-lès-Pas;159;5;164
32;Hauts-de-France;62;1;07;878;Warlus;379;7;386
32;Hauts-de-France;62;1;07;879;Warluzel;233;3;236
32;Hauts-de-France;62;3;22;880;Le Wast;202;3;205
32;Hauts-de-France;62;1;06;881;Beauvoir-Wavans;377;10;387
32;Hauts-de-France;62;5;33;882;Wavrans-sur-l'Aa;1239;34;1273
32;Hauts-de-France;62;1;38;883;Wavrans-sur-Ternoise;195;0;195
32;Hauts-de-France;62;2;31;885;Westrehem;256;1;257
32;Hauts-de-France;62;4;33;886;Wicquinghem;267;3;270
32;Hauts-de-France;62;4;24;887;Widehem;243;1;244
32;Hauts-de-France;62;3;22;888;Wierre-au-Bois;225;0;225
32;Hauts-de-France;62;3;22;889;Wierre-Effroy;872;19;891
32;Hauts-de-France;62;4;06;890;Willeman;183;1;184
32;Hauts-de-France;62;1;06;891;Willencourt;136;4;140
32;Hauts-de-France;62;1;03;892;Willerval;649;20;669
32;Hauts-de-France;62;3;13;893;Wimereux;6343;162;6505
32;Hauts-de-France;62;3;13;894;Wimille;3987;80;4067
32;Hauts-de-France;62;7;39;895;Wingles;8756;64;8820
32;Hauts-de-France;62;3;22;896;Wirwignes;738;21;759
32;Hauts-de-France;62;5;33;897;Wismes;511;9;520
32;Hauts-de-France;62;5;33;898;Wisques;220;9;229
32;Hauts-de-France;62;3;22;899;Wissant;854;17;871
32;Hauts-de-France;62;2;01;900;Witternesse;587;15;602
32;Hauts-de-France;62;5;01;901;Wittes;993;13;1006
32;Hauts-de-France;62;5;32;902;Wizernes;3292;53;3345
32;Hauts-de-France;62;4;33;903;Zoteux;620;4;624
32;Hauts-de-France;62;5;37;904;Zouafques;593;10;603
32;Hauts-de-France;62;5;33;905;Zudausques;987;48;1035
32;Hauts-de-France;62;6;34;906;Zutkerque;1784;22;1806
32;Hauts-de-France;62;7;21;907;Libercourt;8321;40;8361
32;Hauts-de-France;62;3;13;908;La Capelle-lès-Boulogne;1616;38;1654
32;Hauts-de-France;62;1;09;909;Ytres;434;5;439
84;Auvergne-Rhône-Alpes;63;4;01;001;Aigueperse;2767;34;2801
84;Auvergne-Rhône-Alpes;63;1;22;002;Aix-la-Fayette;94;0;94
84;Auvergne-Rhône-Alpes;63;1;02;003;Ambert;6655;245;6900
84;Auvergne-Rhône-Alpes;63;4;27;004;Les Ancizes-Comps;1694;29;1723
84;Auvergne-Rhône-Alpes;63;3;06;005;Antoingt;407;5;412
84;Auvergne-Rhône-Alpes;63;3;06;006;Anzat-le-Luguet;173;2;175
84;Auvergne-Rhône-Alpes;63;3;06;007;Apchat;164;3;167
84;Auvergne-Rhône-Alpes;63;5;30;008;Arconsat;585;10;595
84;Auvergne-Rhône-Alpes;63;3;06;009;Ardes;592;6;598
84;Auvergne-Rhône-Alpes;63;1;02;010;Arlanc;1817;39;1856
84;Auvergne-Rhône-Alpes;63;4;26;011;Ars-les-Favets;221;12;233
84;Auvergne-Rhône-Alpes;63;4;01;012;Artonne;912;17;929
84;Auvergne-Rhône-Alpes;63;4;01;013;Aubiat;924;12;936
84;Auvergne-Rhône-Alpes;63;2;03;014;Aubière;10904;154;11058
84;Auvergne-Rhône-Alpes;63;5;22;015;Aubusson-d'Auvergne;236;2;238
84;Auvergne-Rhône-Alpes;63;5;22;016;Augerolles;887;25;912
84;Auvergne-Rhône-Alpes;63;3;06;017;Augnat;195;1;196
84;Auvergne-Rhône-Alpes;63;2;17;019;Aulnat;4095;39;4134
84;Auvergne-Rhône-Alpes;63;3;23;020;Aurières;362;12;374
84;Auvergne-Rhône-Alpes;63;2;21;021;Authezat;690;8;698
84;Auvergne-Rhône-Alpes;63;3;06;022;Auzat-la-Combelle;2004;28;2032
84;Auvergne-Rhône-Alpes;63;1;22;023;Auzelles;377;10;387
84;Auvergne-Rhône-Alpes;63;3;29;024;Avèze;182;4;186
84;Auvergne-Rhône-Alpes;63;4;26;025;Ayat-sur-Sioule;139;5;144
84;Auvergne-Rhône-Alpes;63;2;23;026;Aydat;2466;46;2512
84;Auvergne-Rhône-Alpes;63;1;02;027;Baffie;111;1;112
84;Auvergne-Rhône-Alpes;63;3;29;028;Bagnols;416;16;432
84;Auvergne-Rhône-Alpes;63;3;06;029;Bansat;258;3;261
84;Auvergne-Rhône-Alpes;63;4;20;030;Bas-et-Lezat;340;6;346
84;Auvergne-Rhône-Alpes;63;3;06;031;Beaulieu;467;5;472
84;Auvergne-Rhône-Alpes;63;2;04;032;Beaumont;10664;225;10889
84;Auvergne-Rhône-Alpes;63;4;20;033;Beaumont-lès-Randan;306;2;308
84;Auvergne-Rhône-Alpes;63;2;05;034;Beauregard-l'Évêque;1537;27;1564
84;Auvergne-Rhône-Alpes;63;4;27;035;Beauregard-Vendon;1238;19;1257
84;Auvergne-Rhône-Alpes;63;3;06;036;Bergonne;319;4;323
84;Auvergne-Rhône-Alpes;63;1;22;037;Bertignat;455;14;469
84;Auvergne-Rhône-Alpes;63;3;29;038;Besse-et-Saint-Anastaise;1497;68;1565
84;Auvergne-Rhône-Alpes;63;1;02;039;Beurières;289;10;299
84;Auvergne-Rhône-Alpes;63;2;05;040;Billom;4777;81;4858
84;Auvergne-Rhône-Alpes;63;4;26;041;Biollet;320;9;329
84;Auvergne-Rhône-Alpes;63;2;07;042;Blanzat;3840;57;3897
84;Auvergne-Rhône-Alpes;63;4;27;043;Blot-l'Église;440;3;443
84;Auvergne-Rhône-Alpes;63;2;05;044;Bongheat;429;7;436
84;Auvergne-Rhône-Alpes;63;5;19;045;Bort-l'Étang;689;17;706
84;Auvergne-Rhône-Alpes;63;3;06;046;Boudes;292;4;296
84;Auvergne-Rhône-Alpes;63;3;29;047;La Bourboule;1768;36;1804
84;Auvergne-Rhône-Alpes;63;4;28;048;Bourg-Lastic;865;27;892
84;Auvergne-Rhône-Alpes;63;2;05;049;Bouzel;729;7;736
84;Auvergne-Rhône-Alpes;63;3;06;050;Brassac-les-Mines;3362;122;3484
84;Auvergne-Rhône-Alpes;63;3;18;051;Brenat;628;13;641
84;Auvergne-Rhône-Alpes;63;3;06;052;Le Breuil-sur-Couze;1039;86;1125
84;Auvergne-Rhône-Alpes;63;4;28;053;Briffons;261;11;272
84;Auvergne-Rhône-Alpes;63;3;18;054;Le Broc;693;17;710
84;Auvergne-Rhône-Alpes;63;4;28;055;Bromont-Lamothe;982;16;998
84;Auvergne-Rhône-Alpes;63;1;22;056;Brousse;336;4;340
84;Auvergne-Rhône-Alpes;63;1;22;057;Le Brugeron;242;6;248
84;Auvergne-Rhône-Alpes;63;5;19;058;Bulhon;534;9;543
84;Auvergne-Rhône-Alpes;63;2;31;059;Busséol;218;5;223
84;Auvergne-Rhône-Alpes;63;4;26;060;Bussières;91;0;91
84;Auvergne-Rhône-Alpes;63;4;01;061;Bussières-et-Pruns;469;7;476
84;Auvergne-Rhône-Alpes;63;4;26;062;Buxières-sous-Montaigut;236;2;238
84;Auvergne-Rhône-Alpes;63;2;07;063;Cébazat;8805;110;8915
84;Auvergne-Rhône-Alpes;63;4;28;064;La Celle;78;0;78
84;Auvergne-Rhône-Alpes;63;1;22;065;Ceilloux;174;3;177
84;Auvergne-Rhône-Alpes;63;5;30;066;Celles-sur-Durolle;1677;31;1708
84;Auvergne-Rhône-Alpes;63;4;26;067;La Cellette;164;2;166
84;Auvergne-Rhône-Alpes;63;2;16;069;Le Cendre;5510;59;5569
84;Auvergne-Rhône-Alpes;63;2;04;070;Ceyrat;6364;131;6495
84;Auvergne-Rhône-Alpes;63;3;23;071;Ceyssat;691;11;702
84;Auvergne-Rhône-Alpes;63;5;30;072;Chabreloche;1200;16;1216
84;Auvergne-Rhône-Alpes;63;3;31;073;Chadeleuf;432;14;446
84;Auvergne-Rhône-Alpes;63;3;06;074;Chalus;183;0;183
84;Auvergne-Rhône-Alpes;63;2;08;075;Chamalières;17276;573;17849
84;Auvergne-Rhône-Alpes;63;1;22;076;Chambon-sur-Dolore;149;2;151
84;Auvergne-Rhône-Alpes;63;3;29;077;Chambon-sur-Lac;423;4;427
84;Auvergne-Rhône-Alpes;63;3;06;079;Champagnat-le-Jeune;151;2;153
84;Auvergne-Rhône-Alpes;63;3;29;080;Champeix;1405;22;1427
84;Auvergne-Rhône-Alpes;63;1;02;081;Champétières;271;6;277
84;Auvergne-Rhône-Alpes;63;4;27;082;Champs;403;9;412
84;Auvergne-Rhône-Alpes;63;4;23;083;Chanat-la-Mouteyre;927;27;954
84;Auvergne-Rhône-Alpes;63;2;21;084;Chanonat;1703;36;1739
84;Auvergne-Rhône-Alpes;63;4;28;085;Chapdes-Beaufort;1119;7;1126
84;Auvergne-Rhône-Alpes;63;1;22;086;La Chapelle-Agnon;337;12;349
84;Auvergne-Rhône-Alpes;63;3;06;087;La Chapelle-Marcousse;66;1;67
84;Auvergne-Rhône-Alpes;63;3;06;088;La Chapelle-sur-Usson;83;0;83
84;Auvergne-Rhône-Alpes;63;4;01;089;Chappes;1630;26;1656
84;Auvergne-Rhône-Alpes;63;4;01;090;Chaptuzat;505;8;513
84;Auvergne-Rhône-Alpes;63;3;06;091;Charbonnier-les-Mines;901;15;916
84;Auvergne-Rhône-Alpes;63;4;28;092;Charbonnières-les-Varennes;1789;26;1815
84;Auvergne-Rhône-Alpes;63;4;27;093;Charbonnières-les-Vieilles;1122;22;1144
84;Auvergne-Rhône-Alpes;63;4;26;094;Charensat;489;5;494
84;Auvergne-Rhône-Alpes;63;5;20;095;Charnat;206;3;209
84;Auvergne-Rhône-Alpes;63;2;05;096;Chas;387;6;393
84;Auvergne-Rhône-Alpes;63;3;06;097;Chassagne;79;2;81
84;Auvergne-Rhône-Alpes;63;3;29;098;Chastreix;223;8;231
84;Auvergne-Rhône-Alpes;63;2;09;099;Châteaugay;3105;53;3158
84;Auvergne-Rhône-Alpes;63;4;26;100;Châteauneuf-les-Bains;324;4;328
84;Auvergne-Rhône-Alpes;63;4;26;101;Château-sur-Cher;68;1;69
84;Auvergne-Rhône-Alpes;63;5;20;102;Châteldon;773;14;787
84;Auvergne-Rhône-Alpes;63;4;09;103;Châtel-Guyon;6239;183;6422
84;Auvergne-Rhône-Alpes;63;1;02;104;La Chaulme;113;5;118
84;Auvergne-Rhône-Alpes;63;1;02;105;Chaumont-le-Bourg;229;6;235
84;Auvergne-Rhône-Alpes;63;2;05;106;Chauriat;1699;18;1717
84;Auvergne-Rhône-Alpes;63;4;01;107;Chavaroux;494;8;502
84;Auvergne-Rhône-Alpes;63;4;25;108;Le Cheix;677;14;691
84;Auvergne-Rhône-Alpes;63;3;29;109;Chidrac;527;13;540
84;Auvergne-Rhône-Alpes;63;4;28;110;Cisternes-la-Forêt;463;5;468
84;Auvergne-Rhône-Alpes;63;3;29;111;Clémensat;120;5;125
84;Auvergne-Rhône-Alpes;63;4;01;112;Clerlande;620;7;627
84;Auvergne-Rhône-Alpes;63;2;99;113;Clermont-Ferrand;147865;2731;150596
84;Auvergne-Rhône-Alpes;63;3;06;114;Collanges;158;1;159
84;Auvergne-Rhône-Alpes;63;4;28;115;Combrailles;221;4;225
84;Auvergne-Rhône-Alpes;63;4;27;116;Combronde;2170;34;2204
84;Auvergne-Rhône-Alpes;63;3;29;117;Compains;128;3;131
84;Auvergne-Rhône-Alpes;63;4;28;118;Condat-en-Combraille;414;7;421
84;Auvergne-Rhône-Alpes;63;1;22;119;Condat-lès-Montboissier;227;3;230
84;Auvergne-Rhône-Alpes;63;2;21;120;Corent;762;9;771
84;Auvergne-Rhône-Alpes;63;3;31;121;Coudes;1269;15;1284
84;Auvergne-Rhône-Alpes;63;3;29;122;Courgoul;62;1;63
84;Auvergne-Rhône-Alpes;63;2;23;123;Cournols;236;7;243
84;Auvergne-Rhône-Alpes;63;2;16;124;Cournon-d'Auvergne;20322;366;20688
84;Auvergne-Rhône-Alpes;63;5;22;125;Courpière;4017;147;4164
84;Auvergne-Rhône-Alpes;63;2;21;126;Le Crest;1269;26;1295
84;Auvergne-Rhône-Alpes;63;5;19;128;Crevant-Laveine;963;16;979
84;Auvergne-Rhône-Alpes;63;3;29;129;Cros;167;1;168
84;Auvergne-Rhône-Alpes;63;4;26;130;La Crouzille;259;11;270
84;Auvergne-Rhône-Alpes;63;5;19;131;Culhat;1126;19;1145
84;Auvergne-Rhône-Alpes;63;1;22;132;Cunlhat;1297;26;1323
84;Auvergne-Rhône-Alpes;63;3;06;134;Dauzat-sur-Vodable;68;2;70
84;Auvergne-Rhône-Alpes;63;4;27;135;Davayat;609;5;614
84;Auvergne-Rhône-Alpes;63;1;22;136;Domaize;388;8;396
84;Auvergne-Rhône-Alpes;63;1;02;137;Doranges;175;4;179
84;Auvergne-Rhône-Alpes;63;5;30;138;Dorat;709;9;718
84;Auvergne-Rhône-Alpes;63;1;02;139;Dore-l'Église;656;8;664
84;Auvergne-Rhône-Alpes;63;4;26;140;Durmignat;211;5;216
84;Auvergne-Rhône-Alpes;63;2;07;141;Durtol;2057;48;2105
84;Auvergne-Rhône-Alpes;63;1;22;142;Échandelys;252;12;264
84;Auvergne-Rhône-Alpes;63;4;01;143;Effiat;1131;18;1149
84;Auvergne-Rhône-Alpes;63;3;29;144;Égliseneuve-d'Entraigues;341;9;350
84;Auvergne-Rhône-Alpes;63;3;06;145;Égliseneuve-des-Liards;151;6;157
84;Auvergne-Rhône-Alpes;63;2;05;146;Égliseneuve-près-Billom;808;64;872
84;Auvergne-Rhône-Alpes;63;1;02;147;Églisolles;253;3;256
84;Auvergne-Rhône-Alpes;63;4;01;148;Ennezat;2520;53;2573
84;Auvergne-Rhône-Alpes;63;4;01;149;Entraigues;675;9;684
84;Auvergne-Rhône-Alpes;63;4;09;150;Enval;1543;31;1574
84;Auvergne-Rhône-Alpes;63;5;30;151;Escoutoux;1344;38;1382
84;Auvergne-Rhône-Alpes;63;4;26;152;Espinasse;291;4;295
84;Auvergne-Rhône-Alpes;63;3;29;153;Espinchal;106;2;108
84;Auvergne-Rhône-Alpes;63;2;05;154;Espirat;436;6;442
84;Auvergne-Rhône-Alpes;63;2;05;155;Estandeuil;482;14;496
84;Auvergne-Rhône-Alpes;63;3;06;156;Esteil;59;0;59
84;Auvergne-Rhône-Alpes;63;2;05;157;Fayet-le-Château;367;10;377
84;Auvergne-Rhône-Alpes;63;1;22;158;Fayet-Ronaye;106;6;112
84;Auvergne-Rhône-Alpes;63;4;28;159;Fernoël;134;0;134
84;Auvergne-Rhône-Alpes;63;3;18;160;Aulhat-Flat;926;32;958
84;Auvergne-Rhône-Alpes;63;1;02;161;La Forie;320;10;330
84;Auvergne-Rhône-Alpes;63;1;22;162;Fournols;320;8;328
84;Auvergne-Rhône-Alpes;63;3;23;163;Gelles;954;57;1011
84;Auvergne-Rhône-Alpes;63;2;17;164;Gerzat;10289;86;10375
84;Auvergne-Rhône-Alpes;63;4;28;165;Giat;797;36;833
84;Auvergne-Rhône-Alpes;63;3;06;166;Gignat;241;5;246
84;Auvergne-Rhône-Alpes;63;4;27;167;Gimeaux;401;6;407
84;Auvergne-Rhône-Alpes;63;2;05;168;Glaine-Montaigut;580;13;593
84;Auvergne-Rhône-Alpes;63;3;06;169;La Godivelle;16;0;16
84;Auvergne-Rhône-Alpes;63;4;28;170;La Goutelle;623;15;638
84;Auvergne-Rhône-Alpes;63;4;26;171;Gouttières;329;13;342
84;Auvergne-Rhône-Alpes;63;3;29;172;Grandeyrolles;53;2;55
84;Auvergne-Rhône-Alpes;63;1;02;173;Grandrif;200;7;207
84;Auvergne-Rhône-Alpes;63;1;22;174;Grandval;120;2;122
84;Auvergne-Rhône-Alpes;63;4;28;175;Herment;236;8;244
84;Auvergne-Rhône-Alpes;63;3;23;176;Heume-l'Église;106;3;109
84;Auvergne-Rhône-Alpes;63;2;05;177;Isserteaux;408;10;418
84;Auvergne-Rhône-Alpes;63;3;18;178;Issoire;15296;405;15701
84;Auvergne-Rhône-Alpes;63;1;02;179;Job;1027;30;1057
84;Auvergne-Rhône-Alpes;63;5;19;180;Joze;1132;17;1149
84;Auvergne-Rhône-Alpes;63;4;27;181;Jozerand;551;14;565
84;Auvergne-Rhône-Alpes;63;3;06;182;Jumeaux;589;15;604
84;Auvergne-Rhône-Alpes;63;3;29;183;Labessette;65;0;65
84;Auvergne-Rhône-Alpes;63;5;20;184;Lachaux;279;4;283
84;Auvergne-Rhône-Alpes;63;3;06;185;Lamontgie;639;8;647
84;Auvergne-Rhône-Alpes;63;4;28;186;Landogne;228;8;236
84;Auvergne-Rhône-Alpes;63;4;26;187;Lapeyrouse;523;12;535
84;Auvergne-Rhône-Alpes;63;2;31;188;Laps;589;16;605
84;Auvergne-Rhône-Alpes;63;3;23;189;Laqueuille;370;4;374
84;Auvergne-Rhône-Alpes;63;3;29;190;Larodde;278;7;285
84;Auvergne-Rhône-Alpes;63;4;28;191;Lastic;104;3;107
84;Auvergne-Rhône-Alpes;63;3;29;192;La Tour-d'Auvergne;643;31;674
84;Auvergne-Rhône-Alpes;63;2;24;193;Lempdes;8677;435;9112
84;Auvergne-Rhône-Alpes;63;5;19;194;Lempty;389;7;396
84;Auvergne-Rhône-Alpes;63;5;19;195;Lezoux;6256;73;6329
84;Auvergne-Rhône-Alpes;63;4;20;196;Limons;749;13;762
84;Auvergne-Rhône-Alpes;63;4;27;197;Lisseuil;127;2;129
84;Auvergne-Rhône-Alpes;63;4;27;198;Loubeyrat;1384;19;1403
84;Auvergne-Rhône-Alpes;63;3;29;199;Ludesse;516;5;521
84;Auvergne-Rhône-Alpes;63;4;01;200;Lussat;907;18;925
84;Auvergne-Rhône-Alpes;63;4;20;201;Luzillat;1134;17;1151
84;Auvergne-Rhône-Alpes;63;3;06;202;Madriat;107;3;110
84;Auvergne-Rhône-Alpes;63;4;09;203;Malauzat;1165;18;1183
84;Auvergne-Rhône-Alpes;63;4;17;204;Malintrat;1132;20;1152
84;Auvergne-Rhône-Alpes;63;2;31;205;Manglieu;467;4;471
84;Auvergne-Rhône-Alpes;63;4;27;206;Manzat;1387;19;1406
84;Auvergne-Rhône-Alpes;63;1;22;207;Marat;813;11;824
84;Auvergne-Rhône-Alpes;63;4;27;208;Marcillat;292;5;297
84;Auvergne-Rhône-Alpes;63;3;06;209;Mareugheol;209;5;214
84;Auvergne-Rhône-Alpes;63;4;20;210;Maringues;3125;50;3175
84;Auvergne-Rhône-Alpes;63;1;02;211;Marsac-en-Livradois;1455;47;1502
84;Auvergne-Rhône-Alpes;63;4;09;212;Marsat;1425;37;1462
84;Auvergne-Rhône-Alpes;63;4;01;213;Les Martres-d'Artière;2149;21;2170
84;Auvergne-Rhône-Alpes;63;2;21;214;Les Martres-de-Veyre;3984;55;4039
84;Auvergne-Rhône-Alpes;63;4;01;215;Martres-sur-Morge;676;7;683
84;Auvergne-Rhône-Alpes;63;2;05;216;Mauzun;117;4;121
84;Auvergne-Rhône-Alpes;63;1;02;218;Mayres;198;6;204
84;Auvergne-Rhône-Alpes;63;3;23;219;Mazaye;716;11;727
84;Auvergne-Rhône-Alpes;63;3;06;220;Mazoires;96;3;99
84;Auvergne-Rhône-Alpes;63;1;02;221;Medeyrolles;122;0;122
84;Auvergne-Rhône-Alpes;63;3;18;222;Meilhaud;489;8;497
84;Auvergne-Rhône-Alpes;63;4;26;223;Menat;538;11;549
84;Auvergne-Rhône-Alpes;63;4;09;224;Ménétrol;1623;24;1647
84;Auvergne-Rhône-Alpes;63;4;28;225;Messeix;1048;40;1088
84;Auvergne-Rhône-Alpes;63;2;24;226;Mur-sur-Allier;3435;76;3511
84;Auvergne-Rhône-Alpes;63;2;31;227;Mirefleurs;2380;59;2439
84;Auvergne-Rhône-Alpes;63;4;28;228;Miremont;294;10;304
84;Auvergne-Rhône-Alpes;63;5;19;229;Moissat;1226;23;1249
84;Auvergne-Rhône-Alpes;63;1;22;230;Le Monestier;228;5;233
84;Auvergne-Rhône-Alpes;63;5;30;231;La Monnerie-le-Montel;1685;34;1719
84;Auvergne-Rhône-Alpes;63;4;20;232;Mons;541;13;554
84;Auvergne-Rhône-Alpes;63;4;26;233;Montaigut;982;9;991
84;Auvergne-Rhône-Alpes;63;3;29;234;Montaigut-le-Blanc;875;17;892
84;Auvergne-Rhône-Alpes;63;4;27;235;Montcel;538;6;544
84;Auvergne-Rhône-Alpes;63;3;29;236;Mont-Dore;1279;18;1297
84;Auvergne-Rhône-Alpes;63;4;28;237;Montel-de-Gelat;427;6;433
84;Auvergne-Rhône-Alpes;63;4;28;238;Montfermy;228;1;229
84;Auvergne-Rhône-Alpes;63;2;05;239;Montmorin;720;23;743
84;Auvergne-Rhône-Alpes;63;4;01;240;Montpensier;465;9;474
84;Auvergne-Rhône-Alpes;63;3;31;241;Montpeyroux;326;15;341
84;Auvergne-Rhône-Alpes;63;3;06;242;Moriat;380;10;390
84;Auvergne-Rhône-Alpes;63;4;26;243;Moureuille;378;6;384
84;Auvergne-Rhône-Alpes;63;4;25;244;Chambaron sur Morge;1786;26;1812
84;Auvergne-Rhône-Alpes;63;4;09;245;Mozac;3876;66;3942
84;Auvergne-Rhône-Alpes;63;3;29;246;Murat-le-Quaire;483;17;500
84;Auvergne-Rhône-Alpes;63;3;29;247;Murol;580;10;590
84;Auvergne-Rhône-Alpes;63;3;23;248;Nébouzat;847;21;868
84;Auvergne-Rhône-Alpes;63;5;22;249;Néronde-sur-Dore;523;10;533
84;Auvergne-Rhône-Alpes;63;3;31;250;Neschers;858;18;876
84;Auvergne-Rhône-Alpes;63;4;26;251;Neuf-Église;296;7;303
84;Auvergne-Rhône-Alpes;63;2;05;252;Neuville;379;7;386
84;Auvergne-Rhône-Alpes;63;5;20;253;Noalhat;239;2;241
84;Auvergne-Rhône-Alpes;63;2;07;254;Nohanent;2218;36;2254
84;Auvergne-Rhône-Alpes;63;3;06;255;Nonette-Orsonnette;595;16;611
84;Auvergne-Rhône-Alpes;63;1;02;256;Novacelles;150;2;152
84;Auvergne-Rhône-Alpes;63;3;23;257;Olby;829;11;840
84;Auvergne-Rhône-Alpes;63;1;22;258;Olliergues;763;20;783
84;Auvergne-Rhône-Alpes;63;2;23;259;Olloix;313;10;323
84;Auvergne-Rhône-Alpes;63;5;22;260;Olmet;158;5;163
84;Auvergne-Rhône-Alpes;63;3;18;261;Orbeil;843;29;872
84;Auvergne-Rhône-Alpes;63;2;21;262;Orcet;2756;40;2796
84;Auvergne-Rhône-Alpes;63;2;23;263;Orcines;3493;105;3598
84;Auvergne-Rhône-Alpes;63;3;23;264;Orcival;247;1;248
84;Auvergne-Rhône-Alpes;63;5;19;265;Orléat;2192;43;2235
84;Auvergne-Rhône-Alpes;63;5;30;267;Palladuc;532;17;549
84;Auvergne-Rhône-Alpes;63;3;18;268;Pardines;290;4;294
84;Auvergne-Rhône-Alpes;63;3;31;269;Parent;882;15;897
84;Auvergne-Rhône-Alpes;63;3;06;270;Parentignat;499;15;514
84;Auvergne-Rhône-Alpes;63;5;20;271;Paslières;1490;37;1527
84;Auvergne-Rhône-Alpes;63;2;03;272;Pérignat-lès-Sarliève;2705;52;2757
84;Auvergne-Rhône-Alpes;63;2;31;273;Pérignat-sur-Allier;1507;32;1539
84;Auvergne-Rhône-Alpes;63;3;23;274;Perpezat;428;15;443
84;Auvergne-Rhône-Alpes;63;3;18;275;Perrier;891;19;910
84;Auvergne-Rhône-Alpes;63;5;19;276;Peschadoires;2121;45;2166
84;Auvergne-Rhône-Alpes;63;3;06;277;Peslières;65;0;65
84;Auvergne-Rhône-Alpes;63;4;25;278;Pessat-Villeneuve;706;6;712
84;Auvergne-Rhône-Alpes;63;3;29;279;Picherande;318;6;324
84;Auvergne-Rhône-Alpes;63;2;31;280;Pignols;345;6;351
84;Auvergne-Rhône-Alpes;63;4;26;281;Pionsat;1062;19;1081
84;Auvergne-Rhône-Alpes;63;3;31;282;Plauzat;1713;21;1734
84;Auvergne-Rhône-Alpes;63;4;28;283;Pontaumur;634;114;748
84;Auvergne-Rhône-Alpes;63;2;24;284;Pont-du-Château;12182;305;12487
84;Auvergne-Rhône-Alpes;63;4;28;285;Pontgibaud;762;17;779
84;Auvergne-Rhône-Alpes;63;4;27;286;Pouzol;270;5;275
84;Auvergne-Rhône-Alpes;63;3;06;287;Les Pradeaux;344;7;351
84;Auvergne-Rhône-Alpes;63;4;27;288;Prompsat;453;14;467
84;Auvergne-Rhône-Alpes;63;4;28;289;Prondines;261;9;270
84;Auvergne-Rhône-Alpes;63;4;28;290;Pulvérières;403;9;412
84;Auvergne-Rhône-Alpes;63;5;20;291;Puy-Guillaume;2790;46;2836
84;Auvergne-Rhône-Alpes;63;4;28;292;Puy-Saint-Gulmier;150;5;155
84;Auvergne-Rhône-Alpes;63;4;26;293;Le Quartier;215;8;223
84;Auvergne-Rhône-Alpes;63;4;27;294;Queuille;289;6;295
84;Auvergne-Rhône-Alpes;63;4;20;295;Randan;1591;15;1606
84;Auvergne-Rhône-Alpes;63;5;19;296;Ravel;762;15;777
84;Auvergne-Rhône-Alpes;63;2;05;297;Reignat;382;3;385
84;Auvergne-Rhône-Alpes;63;5;22;298;La Renaudie;127;4;131
84;Auvergne-Rhône-Alpes;63;3;06;299;Rentières;103;0;103
84;Auvergne-Rhône-Alpes;63;4;25;300;Riom;19004;758;19762
84;Auvergne-Rhône-Alpes;63;5;20;301;Ris;747;9;756
84;Auvergne-Rhône-Alpes;63;2;21;302;La Roche-Blanche;3483;67;3550
84;Auvergne-Rhône-Alpes;63;3;06;303;Roche-Charles-la-Mayrand;41;1;42
84;Auvergne-Rhône-Alpes;63;4;26;304;Roche-d'Agoux;110;0;110
84;Auvergne-Rhône-Alpes;63;3;23;305;Rochefort-Montagne;860;143;1003
84;Auvergne-Rhône-Alpes;63;2;31;306;La Roche-Noire;622;10;632
84;Auvergne-Rhône-Alpes;63;2;03;307;Romagnat;7791;178;7969
84;Auvergne-Rhône-Alpes;63;2;08;308;Royat;4359;118;4477
84;Auvergne-Rhône-Alpes;63;1;02;309;Saillant;308;3;311
84;Auvergne-Rhône-Alpes;63;5;30;310;Sainte-Agathe;173;2;175
84;Auvergne-Rhône-Alpes;63;4;01;311;Saint-Agoulin;339;2;341
84;Auvergne-Rhône-Alpes;63;1;02;312;Saint-Alyre-d'Arlanc;151;4;155
84;Auvergne-Rhône-Alpes;63;3;06;313;Saint-Alyre-ès-Montagne;111;5;116
84;Auvergne-Rhône-Alpes;63;1;22;314;Saint-Amant-Roche-Savine;494;27;521
84;Auvergne-Rhône-Alpes;63;2;21;315;Saint-Amant-Tallende;1747;38;1785
84;Auvergne-Rhône-Alpes;63;4;20;317;Saint-André-le-Coq;529;3;532
84;Auvergne-Rhône-Alpes;63;4;27;318;Saint-Angel;462;9;471
84;Auvergne-Rhône-Alpes;63;1;02;319;Saint-Anthème;706;25;731
84;Auvergne-Rhône-Alpes;63;4;28;320;Saint-Avit;218;5;223
84;Auvergne-Rhône-Alpes;63;3;18;321;Saint-Babel;935;15;950
84;Auvergne-Rhône-Alpes;63;4;17;322;Saint-Beauzire;2218;30;2248
84;Auvergne-Rhône-Alpes;63;1;22;323;Saint-Bonnet-le-Bourg;167;3;170
84;Auvergne-Rhône-Alpes;63;1;22;324;Saint-Bonnet-le-Chastel;205;8;213
84;Auvergne-Rhône-Alpes;63;2;05;325;Saint-Bonnet-lès-Allier;418;6;424
84;Auvergne-Rhône-Alpes;63;3;23;326;Saint-Bonnet-près-Orcival;513;8;521
84;Auvergne-Rhône-Alpes;63;4;25;327;Saint-Bonnet-près-Riom;2035;39;2074
84;Auvergne-Rhône-Alpes;63;1;22;328;Sainte-Catherine;51;2;53
84;Auvergne-Rhône-Alpes;63;4;26;329;Sainte-Christine;127;5;132
84;Auvergne-Rhône-Alpes;63;3;29;330;Saint-Cirgues-sur-Couze;351;7;358
84;Auvergne-Rhône-Alpes;63;1;02;331;Saint-Clément-de-Valorgue;232;6;238
84;Auvergne-Rhône-Alpes;63;4;20;332;Saint-Clément-de-Régnat;539;10;549
84;Auvergne-Rhône-Alpes;63;4;20;333;Saint-Denis-Combarnazat;230;8;238
84;Auvergne-Rhône-Alpes;63;2;05;334;Saint-Dier-d'Auvergne;542;20;562
84;Auvergne-Rhône-Alpes;63;3;29;335;Saint-Diéry;525;12;537
84;Auvergne-Rhône-Alpes;63;3;29;336;Saint-Donat;201;4;205
84;Auvergne-Rhône-Alpes;63;1;22;337;Saint-Éloy-la-Glacière;61;1;62
84;Auvergne-Rhône-Alpes;63;4;26;338;Saint-Éloy-les-Mines;3572;141;3713
84;Auvergne-Rhône-Alpes;63;4;28;339;Saint-Étienne-des-Champs;134;2;136
84;Auvergne-Rhône-Alpes;63;3;06;340;Saint-Étienne-sur-Usson;259;3;262
84;Auvergne-Rhône-Alpes;63;1;02;341;Saint-Ferréol-des-Côtes;547;16;563
84;Auvergne-Rhône-Alpes;63;3;29;342;Saint-Floret;245;7;252
84;Auvergne-Rhône-Alpes;63;5;22;343;Saint-Flour-l'Étang;279;7;286
84;Auvergne-Rhône-Alpes;63;4;27;344;Saint-Gal-sur-Sioule;144;4;148
84;Auvergne-Rhône-Alpes;63;2;04;345;Saint-Genès-Champanelle;3659;105;3764
84;Auvergne-Rhône-Alpes;63;3;29;346;Saint-Genès-Champespe;218;7;225
84;Auvergne-Rhône-Alpes;63;4;01;347;Saint-Genès-du-Retz;464;18;482
84;Auvergne-Rhône-Alpes;63;3;06;348;Saint-Genès-la-Tourette;182;1;183
84;Auvergne-Rhône-Alpes;63;4;27;349;Saint-Georges-de-Mons;1933;49;1982
84;Auvergne-Rhône-Alpes;63;2;31;350;Saint-Georges-sur-Allier;1287;19;1306
84;Auvergne-Rhône-Alpes;63;4;28;351;Saint-Germain-près-Herment;72;2;74
84;Auvergne-Rhône-Alpes;63;3;06;352;Saint-Germain-Lembron;2008;42;2050
84;Auvergne-Rhône-Alpes;63;1;22;353;Saint-Germain-l'Herm;483;27;510
84;Auvergne-Rhône-Alpes;63;4;26;354;Saint-Gervais-d'Auvergne;1273;144;1417
84;Auvergne-Rhône-Alpes;63;1;22;355;Saint-Gervais-sous-Meymont;224;4;228
84;Auvergne-Rhône-Alpes;63;3;06;356;Saint-Gervazy;335;13;348
84;Auvergne-Rhône-Alpes;63;3;06;357;Saint-Hérent;116;2;118
84;Auvergne-Rhône-Alpes;63;4;27;358;Saint-Hilaire-la-Croix;360;3;363
84;Auvergne-Rhône-Alpes;63;4;28;359;Saint-Hilaire-les-Monges;85;1;86
84;Auvergne-Rhône-Alpes;63;4;26;360;Saint-Hilaire;154;3;157
84;Auvergne-Rhône-Alpes;63;4;01;362;Saint-Ignat;915;17;932
84;Auvergne-Rhône-Alpes;63;4;28;363;Saint-Jacques-d'Ambur;281;6;287
84;Auvergne-Rhône-Alpes;63;5;19;364;Saint-Jean-d'Heurs;664;8;672
84;Auvergne-Rhône-Alpes;63;2;05;365;Saint-Jean-des-Ollières;431;11;442
84;Auvergne-Rhône-Alpes;63;3;06;366;Saint-Jean-en-Val;353;3;356
84;Auvergne-Rhône-Alpes;63;3;06;367;Saint-Jean-Saint-Gervais;123;1;124
84;Auvergne-Rhône-Alpes;63;2;05;368;Saint-Julien-de-Coppel;1299;26;1325
84;Auvergne-Rhône-Alpes;63;4;26;369;Saint-Julien-la-Geneste;120;3;123
84;Auvergne-Rhône-Alpes;63;3;28;370;Saint-Julien-Puy-Lavèze;365;5;370
84;Auvergne-Rhône-Alpes;63;1;02;371;Saint-Just;154;5;159
84;Auvergne-Rhône-Alpes;63;4;01;372;Saint-Laure;670;5;675
84;Auvergne-Rhône-Alpes;63;4;26;373;Saint-Maigner;189;4;193
84;Auvergne-Rhône-Alpes;63;1;02;374;Saint-Martin-des-Olmes;287;7;294
84;Auvergne-Rhône-Alpes;63;3;06;375;Saint-Martin-des-Plains;166;1;167
84;Auvergne-Rhône-Alpes;63;3;06;376;Saint-Martin-d'Ollières;148;7;155
84;Auvergne-Rhône-Alpes;63;4;26;377;Saint-Maurice-près-Pionsat;372;6;378
84;Auvergne-Rhône-Alpes;63;2;31;378;Saint-Maurice;941;8;949
84;Auvergne-Rhône-Alpes;63;4;27;379;Saint-Myon;517;6;523
84;Auvergne-Rhône-Alpes;63;3;29;380;Saint-Nectaire;762;3;765
84;Auvergne-Rhône-Alpes;63;4;28;381;Saint-Ours;1650;22;1672
84;Auvergne-Rhône-Alpes;63;4;27;382;Saint-Pardoux;393;13;406
84;Auvergne-Rhône-Alpes;63;3;29;383;Saint-Pierre-Colamine;250;5;255
84;Auvergne-Rhône-Alpes;63;1;22;384;Saint-Pierre-la-Bourlhonne;132;5;137
84;Auvergne-Rhône-Alpes;63;4;28;385;Saint-Pierre-le-Chastel;443;9;452
84;Auvergne-Rhône-Alpes;63;3;23;386;Saint-Pierre-Roche;483;5;488
84;Auvergne-Rhône-Alpes;63;4;20;387;Saint-Priest-Bramefant;863;17;880
84;Auvergne-Rhône-Alpes;63;4;26;388;Saint-Priest-des-Champs;702;17;719
84;Auvergne-Rhône-Alpes;63;3;06;389;Saint-Quentin-sur-Sauxillanges;111;2;113
84;Auvergne-Rhône-Alpes;63;4;27;390;Saint-Quintin-sur-Sioule;384;13;397
84;Auvergne-Rhône-Alpes;63;4;27;391;Saint-Rémy-de-Blot;238;4;242
84;Auvergne-Rhône-Alpes;63;3;06;392;Saint-Rémy-de-Chargnat;579;9;588
84;Auvergne-Rhône-Alpes;63;5;30;393;Saint-Rémy-sur-Durolle;1754;33;1787
84;Auvergne-Rhône-Alpes;63;1;02;394;Saint-Romain;207;6;213
84;Auvergne-Rhône-Alpes;63;2;23;395;Saint-Sandoux;972;19;991
84;Auvergne-Rhône-Alpes;63;2;23;396;Saint-Saturnin;1164;70;1234
84;Auvergne-Rhône-Alpes;63;3;29;397;Saint-Sauves-d'Auvergne;1128;20;1148
84;Auvergne-Rhône-Alpes;63;1;02;398;Saint-Sauveur-la-Sagne;88;3;91
84;Auvergne-Rhône-Alpes;63;4;28;399;Saint-Sulpice;85;6;91
84;Auvergne-Rhône-Alpes;63;4;20;400;Saint-Sylvestre-Pragoulin;1076;19;1095
84;Auvergne-Rhône-Alpes;63;3;29;401;Saint-Victor-la-Rivière;252;6;258
84;Auvergne-Rhône-Alpes;63;5;30;402;Saint-Victor-Montvianeix;250;7;257
84;Auvergne-Rhône-Alpes;63;3;29;403;Saint-Vincent;414;11;425
84;Auvergne-Rhône-Alpes;63;3;18;404;Saint-Yvoine;608;11;619
84;Auvergne-Rhône-Alpes;63;2;31;405;Sallèdes;584;12;596
84;Auvergne-Rhône-Alpes;63;4;01;406;Sardon;303;6;309
84;Auvergne-Rhône-Alpes;63;3;23;407;Saulzet-le-Froid;280;7;287
84;Auvergne-Rhône-Alpes;63;4;26;408;Sauret-Besserve;166;5;171
84;Auvergne-Rhône-Alpes;63;3;29;409;Saurier;279;2;281
84;Auvergne-Rhône-Alpes;63;4;28;410;Sauvagnat;138;3;141
84;Auvergne-Rhône-Alpes;63;3;31;411;Sauvagnat-Sainte-Marthe;475;9;484
84;Auvergne-Rhône-Alpes;63;1;02;412;Sauvessanges;529;7;536
84;Auvergne-Rhône-Alpes;63;2;21;413;La Sauvetat;710;12;722
84;Auvergne-Rhône-Alpes;63;5;22;414;Sauviat;551;12;563
84;Auvergne-Rhône-Alpes;63;3;06;415;Sauxillanges;1296;13;1309
84;Auvergne-Rhône-Alpes;63;4;28;416;Savennes;93;3;96
84;Auvergne-Rhône-Alpes;63;4;07;417;Sayat;2429;46;2475
84;Auvergne-Rhône-Alpes;63;5;22;418;Sermentizon;575;9;584
84;Auvergne-Rhône-Alpes;63;4;26;419;Servant;549;12;561
84;Auvergne-Rhône-Alpes;63;5;19;420;Seychalles;799;9;808
84;Auvergne-Rhône-Alpes;63;3;29;421;Singles;160;5;165
84;Auvergne-Rhône-Alpes;63;3;29;422;Solignat;510;9;519
84;Auvergne-Rhône-Alpes;63;3;06;423;Sugères;602;9;611
84;Auvergne-Rhône-Alpes;63;4;01;424;Surat;580;12;592
84;Auvergne-Rhône-Alpes;63;2;21;425;Tallende;1499;42;1541
84;Auvergne-Rhône-Alpes;63;3;29;426;Tauves;766;17;783
84;Auvergne-Rhône-Alpes;63;4;27;427;Teilhède;486;15;501
84;Auvergne-Rhône-Alpes;63;4;26;428;Teilhet;283;2;285
84;Auvergne-Rhône-Alpes;63;3;06;429;Ternant-les-Eaux;32;2;34
84;Auvergne-Rhône-Alpes;63;5;30;430;Thiers;11784;368;12152
84;Auvergne-Rhône-Alpes;63;1;02;431;Thiolières;162;1;163
84;Auvergne-Rhône-Alpes;63;4;01;432;Thuret;915;38;953
84;Auvergne-Rhône-Alpes;63;4;28;433;Tortebesse;73;3;76
84;Auvergne-Rhône-Alpes;63;1;22;434;Tours-sur-Meymont;514;24;538
84;Auvergne-Rhône-Alpes;63;3;29;435;Tourzel-Ronzières;215;6;221
84;Auvergne-Rhône-Alpes;63;4;28;436;Tralaigues;75;0;75
84;Auvergne-Rhône-Alpes;63;3;29;437;Trémouille-Saint-Loup;151;4;155
84;Auvergne-Rhône-Alpes;63;2;05;438;Trézioux;483;5;488
84;Auvergne-Rhône-Alpes;63;3;06;439;Usson;298;2;300
84;Auvergne-Rhône-Alpes;63;3;29;440;Valbeleix;125;0;125
84;Auvergne-Rhône-Alpes;63;1;02;441;Valcivières;208;3;211
84;Auvergne-Rhône-Alpes;63;3;06;442;Valz-sous-Châteauneuf;52;3;55
84;Auvergne-Rhône-Alpes;63;4;01;443;Varennes-sur-Morge;417;12;429
84;Auvergne-Rhône-Alpes;63;3;06;444;Varennes-sur-Usson;300;4;304
84;Auvergne-Rhône-Alpes;63;2;05;445;Vassel;302;5;307
84;Auvergne-Rhône-Alpes;63;4;01;446;Vensat;523;4;527
84;Auvergne-Rhône-Alpes;63;4;26;447;Vergheas;65;4;69
84;Auvergne-Rhône-Alpes;63;3;06;448;Le Vernet-Chaméane;813;64;877
84;Auvergne-Rhône-Alpes;63;3;23;449;Le Vernet-Sainte-Marguerite;302;4;306
84;Auvergne-Rhône-Alpes;63;4;28;450;Verneugheol;236;10;246
84;Auvergne-Rhône-Alpes;63;3;23;451;Vernines;413;17;430
84;Auvergne-Rhône-Alpes;63;3;29;452;Verrières;72;1;73
84;Auvergne-Rhône-Alpes;63;2;05;453;Vertaizon;3258;32;3290
84;Auvergne-Rhône-Alpes;63;1;22;454;Vertolaye;537;10;547
84;Auvergne-Rhône-Alpes;63;2;21;455;Veyre-Monton;3635;57;3692
84;Auvergne-Rhône-Alpes;63;3;06;456;Vichel;343;14;357
84;Auvergne-Rhône-Alpes;63;2;31;457;Vic-le-Comte;5189;99;5288
84;Auvergne-Rhône-Alpes;63;3;06;458;Villeneuve;151;1;152
84;Auvergne-Rhône-Alpes;63;4;20;459;Villeneuve-les-Cerfs;526;4;530
84;Auvergne-Rhône-Alpes;63;4;28;460;Villossanges;366;10;376
84;Auvergne-Rhône-Alpes;63;5;19;461;Vinzelles;359;3;362
84;Auvergne-Rhône-Alpes;63;4;26;462;Virlet;268;5;273
84;Auvergne-Rhône-Alpes;63;5;30;463;Viscomtat;516;9;525
84;Auvergne-Rhône-Alpes;63;4;27;464;Vitrac;346;12;358
84;Auvergne-Rhône-Alpes;63;1;02;465;Viverols;405;9;414
84;Auvergne-Rhône-Alpes;63;3;29;466;Vodable;196;3;199
84;Auvergne-Rhône-Alpes;63;4;28;467;Voingt;30;1;31
84;Auvergne-Rhône-Alpes;63;5;30;468;Vollore-Montagne;300;9;309
84;Auvergne-Rhône-Alpes;63;5;22;469;Vollore-Ville;720;16;736
84;Auvergne-Rhône-Alpes;63;4;09;470;Volvic;4623;71;4694
84;Auvergne-Rhône-Alpes;63;4;26;471;Youx;904;19;923
84;Auvergne-Rhône-Alpes;63;2;31;472;Yronde-et-Buron;652;17;669
84;Auvergne-Rhône-Alpes;63;4;27;473;Yssac-la-Tourette;392;7;399
75;Nouvelle-Aquitaine;64;3;27;001;Aast;186;7;193
75;Nouvelle-Aquitaine;64;3;23;002;Abère;167;1;168
75;Nouvelle-Aquitaine;64;3;09;003;Abidos;214;8;222
75;Nouvelle-Aquitaine;64;2;16;004;Abitain;107;1;108
75;Nouvelle-Aquitaine;64;3;09;005;Abos;544;13;557
75;Nouvelle-Aquitaine;64;2;14;006;Accous;458;12;470
75;Nouvelle-Aquitaine;64;2;14;007;Agnos;1037;26;1063
75;Nouvelle-Aquitaine;64;1;12;008;Ahaxe-Alciette-Bascassan;269;9;278
75;Nouvelle-Aquitaine;64;1;26;009;Ahetze;2071;32;2103
75;Nouvelle-Aquitaine;64;1;22;010;Aïcirits-Camou-Suhast;667;16;683
75;Nouvelle-Aquitaine;64;1;12;011;Aincille;115;6;121
75;Nouvelle-Aquitaine;64;2;12;012;Ainharp;136;1;137
75;Nouvelle-Aquitaine;64;1;12;013;Ainhice-Mongelos;172;5;177
75;Nouvelle-Aquitaine;64;1;26;014;Ainhoa;670;7;677
75;Nouvelle-Aquitaine;64;2;12;015;Alçay-Alçabéhéty-Sunharette;215;3;218
75;Nouvelle-Aquitaine;64;1;12;016;Aldudes;324;6;330
75;Nouvelle-Aquitaine;64;2;12;017;Alos-Sibas-Abense;330;4;334
75;Nouvelle-Aquitaine;64;1;22;018;Amendeuix-Oneix;450;9;459
75;Nouvelle-Aquitaine;64;1;22;019;Amorots-Succos;233;1;234
75;Nouvelle-Aquitaine;64;3;23;021;Andoins;662;21;683
75;Nouvelle-Aquitaine;64;2;16;022;Andrein;136;3;139
75;Nouvelle-Aquitaine;64;3;27;023;Angaïs;911;23;934
75;Nouvelle-Aquitaine;64;1;96;024;Anglet;39719;1121;40840
75;Nouvelle-Aquitaine;64;2;09;025;Angous;97;5;102
75;Nouvelle-Aquitaine;64;1;12;026;Anhaux;380;10;390
75;Nouvelle-Aquitaine;64;3;23;027;Anos;188;3;191
75;Nouvelle-Aquitaine;64;3;25;028;Anoye;136;2;138
75;Nouvelle-Aquitaine;64;2;14;029;Aramits;665;15;680
75;Nouvelle-Aquitaine;64;1;22;031;Arancou;174;3;177
75;Nouvelle-Aquitaine;64;2;09;032;Araujuzon;183;8;191
75;Nouvelle-Aquitaine;64;2;09;033;Araux;134;1;135
75;Nouvelle-Aquitaine;64;1;22;034;Arbérats-Sillègue;297;6;303
75;Nouvelle-Aquitaine;64;1;26;035;Arbonne;2342;62;2404
75;Nouvelle-Aquitaine;64;1;22;036;Arbouet-Sussaute;317;7;324
75;Nouvelle-Aquitaine;64;3;11;037;Arbus;1214;22;1236
75;Nouvelle-Aquitaine;64;1;26;038;Arcangues;3195;81;3276
75;Nouvelle-Aquitaine;64;2;14;039;Aren;245;1;246
75;Nouvelle-Aquitaine;64;2;14;040;Arette;1074;33;1107
75;Nouvelle-Aquitaine;64;3;17;041;Aressy;763;11;774
75;Nouvelle-Aquitaine;64;3;02;042;Argagnon;702;23;725
75;Nouvelle-Aquitaine;64;3;25;043;Argelos;289;4;293
75;Nouvelle-Aquitaine;64;3;02;044;Arget;78;1;79
75;Nouvelle-Aquitaine;64;1;22;045;Arhansus;77;1;78
75;Nouvelle-Aquitaine;64;1;22;046;Armendarits;396;5;401
75;Nouvelle-Aquitaine;64;1;12;047;Arnéguy;236;3;239
75;Nouvelle-Aquitaine;64;3;02;048;Arnos;130;1;131
75;Nouvelle-Aquitaine;64;1;22;049;Aroue-Ithorots-Olhaïby;232;8;240
75;Nouvelle-Aquitaine;64;2;12;050;Arrast-Larrebieu;95;3;98
75;Nouvelle-Aquitaine;64;1;22;051;Arraute-Charritte;406;5;411
75;Nouvelle-Aquitaine;64;3;25;052;Arricau-Bordes;108;0;108
75;Nouvelle-Aquitaine;64;3;23;053;Arrien;190;3;193
75;Nouvelle-Aquitaine;64;3;17;054;Arros-de-Nay;767;21;788
75;Nouvelle-Aquitaine;64;3;25;056;Arrosès;139;2;141
75;Nouvelle-Aquitaine;64;3;02;057;Arthez-de-Béarn;1835;42;1877
75;Nouvelle-Aquitaine;64;3;17;058;Arthez-d'Asson;472;10;482
75;Nouvelle-Aquitaine;64;3;23;059;Artigueloutan;1083;28;1111
75;Nouvelle-Aquitaine;64;3;11;060;Artiguelouve;1851;52;1903
75;Nouvelle-Aquitaine;64;3;02;061;Artix;3428;64;3492
75;Nouvelle-Aquitaine;64;2;15;062;Arudy;2239;46;2285
75;Nouvelle-Aquitaine;64;3;02;063;Arzacq-Arraziguet;1057;21;1078
75;Nouvelle-Aquitaine;64;2;14;064;Asasp-Arros;449;9;458
75;Nouvelle-Aquitaine;64;1;26;065;Ascain;4359;113;4472
75;Nouvelle-Aquitaine;64;1;12;066;Ascarat;329;9;338
75;Nouvelle-Aquitaine;64;3;17;067;Assat;1942;45;1987
75;Nouvelle-Aquitaine;64;3;17;068;Asson;2004;51;2055
75;Nouvelle-Aquitaine;64;2;15;069;Aste-Béon;231;6;237
75;Nouvelle-Aquitaine;64;3;25;070;Astis;307;1;308
75;Nouvelle-Aquitaine;64;2;16;071;Athos-Aspis;210;5;215
75;Nouvelle-Aquitaine;64;3;08;072;Aubertin;651;14;665
75;Nouvelle-Aquitaine;64;3;25;073;Aubin;260;5;265
75;Nouvelle-Aquitaine;64;3;25;074;Aubous;45;0;45
75;Nouvelle-Aquitaine;64;2;09;075;Audaux;166;1;167
75;Nouvelle-Aquitaine;64;3;25;077;Auga;173;3;176
75;Nouvelle-Aquitaine;64;3;25;078;Auriac;230;6;236
75;Nouvelle-Aquitaine;64;3;25;079;Aurions-Idernes;102;3;105
75;Nouvelle-Aquitaine;64;3;02;080;Aussevielle;790;24;814
75;Nouvelle-Aquitaine;64;2;12;081;Aussurucq;239;2;241
75;Nouvelle-Aquitaine;64;2;16;082;Auterrive;140;1;141
75;Nouvelle-Aquitaine;64;2;16;083;Autevielle-Saint-Martin-Bideren;203;3;206
75;Nouvelle-Aquitaine;64;3;25;084;Aydie;140;2;142
75;Nouvelle-Aquitaine;64;2;14;085;Aydius;109;1;110
75;Nouvelle-Aquitaine;64;1;22;086;Ayherre;1094;33;1127
75;Nouvelle-Aquitaine;64;3;16;087;Baigts-de-Béarn;865;22;887
75;Nouvelle-Aquitaine;64;3;02;088;Balansun;299;9;308
75;Nouvelle-Aquitaine;64;3;23;089;Baleix;143;1;144
75;Nouvelle-Aquitaine;64;3;25;090;Baliracq-Maumusson;121;2;123
75;Nouvelle-Aquitaine;64;3;17;091;Baliros;494;7;501
75;Nouvelle-Aquitaine;64;1;12;092;Banca;346;7;353
75;Nouvelle-Aquitaine;64;2;12;093;Barcus;641;5;646
75;Nouvelle-Aquitaine;64;1;13;094;Bardos;1828;49;1877
75;Nouvelle-Aquitaine;64;3;23;095;Barinque;592;12;604
75;Nouvelle-Aquitaine;64;2;16;096;Barraute-Camu;175;1;176
75;Nouvelle-Aquitaine;64;3;27;097;Barzun;609;11;620
75;Nouvelle-Aquitaine;64;3;25;098;Bassillon-Vauzé;65;2;67
75;Nouvelle-Aquitaine;64;2;09;099;Bastanès;98;4;102
75;Nouvelle-Aquitaine;64;1;26;100;Bassussarry;3231;95;3326
75;Nouvelle-Aquitaine;64;3;27;101;Baudreix;585;114;699
75;Nouvelle-Aquitaine;64;1;97;102;Bayonne;51894;1169;53063
75;Nouvelle-Aquitaine;64;3;23;103;Bédeille;207;3;210
75;Nouvelle-Aquitaine;64;2;14;104;Bedous;600;15;615
75;Nouvelle-Aquitaine;64;1;22;105;Béguios;271;12;283
75;Nouvelle-Aquitaine;64;1;22;106;Béhasque-Lapiste;520;9;529
75;Nouvelle-Aquitaine;64;1;12;107;Béhorléguy;73;3;76
75;Nouvelle-Aquitaine;64;3;16;108;Bellocq;909;11;920
75;Nouvelle-Aquitaine;64;3;27;109;Bénéjacq;1943;44;1987
75;Nouvelle-Aquitaine;64;2;15;110;Béost;220;2;222
75;Nouvelle-Aquitaine;64;3;23;111;Bentayou-Sérée;109;1;110
75;Nouvelle-Aquitaine;64;2;16;112;Bérenx;427;4;431
75;Nouvelle-Aquitaine;64;1;22;113;Bergouey-Viellenave;116;5;121
75;Nouvelle-Aquitaine;64;3;23;114;Bernadets;586;9;595
75;Nouvelle-Aquitaine;64;2;12;115;Berrogain-Laruns;159;68;227
75;Nouvelle-Aquitaine;64;2;15;116;Bescat;245;5;250
75;Nouvelle-Aquitaine;64;3;09;117;Bésingrand;145;4;149
75;Nouvelle-Aquitaine;64;3;25;118;Bétracq;50;0;50
75;Nouvelle-Aquitaine;64;3;27;119;Beuste;673;21;694
75;Nouvelle-Aquitaine;64;1;22;120;Beyrie-sur-Joyeuse;530;7;537
75;Nouvelle-Aquitaine;64;3;02;121;Beyrie-en-Béarn;193;2;195
75;Nouvelle-Aquitaine;64;1;07;122;Biarritz;25787;721;26508
75;Nouvelle-Aquitaine;64;1;22;123;Bidache;1358;26;1384
75;Nouvelle-Aquitaine;64;1;12;124;Bidarray;663;15;678
75;Nouvelle-Aquitaine;64;1;24;125;Bidart;6975;138;7113
75;Nouvelle-Aquitaine;64;2;14;126;Bidos;1109;30;1139
75;Nouvelle-Aquitaine;64;2;15;127;Bielle;390;14;404
75;Nouvelle-Aquitaine;64;2;15;128;Bilhères;159;5;164
75;Nouvelle-Aquitaine;64;3;08;129;Billère;12793;230;13023
75;Nouvelle-Aquitaine;64;1;10;130;Biriatou;1228;20;1248
75;Nouvelle-Aquitaine;64;3;09;131;Biron;637;21;658
75;Nouvelle-Aquitaine;64;3;20;132;Bizanos;4563;126;4689
75;Nouvelle-Aquitaine;64;3;27;133;Boeil-Bezing;1347;27;1374
75;Nouvelle-Aquitaine;64;1;22;134;Bonloc;369;7;376
75;Nouvelle-Aquitaine;64;3;02;135;Bonnut;794;14;808
75;Nouvelle-Aquitaine;64;2;14;136;Borce;136;5;141
75;Nouvelle-Aquitaine;64;3;27;137;Bordères;676;20;696
75;Nouvelle-Aquitaine;64;3;27;138;Bordes;2887;52;2939
75;Nouvelle-Aquitaine;64;3;17;139;Bosdarros;988;23;1011
75;Nouvelle-Aquitaine;64;1;05;140;Boucau;8627;170;8797
75;Nouvelle-Aquitaine;64;3;25;141;Boueilh-Boueilho-Lasque;375;9;384
75;Nouvelle-Aquitaine;64;3;02;142;Bougarber;844;27;871
75;Nouvelle-Aquitaine;64;3;02;143;Bouillon;157;0;157
75;Nouvelle-Aquitaine;64;3;02;144;Boumourt;165;2;167
75;Nouvelle-Aquitaine;64;3;17;145;Bourdettes;513;8;521
75;Nouvelle-Aquitaine;64;3;25;146;Bournos;334;4;338
75;Nouvelle-Aquitaine;64;1;13;147;Briscous;2878;45;2923
75;Nouvelle-Aquitaine;64;3;17;148;Bruges-Capbis-Mifaget;870;25;895
75;Nouvelle-Aquitaine;64;2;09;149;Bugnein;243;6;249
75;Nouvelle-Aquitaine;64;1;22;150;Bunus;131;2;133
75;Nouvelle-Aquitaine;64;2;16;151;Burgaronne;99;5;104
75;Nouvelle-Aquitaine;64;3;23;152;Buros;1927;54;1981
75;Nouvelle-Aquitaine;64;3;25;153;Burosse-Mendousse;67;1;68
75;Nouvelle-Aquitaine;64;1;12;154;Bussunarits-Sarrasquette;206;1;207
75;Nouvelle-Aquitaine;64;1;12;155;Bustince-Iriberry;104;1;105
75;Nouvelle-Aquitaine;64;2;15;156;Buziet;476;14;490
75;Nouvelle-Aquitaine;64;2;15;157;Buzy;988;22;1010
75;Nouvelle-Aquitaine;64;3;02;158;Cabidos;173;7;180
75;Nouvelle-Aquitaine;64;3;25;159;Cadillon;117;4;121
75;Nouvelle-Aquitaine;64;1;03;160;Cambo-les-Bains;6622;109;6731
75;Nouvelle-Aquitaine;64;1;22;161;Came;996;19;1015
75;Nouvelle-Aquitaine;64;2;12;162;Camou-Cihigue;101;3;104
75;Nouvelle-Aquitaine;64;3;09;165;Cardesse;300;1;301
75;Nouvelle-Aquitaine;64;1;12;166;Caro;193;9;202
75;Nouvelle-Aquitaine;64;3;25;167;Carrère;217;5;222
75;Nouvelle-Aquitaine;64;2;16;168;Carresse-Cassaber;667;15;682
75;Nouvelle-Aquitaine;64;2;16;170;Castagnède;200;2;202
75;Nouvelle-Aquitaine;64;3;02;171;Casteide-Cami;260;2;262
75;Nouvelle-Aquitaine;64;3;02;172;Casteide-Candau;302;3;305
75;Nouvelle-Aquitaine;64;3;23;173;Casteide-Doat;162;1;163
75;Nouvelle-Aquitaine;64;3;23;174;Castéra-Loubix;52;1;53
75;Nouvelle-Aquitaine;64;2;15;175;Castet;153;4;157
75;Nouvelle-Aquitaine;64;2;16;176;Castetbon;166;4;170
75;Nouvelle-Aquitaine;64;3;02;177;Castétis;624;25;649
75;Nouvelle-Aquitaine;64;2;09;178;Castetnau-Camblong;464;15;479
75;Nouvelle-Aquitaine;64;3;09;179;Castetner;133;6;139
75;Nouvelle-Aquitaine;64;3;25;180;Castetpugon;212;5;217
75;Nouvelle-Aquitaine;64;3;02;181;Castillon (Canton d'Arthez-de-Béarn);330;4;334
75;Nouvelle-Aquitaine;64;3;25;182;Castillon (Canton de Lembeye);69;1;70
75;Nouvelle-Aquitaine;64;3;25;183;Caubios-Loos;598;18;616
75;Nouvelle-Aquitaine;64;3;02;184;Cescau;612;27;639
75;Nouvelle-Aquitaine;64;2;14;185;Cette-Eygun;61;1;62
75;Nouvelle-Aquitaine;64;2;09;186;Charre;216;3;219
75;Nouvelle-Aquitaine;64;2;12;187;Charritte-de-Bas;254;9;263
75;Nouvelle-Aquitaine;64;2;12;188;Chéraute;1083;154;1237
75;Nouvelle-Aquitaine;64;1;24;189;Ciboure;6211;180;6391
75;Nouvelle-Aquitaine;64;3;25;190;Claracq;236;8;244
75;Nouvelle-Aquitaine;64;3;27;191;Coarraze;2170;142;2312
75;Nouvelle-Aquitaine;64;3;25;192;Conchez-de-Béarn;111;1;112
75;Nouvelle-Aquitaine;64;3;25;193;Corbère-Abères;98;2;100
75;Nouvelle-Aquitaine;64;3;25;194;Coslédaà-Lube-Boast;382;9;391
75;Nouvelle-Aquitaine;64;3;02;195;Coublucq;95;2;97
75;Nouvelle-Aquitaine;64;3;25;196;Crouseilles;121;0;121
75;Nouvelle-Aquitaine;64;3;09;197;Cuqueron;189;5;194
75;Nouvelle-Aquitaine;64;3;02;198;Denguin;1766;50;1816
75;Nouvelle-Aquitaine;64;3;25;199;Diusse;142;4;146
75;Nouvelle-Aquitaine;64;3;02;200;Doazon;182;3;185
75;Nouvelle-Aquitaine;64;2;09;201;Dognen;227;7;234
75;Nouvelle-Aquitaine;64;1;22;202;Domezain-Berraute;464;11;475
75;Nouvelle-Aquitaine;64;3;25;203;Doumy;317;7;324
75;Nouvelle-Aquitaine;64;2;15;204;Eaux-Bonnes;193;3;196
75;Nouvelle-Aquitaine;64;2;16;205;Escos;237;2;239
75;Nouvelle-Aquitaine;64;2;14;206;Escot;123;1;124
75;Nouvelle-Aquitaine;64;2;15;207;Escou;423;12;435
75;Nouvelle-Aquitaine;64;3;23;208;Escoubès;425;8;433
75;Nouvelle-Aquitaine;64;2;15;209;Escout;438;8;446
75;Nouvelle-Aquitaine;64;3;25;210;Escurès;145;1;146
75;Nouvelle-Aquitaine;64;3;23;211;Eslourenties-Daban;361;4;365
75;Nouvelle-Aquitaine;64;3;23;212;Espéchède;142;2;144
75;Nouvelle-Aquitaine;64;1;03;213;Espelette;1985;47;2032
75;Nouvelle-Aquitaine;64;2;12;214;Espès-Undurein;491;16;507
75;Nouvelle-Aquitaine;64;2;16;215;Espiute;105;3;108
75;Nouvelle-Aquitaine;64;3;27;216;Espoey;1190;46;1236
75;Nouvelle-Aquitaine;64;2;14;217;Esquiule;538;12;550
75;Nouvelle-Aquitaine;64;1;12;218;Estérençuby;328;1;329
75;Nouvelle-Aquitaine;64;2;15;219;Estialescq;260;6;266
75;Nouvelle-Aquitaine;64;2;15;220;Estos;505;12;517
75;Nouvelle-Aquitaine;64;1;22;221;Etcharry;154;29;183
75;Nouvelle-Aquitaine;64;2;12;222;Etchebar;75;0;75
75;Nouvelle-Aquitaine;64;2;14;223;Etsaut;59;2;61
75;Nouvelle-Aquitaine;64;2;14;224;Eysus;638;17;655
75;Nouvelle-Aquitaine;64;2;14;225;Ance Féas;615;16;631
75;Nouvelle-Aquitaine;64;3;02;226;Fichous-Riumayou;177;1;178
75;Nouvelle-Aquitaine;64;3;23;227;Gabaston;667;13;680
75;Nouvelle-Aquitaine;64;1;22;228;Gabat;270;2;272
75;Nouvelle-Aquitaine;64;1;12;229;Gamarthe;127;5;132
75;Nouvelle-Aquitaine;64;3;17;230;Gan;5585;107;5692
75;Nouvelle-Aquitaine;64;2;12;231;Garindein;498;8;506
75;Nouvelle-Aquitaine;64;3;25;232;Garlède-Mondebat;220;2;222
75;Nouvelle-Aquitaine;64;3;25;233;Garlin;1356;23;1379
75;Nouvelle-Aquitaine;64;3;02;234;Garos;261;9;270
75;Nouvelle-Aquitaine;64;1;22;235;Garris;281;8;289
75;Nouvelle-Aquitaine;64;3;25;236;Gayon;54;1;55
75;Nouvelle-Aquitaine;64;3;21;237;Gelos;3652;132;3784
75;Nouvelle-Aquitaine;64;3;27;238;Ger;1969;53;2022
75;Nouvelle-Aquitaine;64;3;25;239;Gerderest;139;1;140
75;Nouvelle-Aquitaine;64;2;15;240;Gère-Bélesten;183;7;190
75;Nouvelle-Aquitaine;64;2;14;241;Géronce;477;6;483
75;Nouvelle-Aquitaine;64;2;09;242;Gestas;75;0;75
75;Nouvelle-Aquitaine;64;3;02;243;Géus-d'Arzacq;201;2;203
75;Nouvelle-Aquitaine;64;2;14;244;Geüs-d'Oloron;255;10;265
75;Nouvelle-Aquitaine;64;2;15;245;Goès;576;14;590
75;Nouvelle-Aquitaine;64;3;27;246;Gomer;303;7;310
75;Nouvelle-Aquitaine;64;2;12;247;Gotein-Libarrenx;474;13;487
75;Nouvelle-Aquitaine;64;1;24;249;Guéthary;1326;36;1362
75;Nouvelle-Aquitaine;64;1;13;250;Guiche;1001;33;1034
75;Nouvelle-Aquitaine;64;2;16;251;Guinarthe-Parenties;221;8;229
75;Nouvelle-Aquitaine;64;2;14;252;Gurmençon;880;27;907
75;Nouvelle-Aquitaine;64;2;09;253;Gurs;419;10;429
75;Nouvelle-Aquitaine;64;3;02;254;Hagetaubin;576;18;594
75;Nouvelle-Aquitaine;64;1;03;255;Halsou;621;5;626
75;Nouvelle-Aquitaine;64;1;03;256;Hasparren;7498;281;7779
75;Nouvelle-Aquitaine;64;3;17;257;Haut-de-Bosdarros;350;1;351
75;Nouvelle-Aquitaine;64;2;12;258;Haux;86;1;87
75;Nouvelle-Aquitaine;64;1;22;259;Hélette;736;16;752
75;Nouvelle-Aquitaine;64;1;10;260;Hendaye;16967;437;17404
75;Nouvelle-Aquitaine;64;2;15;261;Herrère;389;2;391
75;Nouvelle-Aquitaine;64;3;23;262;Higuères-Souye;275;6;281
75;Nouvelle-Aquitaine;64;2;16;263;L'Hôpital-d'Orion;128;4;132
75;Nouvelle-Aquitaine;64;2;12;264;L'Hôpital-Saint-Blaise;61;2;63
75;Nouvelle-Aquitaine;64;1;22;265;Hosta;93;0;93
75;Nouvelle-Aquitaine;64;3;27;266;Hours;243;9;252
75;Nouvelle-Aquitaine;64;1;22;267;Ibarrolle;77;1;78
75;Nouvelle-Aquitaine;64;2;12;268;Idaux-Mendy;275;4;279
75;Nouvelle-Aquitaine;64;3;19;269;Idron;4903;161;5064
75;Nouvelle-Aquitaine;64;3;27;270;Igon;974;48;1022
75;Nouvelle-Aquitaine;64;1;22;271;Iholdy;537;8;545
75;Nouvelle-Aquitaine;64;1;22;272;Ilharre;145;1;146
75;Nouvelle-Aquitaine;64;1;22;273;Irissarry;912;13;925
75;Nouvelle-Aquitaine;64;1;12;274;Irouléguy;364;2;366
75;Nouvelle-Aquitaine;64;1;12;275;Ispoure;672;13;685
75;Nouvelle-Aquitaine;64;2;14;276;Issor;236;6;242
75;Nouvelle-Aquitaine;64;1;22;277;Isturits;517;13;530
75;Nouvelle-Aquitaine;64;1;03;279;Itxassou;2168;66;2234
75;Nouvelle-Aquitaine;64;2;15;280;Izeste;432;3;435
75;Nouvelle-Aquitaine;64;2;09;281;Jasses;145;3;148
75;Nouvelle-Aquitaine;64;1;03;282;Jatxou;1168;31;1199
75;Nouvelle-Aquitaine;64;1;12;283;Jaxu;195;1;196
75;Nouvelle-Aquitaine;64;3;08;284;Jurançon;7102;240;7342
75;Nouvelle-Aquitaine;64;1;22;285;Juxue;206;6;212
75;Nouvelle-Aquitaine;64;3;09;286;Laà-Mondrans;432;13;445
75;Nouvelle-Aquitaine;64;2;16;287;Laàs;139;3;142
75;Nouvelle-Aquitaine;64;3;02;288;Labastide-Cézéracq;556;13;569
75;Nouvelle-Aquitaine;64;1;22;289;La Bastide-Clairence;961;34;995
75;Nouvelle-Aquitaine;64;3;02;290;Labastide-Monréjeau;604;17;621
75;Nouvelle-Aquitaine;64;2;16;291;Labastide-Villefranche;318;6;324
75;Nouvelle-Aquitaine;64;3;27;292;Labatmale;255;2;257
75;Nouvelle-Aquitaine;64;3;23;293;Labatut;170;2;172
75;Nouvelle-Aquitaine;64;1;22;294;Labets-Biscay;159;3;162
75;Nouvelle-Aquitaine;64;3;02;295;Labeyrie;115;3;118
75;Nouvelle-Aquitaine;64;3;02;296;Lacadée;152;4;156
75;Nouvelle-Aquitaine;64;1;12;297;Lacarre;169;4;173
75;Nouvelle-Aquitaine;64;2;12;298;Lacarry-Arhan-Charritte-de-Haut;131;0;131
75;Nouvelle-Aquitaine;64;3;09;299;Lacommande;193;6;199
75;Nouvelle-Aquitaine;64;3;02;300;Lacq;725;12;737
75;Nouvelle-Aquitaine;64;3;09;301;Lagor;1158;30;1188
75;Nouvelle-Aquitaine;64;3;27;302;Lagos;468;12;480
75;Nouvelle-Aquitaine;64;2;12;303;Laguinge-Restoue;157;8;165
75;Nouvelle-Aquitaine;64;1;13;304;Lahonce;2506;55;2561
75;Nouvelle-Aquitaine;64;2;16;305;Lahontan;517;12;529
75;Nouvelle-Aquitaine;64;3;09;306;Lahourcade;699;21;720
75;Nouvelle-Aquitaine;64;3;25;307;Lalongue;209;3;212
75;Nouvelle-Aquitaine;64;3;25;308;Lalonquette;264;5;269
75;Nouvelle-Aquitaine;64;3;23;309;Lamayou;204;5;209
75;Nouvelle-Aquitaine;64;2;14;310;Lanne-en-Barétous;493;8;501
75;Nouvelle-Aquitaine;64;3;25;311;Lannecaube;156;2;158
75;Nouvelle-Aquitaine;64;3;16;312;Lanneplaà;305;9;314
75;Nouvelle-Aquitaine;64;1;22;313;Lantabat;275;5;280
75;Nouvelle-Aquitaine;64;1;22;314;Larceveau-Arros-Cibits;436;3;439
75;Nouvelle-Aquitaine;64;3;08;315;Laroin;1105;27;1132
75;Nouvelle-Aquitaine;64;2;12;316;Larrau;195;2;197
75;Nouvelle-Aquitaine;64;1;03;317;Larressore;2140;31;2171
75;Nouvelle-Aquitaine;64;3;02;318;Larreule;182;5;187
75;Nouvelle-Aquitaine;64;1;22;319;Larribar-Sorhapuru;183;0;183
75;Nouvelle-Aquitaine;64;2;15;320;Laruns;1185;23;1208
75;Nouvelle-Aquitaine;64;3;25;321;Lasclaveries;245;5;250
75;Nouvelle-Aquitaine;64;1;12;322;Lasse;337;6;343
75;Nouvelle-Aquitaine;64;3;25;323;Lasserre;102;3;105
75;Nouvelle-Aquitaine;64;2;15;324;Lasseube;1750;40;1790
75;Nouvelle-Aquitaine;64;2;15;325;Lasseubetat;208;4;212
75;Nouvelle-Aquitaine;64;2;09;326;Lay-Lamidou;118;4;122
75;Nouvelle-Aquitaine;64;1;12;327;Lecumberry;170;4;174
75;Nouvelle-Aquitaine;64;2;15;328;Ledeuix;1029;29;1058
75;Nouvelle-Aquitaine;64;3;23;329;Lée;1257;59;1316
75;Nouvelle-Aquitaine;64;2;14;330;Lées-Athas;250;9;259
75;Nouvelle-Aquitaine;64;3;25;331;Lembeye;768;16;784
75;Nouvelle-Aquitaine;64;3;25;332;Lème;166;4;170
75;Nouvelle-Aquitaine;64;2;16;334;Léren;218;3;221
75;Nouvelle-Aquitaine;64;3;11;335;Lescar;9665;419;10084
75;Nouvelle-Aquitaine;64;2;14;336;Lescun;168;1;169
75;Nouvelle-Aquitaine;64;3;25;337;Lespielle;150;3;153
75;Nouvelle-Aquitaine;64;3;23;338;Lespourcy;189;6;195
75;Nouvelle-Aquitaine;64;3;27;339;Lestelle-Bétharram;825;81;906
75;Nouvelle-Aquitaine;64;2;12;340;Lichans-Sunhar;84;1;85
75;Nouvelle-Aquitaine;64;2;12;341;Lichos;135;1;136
75;Nouvelle-Aquitaine;64;2;12;342;Licq-Athérey;201;7;208
75;Nouvelle-Aquitaine;64;3;27;343;Limendous;734;8;742
75;Nouvelle-Aquitaine;64;3;27;344;Livron;381;16;397
75;Nouvelle-Aquitaine;64;1;22;345;Lohitzun-Oyhercq;203;1;204
75;Nouvelle-Aquitaine;64;3;23;346;Lombia;206;1;207
75;Nouvelle-Aquitaine;64;3;02;347;Lonçon;209;3;212
75;Nouvelle-Aquitaine;64;3;11;348;Lons;13707;250;13957
75;Nouvelle-Aquitaine;64;3;09;349;Loubieng;503;18;521
75;Nouvelle-Aquitaine;64;1;03;350;Louhossoa;858;18;876
75;Nouvelle-Aquitaine;64;2;14;351;Lourdios-Ichère;136;9;145
75;Nouvelle-Aquitaine;64;3;27;352;Lourenties;391;10;401
75;Nouvelle-Aquitaine;64;2;15;353;Louvie-Juzon;1042;28;1070
75;Nouvelle-Aquitaine;64;2;15;354;Louvie-Soubiron;124;1;125
75;Nouvelle-Aquitaine;64;3;02;355;Louvigny;139;2;141
75;Nouvelle-Aquitaine;64;3;25;356;Luc-Armau;110;0;110
75;Nouvelle-Aquitaine;64;3;25;357;Lucarré;63;0;63
75;Nouvelle-Aquitaine;64;3;27;358;Lucgarier;251;1;252
75;Nouvelle-Aquitaine;64;3;09;359;Lucq-de-Béarn;919;20;939
75;Nouvelle-Aquitaine;64;2;14;360;Lurbe-Saint-Christau;190;6;196
75;Nouvelle-Aquitaine;64;3;25;361;Lussagnet-Lusson;179;8;187
75;Nouvelle-Aquitaine;64;1;22;362;Luxe-Sumberraute;410;22;432
75;Nouvelle-Aquitaine;64;2;15;363;Lys;327;4;331
75;Nouvelle-Aquitaine;64;1;03;364;Macaye;584;10;594
75;Nouvelle-Aquitaine;64;3;02;365;Malaussanne;408;7;415
75;Nouvelle-Aquitaine;64;3;25;366;Mascaraàs-Haron;123;0;123
75;Nouvelle-Aquitaine;64;3;09;367;Maslacq;882;25;907
75;Nouvelle-Aquitaine;64;1;22;368;Masparraute;250;7;257
75;Nouvelle-Aquitaine;64;3;25;369;Maspie-Lalonquère-Juillacq;250;11;261
75;Nouvelle-Aquitaine;64;3;23;370;Maucor;560;16;576
75;Nouvelle-Aquitaine;64;2;12;371;Mauléon-Licharre;2947;236;3183
75;Nouvelle-Aquitaine;64;3;23;372;Maure;94;1;95
75;Nouvelle-Aquitaine;64;3;20;373;Mazères-Lezons;1823;43;1866
75;Nouvelle-Aquitaine;64;3;02;374;Mazerolles;1139;19;1158
75;Nouvelle-Aquitaine;64;1;22;375;Méharin;279;4;283
75;Nouvelle-Aquitaine;64;3;17;376;Meillon;929;26;955
75;Nouvelle-Aquitaine;64;1;22;377;Mendionde;838;23;861
75;Nouvelle-Aquitaine;64;2;12;378;Menditte;204;128;332
75;Nouvelle-Aquitaine;64;1;12;379;Mendive;161;5;166
75;Nouvelle-Aquitaine;64;3;02;380;Méracq;231;5;236
75;Nouvelle-Aquitaine;64;2;09;381;Méritein;282;9;291
75;Nouvelle-Aquitaine;64;3;02;382;Mesplède;344;10;354
75;Nouvelle-Aquitaine;64;3;02;383;Mialos;133;1;134
75;Nouvelle-Aquitaine;64;3;25;385;Miossens-Lanusse;275;2;277
75;Nouvelle-Aquitaine;64;3;27;386;Mirepeix;1258;26;1284
75;Nouvelle-Aquitaine;64;3;02;387;Momas;606;12;618
75;Nouvelle-Aquitaine;64;3;23;388;Momy;116;1;117
75;Nouvelle-Aquitaine;64;3;25;389;Monassut-Audiracq;366;6;372
75;Nouvelle-Aquitaine;64;3;25;390;Moncaup;159;12;171
75;Nouvelle-Aquitaine;64;2;12;391;Moncayolle-Larrory-Mendibieu;306;7;313
75;Nouvelle-Aquitaine;64;3;25;392;Moncla;83;2;85
75;Nouvelle-Aquitaine;64;3;09;393;Monein;4435;105;4540
75;Nouvelle-Aquitaine;64;3;25;394;Monpezat;84;1;85
75;Nouvelle-Aquitaine;64;3;23;395;Monségur;124;0;124
75;Nouvelle-Aquitaine;64;3;02;396;Mont;1137;95;1232
75;Nouvelle-Aquitaine;64;3;02;397;Montagut;118;6;124
75;Nouvelle-Aquitaine;64;3;23;398;Montaner;430;8;438
75;Nouvelle-Aquitaine;64;3;25;399;Montardon;2323;306;2629
75;Nouvelle-Aquitaine;64;3;27;400;Montaut;1101;46;1147
75;Nouvelle-Aquitaine;64;3;25;401;Mont-Disse;78;1;79
75;Nouvelle-Aquitaine;64;2;16;403;Montfort;178;3;181
75;Nouvelle-Aquitaine;64;2;12;404;Montory;309;8;317
75;Nouvelle-Aquitaine;64;3;23;405;Morlaàs;4356;260;4616
75;Nouvelle-Aquitaine;64;3;02;406;Morlanne;613;16;629
75;Nouvelle-Aquitaine;64;1;13;407;Mouguerre;5294;148;5442
75;Nouvelle-Aquitaine;64;3;25;408;Mouhous;60;0;60
75;Nouvelle-Aquitaine;64;2;14;409;Moumour;831;22;853
75;Nouvelle-Aquitaine;64;3;09;410;Mourenx;6122;180;6302
75;Nouvelle-Aquitaine;64;2;12;411;Musculdy;236;3;239
75;Nouvelle-Aquitaine;64;2;09;412;Nabas;94;1;95
75;Nouvelle-Aquitaine;64;3;17;413;Narcastet;762;12;774
75;Nouvelle-Aquitaine;64;2;16;414;Narp;112;2;114
75;Nouvelle-Aquitaine;64;3;25;415;Navailles-Angos;1522;33;1555
75;Nouvelle-Aquitaine;64;2;09;416;Navarrenx;1052;23;1075
75;Nouvelle-Aquitaine;64;3;17;417;Nay;3265;236;3501
75;Nouvelle-Aquitaine;64;3;09;418;Noguères;138;3;141
75;Nouvelle-Aquitaine;64;3;27;419;Nousty;1597;30;1627
75;Nouvelle-Aquitaine;64;2;09;420;Ogenne-Camptort;245;5;250
75;Nouvelle-Aquitaine;64;2;15;421;Ogeu-les-Bains;1276;29;1305
75;Nouvelle-Aquitaine;64;2;98;422;Oloron-Sainte-Marie;10594;639;11233
75;Nouvelle-Aquitaine;64;2;16;423;Oraàs;182;3;185
75;Nouvelle-Aquitaine;64;2;12;424;Ordiarp;540;4;544
75;Nouvelle-Aquitaine;64;1;22;425;Orègue;487;9;496
75;Nouvelle-Aquitaine;64;2;14;426;Orin;249;10;259
75;Nouvelle-Aquitaine;64;2;16;427;Orion;148;2;150
75;Nouvelle-Aquitaine;64;2;16;428;Orriule;139;1;140
75;Nouvelle-Aquitaine;64;1;22;429;Orsanco;114;4;118
75;Nouvelle-Aquitaine;64;3;16;430;Orthez;10369;678;11047
75;Nouvelle-Aquitaine;64;3;09;431;Os-Marsillon;536;9;545
75;Nouvelle-Aquitaine;64;2;12;432;Ossas-Suhare;85;1;86
75;Nouvelle-Aquitaine;64;2;14;433;Osse-en-Aspe;330;19;349
75;Nouvelle-Aquitaine;64;2;16;434;Ossenx;50;1;51
75;Nouvelle-Aquitaine;64;1;22;435;Osserain-Rivareyte;214;9;223
75;Nouvelle-Aquitaine;64;1;12;436;Ossès;816;22;838
75;Nouvelle-Aquitaine;64;1;22;437;Ostabat-Asme;195;2;197
75;Nouvelle-Aquitaine;64;3;23;438;Ouillon;539;13;552
75;Nouvelle-Aquitaine;64;3;23;439;Ousse;1669;51;1720
75;Nouvelle-Aquitaine;64;3;09;440;Ozenx-Montestrucq;388;17;405
75;Nouvelle-Aquitaine;64;1;22;441;Pagolle;261;5;266
75;Nouvelle-Aquitaine;64;3;09;442;Parbayse;335;11;346
75;Nouvelle-Aquitaine;64;3;09;443;Pardies;860;23;883
75;Nouvelle-Aquitaine;64;3;17;444;Pardies-Piétat;462;11;473
75;Nouvelle-Aquitaine;64;3;99;445;Pau;75627;1443;77070
75;Nouvelle-Aquitaine;64;3;25;446;Peyrelongue-Abos;157;1;158
75;Nouvelle-Aquitaine;64;3;02;447;Piets-Plasence-Moustrou;140;1;141
75;Nouvelle-Aquitaine;64;3;11;448;Poey-de-Lescar;1772;50;1822
75;Nouvelle-Aquitaine;64;2;15;449;Poey-d'Oloron;164;3;167
75;Nouvelle-Aquitaine;64;3;02;450;Pomps;295;6;301
75;Nouvelle-Aquitaine;64;3;23;451;Ponson-Debat-Pouts;97;3;100
75;Nouvelle-Aquitaine;64;3;27;452;Ponson-Dessus;260;7;267
75;Nouvelle-Aquitaine;64;3;27;453;Pontacq;2925;57;2982
75;Nouvelle-Aquitaine;64;3;23;454;Pontiacq-Viellepinte;186;2;188
75;Nouvelle-Aquitaine;64;3;25;455;Portet;167;3;170
75;Nouvelle-Aquitaine;64;3;25;456;Pouliacq;51;3;54
75;Nouvelle-Aquitaine;64;3;02;457;Poursiugues-Boucoue;187;4;191
75;Nouvelle-Aquitaine;64;2;14;458;Préchacq-Josbaig;295;8;303
75;Nouvelle-Aquitaine;64;2;09;459;Préchacq-Navarrenx;173;2;175
75;Nouvelle-Aquitaine;64;2;15;460;Précilhon;405;7;412
75;Nouvelle-Aquitaine;64;3;16;461;Puyoô;1125;17;1142
75;Nouvelle-Aquitaine;64;3;16;462;Ramous;494;6;500
75;Nouvelle-Aquitaine;64;2;15;463;Rébénacq;663;6;669
75;Nouvelle-Aquitaine;64;3;25;464;Ribarrouy;83;1;84
75;Nouvelle-Aquitaine;64;3;23;465;Riupeyrous;224;3;227
75;Nouvelle-Aquitaine;64;2;09;466;Rivehaute;266;7;273
75;Nouvelle-Aquitaine;64;3;17;467;Rontignon;849;16;865
75;Nouvelle-Aquitaine;64;2;12;468;Roquiague;122;2;124
75;Nouvelle-Aquitaine;64;3;17;469;Saint-Abit;311;8;319
75;Nouvelle-Aquitaine;64;3;23;470;Saint-Armou;656;21;677
75;Nouvelle-Aquitaine;64;3;16;471;Saint-Boès;361;12;373
75;Nouvelle-Aquitaine;64;3;23;472;Saint-Castin;866;11;877
75;Nouvelle-Aquitaine;64;2;15;473;Sainte-Colome;358;4;362
75;Nouvelle-Aquitaine;64;2;16;474;Saint-Dos;158;2;160
75;Nouvelle-Aquitaine;64;2;12;475;Sainte-Engrâce;195;1;196
75;Nouvelle-Aquitaine;64;1;22;476;Saint-Esteben;411;6;417
75;Nouvelle-Aquitaine;64;1;12;477;Saint-Étienne-de-Baïgorry;1478;39;1517
75;Nouvelle-Aquitaine;64;3;08;478;Saint-Faust;746;26;772
75;Nouvelle-Aquitaine;64;3;16;479;Saint-Girons-en-Béarn;163;4;167
75;Nouvelle-Aquitaine;64;2;16;480;Saint-Gladie-Arrive-Munein;198;5;203
75;Nouvelle-Aquitaine;64;2;14;481;Saint-Goin;237;4;241
75;Nouvelle-Aquitaine;64;3;23;482;Saint-Jammes;620;8;628
75;Nouvelle-Aquitaine;64;1;24;483;Saint-Jean-de-Luz;14196;422;14618
75;Nouvelle-Aquitaine;64;1;12;484;Saint-Jean-le-Vieux;840;17;857
75;Nouvelle-Aquitaine;64;1;12;485;Saint-Jean-Pied-de-Port;1532;295;1827
75;Nouvelle-Aquitaine;64;3;25;486;Saint-Jean-Poudge;67;0;67
75;Nouvelle-Aquitaine;64;1;22;487;Saint-Just-Ibarre;206;5;211
75;Nouvelle-Aquitaine;64;3;23;488;Saint-Laurent-Bretagne;447;12;459
75;Nouvelle-Aquitaine;64;1;22;489;Saint-Martin-d'Arberoue;332;10;342
75;Nouvelle-Aquitaine;64;1;12;490;Saint-Martin-d'Arrossa;538;15;553
75;Nouvelle-Aquitaine;64;3;02;491;Saint-Médard;202;5;207
75;Nouvelle-Aquitaine;64;1;12;492;Saint-Michel;292;6;298
75;Nouvelle-Aquitaine;64;1;22;493;Saint-Palais;1841;67;1908
75;Nouvelle-Aquitaine;64;2;16;494;Saint-Pé-de-Léren;259;6;265
75;Nouvelle-Aquitaine;64;1;26;495;Saint-Pée-sur-Nivelle;7037;152;7189
75;Nouvelle-Aquitaine;64;1;13;496;Saint-Pierre-d'Irube;5491;97;5588
75;Nouvelle-Aquitaine;64;3;27;498;Saint-Vincent;395;10;405
75;Nouvelle-Aquitaine;64;2;16;499;Salies-de-Béarn;4568;129;4697
75;Nouvelle-Aquitaine;64;3;16;500;Salles-Mongiscard;297;6;303
75;Nouvelle-Aquitaine;64;3;02;501;Sallespisse;571;8;579
75;Nouvelle-Aquitaine;64;1;13;502;Sames;709;6;715
75;Nouvelle-Aquitaine;64;3;25;503;Samsons-Lion;90;1;91
75;Nouvelle-Aquitaine;64;1;26;504;Sare;2688;37;2725
75;Nouvelle-Aquitaine;64;3;09;505;Sarpourenx;310;14;324
75;Nouvelle-Aquitaine;64;2;14;506;Sarrance;161;3;164
75;Nouvelle-Aquitaine;64;3;23;507;Saubole;139;3;142
75;Nouvelle-Aquitaine;64;2;15;508;Saucède;132;2;134
75;Nouvelle-Aquitaine;64;2;12;509;Sauguis-Saint-Étienne;175;4;179
75;Nouvelle-Aquitaine;64;3;02;510;Sault-de-Navailles;941;19;960
75;Nouvelle-Aquitaine;64;3;25;511;Sauvagnon;3411;86;3497
75;Nouvelle-Aquitaine;64;3;09;512;Sauvelade;265;4;269
75;Nouvelle-Aquitaine;64;2;16;513;Sauveterre-de-Béarn;1370;96;1466
75;Nouvelle-Aquitaine;64;3;02;514;Séby;196;7;203
75;Nouvelle-Aquitaine;64;3;23;515;Sedze-Maubecq;252;4;256
75;Nouvelle-Aquitaine;64;3;23;516;Sedzère;384;3;387
75;Nouvelle-Aquitaine;64;3;25;517;Séméacq-Blachon;160;8;168
75;Nouvelle-Aquitaine;64;3;23;518;Sendets;1048;21;1069
75;Nouvelle-Aquitaine;64;3;25;519;Serres-Castet;4348;126;4474
75;Nouvelle-Aquitaine;64;3;23;520;Serres-Morlaàs;829;33;862
75;Nouvelle-Aquitaine;64;3;02;521;Serres-Sainte-Marie;571;17;588
75;Nouvelle-Aquitaine;64;2;15;522;Sévignacq-Meyracq;530;15;545
75;Nouvelle-Aquitaine;64;3;25;523;Sévignacq;764;14;778
75;Nouvelle-Aquitaine;64;3;25;524;Simacourbe;417;2;419
75;Nouvelle-Aquitaine;64;3;11;525;Siros;773;15;788
75;Nouvelle-Aquitaine;64;3;27;526;Soumoulou;1583;20;1603
75;Nouvelle-Aquitaine;64;1;03;527;Souraïde;1497;29;1526
75;Nouvelle-Aquitaine;64;1;22;528;Suhescun;168;8;176
75;Nouvelle-Aquitaine;64;2;09;529;Sus;377;11;388
75;Nouvelle-Aquitaine;64;2;09;530;Susmiou;352;7;359
75;Nouvelle-Aquitaine;64;2;16;531;Tabaille-Usquain;46;2;48
75;Nouvelle-Aquitaine;64;3;25;532;Tadousse-Ussau;70;1;71
75;Nouvelle-Aquitaine;64;2;12;533;Tardets-Sorholus;558;9;567
75;Nouvelle-Aquitaine;64;3;25;534;Taron-Sadirac-Viellenave;192;0;192
75;Nouvelle-Aquitaine;64;3;09;535;Tarsacq;530;6;536
75;Nouvelle-Aquitaine;64;3;25;536;Thèze;858;16;874
75;Nouvelle-Aquitaine;64;2;12;537;Trois-Villes;129;4;133
75;Nouvelle-Aquitaine;64;1;12;538;Uhart-Cize;803;16;819
75;Nouvelle-Aquitaine;64;1;22;539;Uhart-Mixe;210;5;215
75;Nouvelle-Aquitaine;64;1;13;540;Urcuit;2725;73;2798
75;Nouvelle-Aquitaine;64;3;02;541;Urdès;310;3;313
75;Nouvelle-Aquitaine;64;2;14;542;Urdos;66;1;67
75;Nouvelle-Aquitaine;64;1;12;543;Urepel;277;7;284
75;Nouvelle-Aquitaine;64;3;23;544;Urost;76;2;78
75;Nouvelle-Aquitaine;64;1;10;545;Urrugne;10418;193;10611
75;Nouvelle-Aquitaine;64;1;13;546;Urt;2323;34;2357
75;Nouvelle-Aquitaine;64;1;26;547;Ustaritz;6918;260;7178
75;Nouvelle-Aquitaine;64;3;02;548;Uzan;166;4;170
75;Nouvelle-Aquitaine;64;3;11;549;Uzein;1228;24;1252
75;Nouvelle-Aquitaine;64;3;17;550;Uzos;767;30;797
75;Nouvelle-Aquitaine;64;2;15;551;Verdets;287;4;291
75;Nouvelle-Aquitaine;64;3;25;552;Vialer;183;3;186
75;Nouvelle-Aquitaine;64;3;02;554;Viellenave-d'Arthez;210;3;213
75;Nouvelle-Aquitaine;64;2;09;555;Viellenave-de-Navarrenx;166;2;168
75;Nouvelle-Aquitaine;64;3;09;556;Vielleségure;385;8;393
75;Nouvelle-Aquitaine;64;3;02;557;Vignes;458;22;480
75;Nouvelle-Aquitaine;64;1;13;558;Villefranque;2822;78;2900
75;Nouvelle-Aquitaine;64;2;12;559;Viodos-Abense-de-Bas;728;16;744
75;Nouvelle-Aquitaine;64;3;25;560;Viven;178;0;178
76;Occitanie;65;1;16;001;Adast;297;7;304
76;Occitanie;65;1;06;002;Adé;826;10;836
76;Occitanie;65;2;08;003;Adervielle-Pouchergues;143;1;144
76;Occitanie;65;1;16;004;Agos-Vidalos;409;10;419
76;Occitanie;65;3;07;005;Allier;433;11;444
76;Occitanie;65;2;08;006;Ancizan;269;8;277
76;Occitanie;65;3;17;007;Andrest;1379;26;1405
76;Occitanie;65;2;15;009;Anères;171;4;175
76;Occitanie;65;3;07;010;Angos;223;4;227
76;Occitanie;65;1;06;011;Les Angles;130;3;133
76;Occitanie;65;2;15;012;Anla;81;2;83
76;Occitanie;65;3;13;013;Ansost;57;2;59
76;Occitanie;65;2;15;014;Antichan;40;0;40
76;Occitanie;65;3;03;015;Antin;105;7;112
76;Occitanie;65;2;04;016;Antist;183;3;186
76;Occitanie;65;2;08;017;Aragnouet;249;2;251
76;Occitanie;65;1;16;018;Arbéost;84;1;85
76;Occitanie;65;3;07;019;Arcizac-Adour;559;11;570
76;Occitanie;65;1;06;020;Arcizac-ez-Angles;263;5;268
76;Occitanie;65;1;16;021;Arcizans-Avant;390;15;405
76;Occitanie;65;1;16;022;Arcizans-Dessus;118;7;125
76;Occitanie;65;2;08;023;Ardengost;13;0;13
76;Occitanie;65;2;14;024;Argelès-Bagnères;105;3;108
76;Occitanie;65;1;16;025;Argelès-Gazost;2911;170;3081
76;Occitanie;65;3;03;026;Aries-Espénan;75;0;75
76;Occitanie;65;2;15;028;Arné;206;5;211
76;Occitanie;65;1;16;029;Arras-en-Lavedan;482;11;493
76;Occitanie;65;2;08;031;Arreau;792;27;819
76;Occitanie;65;1;16;032;Arrens-Marsous;700;20;720
76;Occitanie;65;1;06;033;Arrodets-ez-Angles;113;3;116
76;Occitanie;65;2;14;034;Arrodets;19;0;19
76;Occitanie;65;3;17;035;Artagnan;518;12;530
76;Occitanie;65;1;16;036;Artalens-Souin;132;3;135
76;Occitanie;65;2;14;037;Artiguemy;88;1;89
76;Occitanie;65;1;06;038;Artigues;14;1;15
76;Occitanie;65;2;08;039;Aspin-Aure;40;0;40
76;Occitanie;65;1;05;040;Aspin-en-Lavedan;321;3;324
76;Occitanie;65;2;14;041;Asque;119;7;126
76;Occitanie;65;2;04;042;Asté;575;12;587
76;Occitanie;65;2;04;043;Astugue;263;7;270
76;Occitanie;65;3;03;044;Aubarède;298;6;304
76;Occitanie;65;1;16;045;Aucun;230;9;239
76;Occitanie;65;2;08;046;Aulon;93;3;96
76;Occitanie;65;3;01;047;Aureilhan;7864;223;8087
76;Occitanie;65;3;17;048;Aurensan;789;10;799
76;Occitanie;65;3;13;049;Auriébat;241;3;244
76;Occitanie;65;2;08;050;Avajan;79;2;81
76;Occitanie;65;2;15;051;Aventignan;208;7;215
76;Occitanie;65;3;09;052;Averan;66;0;66
76;Occitanie;65;2;15;053;Aveux;42;1;43
76;Occitanie;65;2;08;054;Avezac-Prat-Lahitte;610;8;618
76;Occitanie;65;1;16;055;Ayros-Arbouix;334;12;346
76;Occitanie;65;1;16;056;Ayzac-Ost;453;13;466
76;Occitanie;65;3;09;057;Azereix;984;17;1001
76;Occitanie;65;2;08;058;Azet;143;2;145
76;Occitanie;65;2;04;059;Bagnères-de-Bigorre;7085;283;7368
76;Occitanie;65;2;14;060;Banios;60;3;63
76;Occitanie;65;3;13;061;Barbachen;51;0;51
76;Occitanie;65;3;07;062;Barbazan-Debat;3498;76;3574
76;Occitanie;65;3;14;063;Barbazan-Dessus;172;3;175
76;Occitanie;65;2;08;064;Bareilles;49;1;50
76;Occitanie;65;1;05;065;Barlest;293;8;301
76;Occitanie;65;2;08;066;Barrancoueu;32;0;32
76;Occitanie;65;3;09;067;Barry;128;7;135
76;Occitanie;65;3;03;068;Barthe;23;1;24
76;Occitanie;65;2;08;069;La Barthe-de-Neste;1224;30;1254
76;Occitanie;65;1;05;070;Bartrès;553;18;571
76;Occitanie;65;2;14;071;Batsère;33;0;33
76;Occitanie;65;3;02;072;Bazet;1824;15;1839
76;Occitanie;65;3;13;073;Bazillac;355;7;362
76;Occitanie;65;3;03;074;Bazordan;110;2;112
76;Occitanie;65;2;08;075;Bazus-Aure;133;7;140
76;Occitanie;65;2;08;076;Bazus-Neste;59;2;61
76;Occitanie;65;1;16;077;Beaucens;418;24;442
76;Occitanie;65;2;04;078;Beaudéan;399;10;409
76;Occitanie;65;3;14;079;Bégole;198;4;202
76;Occitanie;65;3;09;080;Bénac;557;9;566
76;Occitanie;65;2;14;081;Benqué-Molère;135;3;138
76;Occitanie;65;1;06;082;Berbérust-Lias;51;0;51
76;Occitanie;65;3;07;083;Bernac-Debat;706;17;723
76;Occitanie;65;3;07;084;Bernac-Dessus;290;3;293
76;Occitanie;65;3;03;085;Bernadets-Debat;111;2;113
76;Occitanie;65;3;14;086;Bernadets-Dessus;151;6;157
76;Occitanie;65;2;15;087;Bertren;177;5;182
76;Occitanie;65;3;03;088;Betbèze;47;1;48
76;Occitanie;65;1;16;089;Betpouey;85;3;88
76;Occitanie;65;3;03;090;Betpouy;79;3;82
76;Occitanie;65;2;14;091;Bettes;56;1;57
76;Occitanie;65;2;08;092;Beyrède-Jumet-Camous;226;2;228
76;Occitanie;65;2;15;093;Bize;209;8;217
76;Occitanie;65;2;15;094;Bizous;122;1;123
76;Occitanie;65;3;03;095;Bonnefont;331;11;342
76;Occitanie;65;2;14;096;Bonnemazon;64;3;67
76;Occitanie;65;2;14;097;Bonrepos;190;8;198
76;Occitanie;65;1;16;098;Boô-Silhen;325;7;332
76;Occitanie;65;2;08;099;Bordères-Louron;141;3;144
76;Occitanie;65;3;02;100;Bordères-sur-l'Échez;5357;114;5471
76;Occitanie;65;3;14;101;Bordes;762;12;774
76;Occitanie;65;3;13;102;Bouilh-Devant;20;2;22
76;Occitanie;65;3;03;103;Bouilh-Péreuilh;109;1;110
76;Occitanie;65;3;03;104;Boulin;295;9;304
76;Occitanie;65;2;14;105;Bourg-de-Bigorre;196;3;199
76;Occitanie;65;2;08;106;Bourisp;165;4;169
76;Occitanie;65;1;06;107;Bourréac;111;2;113
76;Occitanie;65;3;02;108;Bours;865;19;884
76;Occitanie;65;2;15;109;Bramevaque;31;1;32
76;Occitanie;65;3;03;110;Bugard;96;0;96
76;Occitanie;65;2;14;111;Bulan;64;0;64
76;Occitanie;65;1;16;112;Bun;156;5;161
76;Occitanie;65;3;14;113;Burg;282;11;293
76;Occitanie;65;3;13;114;Buzon;75;4;79
76;Occitanie;65;3;03;115;Cabanac;289;10;299
76;Occitanie;65;2;08;116;Cadéac;299;5;304
76;Occitanie;65;2;08;117;Cadeilhan-Trachère;42;1;43
76;Occitanie;65;3;14;118;Caharet;38;1;39
76;Occitanie;65;3;17;119;Caixon;368;11;379
76;Occitanie;65;3;14;120;Calavanté;337;14;351
76;Occitanie;65;3;17;121;Camalès;390;11;401
76;Occitanie;65;2;04;123;Campan;1313;54;1367
76;Occitanie;65;2;08;124;Camparan;57;2;59
76;Occitanie;65;2;15;125;Campistrous;313;7;320
76;Occitanie;65;3;03;126;Campuzan;147;5;152
76;Occitanie;65;2;08;127;Capvern;1264;26;1290
76;Occitanie;65;2;14;128;Castelbajac;138;3;141
76;Occitanie;65;3;03;129;Castelnau-Magnoac;799;22;821
76;Occitanie;65;3;13;130;Castelnau-Rivière-Basse;614;12;626
76;Occitanie;65;3;03;131;Castelvieilh;245;2;247
76;Occitanie;65;3;14;132;Castéra-Lanusse;44;0;44
76;Occitanie;65;3;03;133;Castéra-Lou;235;4;239
76;Occitanie;65;3;03;134;Casterets;13;0;13
76;Occitanie;65;2;14;135;Castillon;82;0;82
76;Occitanie;65;3;03;136;Caubous;34;0;34
76;Occitanie;65;3;13;137;Caussade-Rivière;96;3;99
76;Occitanie;65;1;16;138;Cauterets;878;19;897
76;Occitanie;65;2;15;139;Cazarilh;54;1;55
76;Occitanie;65;2;08;140;Cazaux-Debat;31;1;32
76;Occitanie;65;2;08;141;Cazaux-Fréchet-Anéran-Camors;56;3;59
76;Occitanie;65;3;03;142;Chelle-Debat;211;4;215
76;Occitanie;65;2;14;143;Chelle-Spou;113;2;115
76;Occitanie;65;1;06;144;Cheust;87;2;89
76;Occitanie;65;1;16;145;Chèze;49;0;49
76;Occitanie;65;3;02;146;Chis;312;1;313
76;Occitanie;65;2;14;147;Cieutat;608;12;620
76;Occitanie;65;3;03;148;Cizos;133;1;134
76;Occitanie;65;3;14;149;Clarac;169;4;173
76;Occitanie;65;2;15;150;Clarens;499;25;524
76;Occitanie;65;3;03;151;Collongues;146;4;150
76;Occitanie;65;3;03;153;Coussan;122;5;127
76;Occitanie;65;2;15;154;Créchets;59;0;59
76;Occitanie;65;3;03;155;Devèze;52;2;54
76;Occitanie;65;3;03;156;Dours;217;5;222
76;Occitanie;65;2;08;157;Ens;21;2;23
76;Occitanie;65;2;15;158;Esbareich;82;0;82
76;Occitanie;65;2;08;159;Escala;361;11;372
76;Occitanie;65;3;17;160;Escaunets;120;3;123
76;Occitanie;65;3;13;161;Escondeaux;282;4;286
76;Occitanie;65;2;14;162;Esconnets;33;1;34
76;Occitanie;65;2;14;163;Escots;39;1;40
76;Occitanie;65;1;06;164;Escoubès-Pouts;107;2;109
76;Occitanie;65;2;08;165;Esparros;188;1;189
76;Occitanie;65;2;14;166;Espèche;53;0;53
76;Occitanie;65;2;14;167;Espieilh;26;1;27
76;Occitanie;65;1;16;168;Esquièze-Sère;406;12;418
76;Occitanie;65;1;16;169;Estaing;90;2;92
76;Occitanie;65;3;03;170;Estampures;78;2;80
76;Occitanie;65;2;08;171;Estarvielle;39;0;39
76;Occitanie;65;2;08;172;Estensan;39;0;39
76;Occitanie;65;1;16;173;Esterre;193;7;200
76;Occitanie;65;3;13;174;Estirac;105;4;109
76;Occitanie;65;2;15;175;Ferrère;40;3;43
76;Occitanie;65;1;16;176;Ferrières;83;0;83
76;Occitanie;65;3;03;177;Fontrailles;161;3;164
76;Occitanie;65;3;03;178;Fréchède;53;0;53
76;Occitanie;65;2;14;179;Fréchendets;27;0;27
76;Occitanie;65;2;08;180;Fréchet-Aure;13;0;13
76;Occitanie;65;3;14;181;Fréchou-Fréchet;164;3;167
76;Occitanie;65;1;16;182;Gaillagos;124;1;125
76;Occitanie;65;2;14;183;Galan;702;13;715
76;Occitanie;65;2;14;184;Galez;173;2;175
76;Occitanie;65;3;09;185;Gardères;445;11;456
76;Occitanie;65;2;15;186;Gaudent;35;0;35
76;Occitanie;65;3;03;187;Gaussan;100;4;104
76;Occitanie;65;3;17;189;Gayan;281;2;283
76;Occitanie;65;2;08;190;Gazave;71;0;71
76;Occitanie;65;1;06;191;Gazost;123;2;125
76;Occitanie;65;1;16;192;Gavarnie-Gèdre;341;9;350
76;Occitanie;65;2;15;193;Gembrie;87;4;91
76;Occitanie;65;2;15;194;Générest;97;3;100
76;Occitanie;65;2;08;195;Génos;139;0;139
76;Occitanie;65;3;13;196;Gensac;90;2;92
76;Occitanie;65;1;06;197;Ger;155;9;164
76;Occitanie;65;2;04;198;Gerde;1117;34;1151
76;Occitanie;65;2;08;199;Germ;36;0;36
76;Occitanie;65;1;06;200;Germs-sur-l'Oussouet;107;1;108
76;Occitanie;65;1;06;201;Geu;183;4;187
76;Occitanie;65;1;16;202;Gez;331;13;344
76;Occitanie;65;1;06;203;Gez-ez-Angles;27;1;28
76;Occitanie;65;3;03;204;Gonez;27;0;27
76;Occitanie;65;2;08;205;Gouaux;54;1;55
76;Occitanie;65;3;14;206;Goudon;230;6;236
76;Occitanie;65;2;14;207;Gourgue;64;0;64
76;Occitanie;65;2;08;208;Grailhen;23;2;25
76;Occitanie;65;2;08;209;Grézian;78;0;78
76;Occitanie;65;1;16;210;Grust;35;1;36
76;Occitanie;65;2;08;211;Guchan;148;5;153
76;Occitanie;65;2;08;212;Guchen;330;11;341
76;Occitanie;65;3;03;213;Guizerix;121;3;124
76;Occitanie;65;3;03;214;Hachan;44;0;44
76;Occitanie;65;3;13;215;Hagedet;44;2;46
76;Occitanie;65;2;14;216;Hauban;104;0;104
76;Occitanie;65;2;15;217;Hautaget;55;2;57
76;Occitanie;65;2;08;218;Hèches;613;14;627
76;Occitanie;65;3;13;219;Hères;122;1;123
76;Occitanie;65;3;09;220;Hibarette;240;1;241
76;Occitanie;65;2;04;221;Hiis;255;5;260
76;Occitanie;65;3;14;222;Hitte;163;1;164
76;Occitanie;65;3;07;223;Horgues;1195;26;1221
76;Occitanie;65;2;14;224;Houeydets;281;6;287
76;Occitanie;65;3;03;225;Hourc;105;1;106
76;Occitanie;65;3;02;226;Ibos;2906;138;3044
76;Occitanie;65;2;08;228;Ilhet;121;0;121
76;Occitanie;65;2;15;229;Ilheu;45;0;45
76;Occitanie;65;2;15;230;Izaourt;255;6;261
76;Occitanie;65;2;08;231;Izaux;200;12;212
76;Occitanie;65;3;03;232;Jacque;68;2;70
76;Occitanie;65;1;06;233;Jarret;315;4;319
76;Occitanie;65;2;08;234;Jézeau;93;3;96
76;Occitanie;65;3;09;235;Juillan;4045;95;4140
76;Occitanie;65;1;06;236;Julos;441;12;453
76;Occitanie;65;1;06;237;Juncalas;160;5;165
76;Occitanie;65;2;04;238;Labassère;236;10;246
76;Occitanie;65;2;08;239;Labastide;154;5;159
76;Occitanie;65;3;13;240;Labatut-Rivière;385;6;391
76;Occitanie;65;2;08;241;Laborde;85;3;88
76;Occitanie;65;3;13;242;Lacassagne;238;3;241
76;Occitanie;65;3;13;243;Lafitole;458;18;476
76;Occitanie;65;3;17;244;Lagarde;529;7;536
76;Occitanie;65;2;15;245;Lagrange;234;7;241
76;Occitanie;65;1;06;247;Arrayou-Lahitte;104;1;105
76;Occitanie;65;3;13;248;Lahitte-Toupière;258;17;275
76;Occitanie;65;3;03;249;Lalanne;101;5;106
76;Occitanie;65;3;03;250;Lalanne-Trie;118;1;119
76;Occitanie;65;3;07;251;Laloubère;1877;65;1942
76;Occitanie;65;3;09;252;Lamarque-Pontacq;866;14;880
76;Occitanie;65;3;03;253;Lamarque-Rustaing;53;0;53
76;Occitanie;65;3;13;254;Laméac;143;4;147
76;Occitanie;65;2;08;255;Lançon;30;0;30
76;Occitanie;65;3;14;256;Lanespède;147;2;149
76;Occitanie;65;3;09;257;Lanne;601;9;610
76;Occitanie;65;2;15;258;Lannemezan;5816;159;5975
76;Occitanie;65;3;03;259;Lansac;180;5;185
76;Occitanie;65;3;03;260;Lapeyre;95;1;96
76;Occitanie;65;3;03;261;Laran;48;1;49
76;Occitanie;65;3;13;262;Larreule;400;10;410
76;Occitanie;65;3;03;263;Larroque;95;3;98
76;Occitanie;65;3;13;264;Lascazères;311;25;336
76;Occitanie;65;3;03;265;Laslades;329;10;339
76;Occitanie;65;3;03;266;Lassales;36;1;37
76;Occitanie;65;1;16;267;Lau-Balagnas;522;17;539
76;Occitanie;65;3;09;268;Layrisse;212;3;215
76;Occitanie;65;3;13;269;Lescurry;168;3;171
76;Occitanie;65;3;14;270;Lespouey;204;9;213
76;Occitanie;65;1;06;271;Lézignan;355;4;359
76;Occitanie;65;3;14;272;Lhez;78;0;78
76;Occitanie;65;3;13;273;Liac;198;0;198
76;Occitanie;65;2;14;274;Libaros;138;1;139
76;Occitanie;65;2;14;275;Lies;74;2;76
76;Occitanie;65;3;03;276;Lizos;117;1;118
76;Occitanie;65;2;15;277;Lombrès;92;3;95
76;Occitanie;65;2;14;278;Lomné;31;0;31
76;Occitanie;65;2;08;279;Lortet;218;8;226
76;Occitanie;65;1;05;280;Loubajac;424;2;426
76;Occitanie;65;3;09;281;Loucrup;242;4;246
76;Occitanie;65;2;08;282;Loudenvielle;297;6;303
76;Occitanie;65;2;08;283;Loudervielle;50;3;53
76;Occitanie;65;3;09;284;Louey;1040;28;1068
76;Occitanie;65;3;03;285;Louit;188;3;191
76;Occitanie;65;1;98;286;Lourdes;13132;317;13449
76;Occitanie;65;2;15;287;Loures-Barousse;630;13;643
76;Occitanie;65;3;03;288;Lubret-Saint-Luc;53;0;53
76;Occitanie;65;3;03;289;Luby-Betmont;111;1;112
76;Occitanie;65;3;14;290;Luc;193;1;194
76;Occitanie;65;1;06;291;Lugagnan;135;3;138
76;Occitanie;65;3;09;292;Luquet;401;3;404
76;Occitanie;65;3;03;293;Lustar;104;2;106
76;Occitanie;65;2;14;294;Lutilhous;219;3;222
76;Occitanie;65;1;16;295;Luz-Saint-Sauveur;939;15;954
76;Occitanie;65;3;13;296;Madiran;424;12;436
76;Occitanie;65;3;13;297;Mansan;41;5;46
76;Occitanie;65;3;03;298;Marquerie;85;0;85
76;Occitanie;65;3;17;299;Marsac;222;4;226
76;Occitanie;65;2;14;300;Marsas;67;5;72
76;Occitanie;65;3;03;301;Marseillan;260;4;264
76;Occitanie;65;3;14;303;Mascaras;362;4;366
76;Occitanie;65;3;13;304;Maubourguet;2266;28;2294
76;Occitanie;65;2;15;305;Mauléon-Barousse;92;0;92
76;Occitanie;65;2;14;306;Mauvezin;233;4;237
76;Occitanie;65;2;15;307;Mazères-de-Neste;337;6;343
76;Occitanie;65;3;03;308;Mazerolles;106;4;110
76;Occitanie;65;2;08;309;Mazouau;15;3;18
76;Occitanie;65;2;14;310;Mérilheu;243;5;248
76;Occitanie;65;3;13;311;Mingot;101;0;101
76;Occitanie;65;3;07;313;Momères;744;23;767
76;Occitanie;65;3;13;314;Monfaucon;209;6;215
76;Occitanie;65;3;03;315;Monléon-Magnoac;419;221;640
76;Occitanie;65;3;03;316;Monlong;103;4;107
76;Occitanie;65;2;08;317;Mont;36;2;38
76;Occitanie;65;2;14;318;Montastruc;227;6;233
76;Occitanie;65;2;15;319;Montégut;137;2;139
76;Occitanie;65;2;04;320;Montgaillard;850;18;868
76;Occitanie;65;3;07;321;Montignac;144;2;146
76;Occitanie;65;2;08;322;Montoussé;254;7;261
76;Occitanie;65;2;15;323;Montsérié;82;0;82
76;Occitanie;65;3;14;324;Moulédous;212;7;219
76;Occitanie;65;3;13;325;Moumoulous;44;0;44
76;Occitanie;65;3;03;326;Mun;89;3;92
76;Occitanie;65;2;15;327;Nestier;153;2;155
76;Occitanie;65;2;04;328;Neuilh;97;4;101
76;Occitanie;65;2;15;329;Nistos;210;8;218
76;Occitanie;65;3;17;330;Nouilhan;216;3;219
76;Occitanie;65;3;07;331;Odos;3290;99;3389
76;Occitanie;65;3;03;332;Oléac-Debat;170;1;171
76;Occitanie;65;3;14;333;Oléac-Dessus;114;1;115
76;Occitanie;65;1;05;334;Omex;224;3;227
76;Occitanie;65;2;04;335;Ordizan;523;16;539
76;Occitanie;65;3;03;336;Organ;36;0;36
76;Occitanie;65;3;14;337;Orieux;106;3;109
76;Occitanie;65;2;14;338;Orignac;245;3;248
76;Occitanie;65;3;09;339;Orincles;327;7;334
76;Occitanie;65;3;02;340;Orleix;2011;43;2054
76;Occitanie;65;3;17;341;Oroix;111;2;113
76;Occitanie;65;3;03;342;Osmets;95;2;97
76;Occitanie;65;1;05;343;Ossen;246;4;250
76;Occitanie;65;3;09;344;Ossun;2374;49;2423
76;Occitanie;65;1;06;345;Ossun-ez-Angles;55;0;55
76;Occitanie;65;3;14;346;Oueilloux;160;6;166
76;Occitanie;65;2;15;347;Ourde;44;0;44
76;Occitanie;65;1;06;348;Ourdis-Cotdoussan;46;2;48
76;Occitanie;65;1;06;349;Ourdon;11;0;11
76;Occitanie;65;3;02;350;Oursbelille;1197;41;1238
76;Occitanie;65;1;06;351;Ousté;32;0;32
76;Occitanie;65;1;16;352;Ouzous;219;8;227
76;Occitanie;65;3;14;353;Ozon;259;10;269
76;Occitanie;65;2;08;354;Pailhac;71;2;73
76;Occitanie;65;1;06;355;Paréac;71;0;71
76;Occitanie;65;2;14;356;Péré;59;2;61
76;Occitanie;65;3;14;357;Peyraube;168;3;171
76;Occitanie;65;3;03;358;Peyret-Saint-André;52;2;54
76;Occitanie;65;3;03;359;Peyriguère;30;0;30
76;Occitanie;65;1;05;360;Peyrouse;276;8;284
76;Occitanie;65;3;13;361;Peyrun;93;0;93
76;Occitanie;65;1;16;362;Pierrefitte-Nestalas;1126;25;1151
76;Occitanie;65;2;15;363;Pinas;450;9;459
76;Occitanie;65;3;17;364;Pintac;21;3;24
76;Occitanie;65;1;05;366;Poueyferré;843;17;860
76;Occitanie;65;3;14;367;Poumarous;164;3;167
76;Occitanie;65;3;03;368;Pouy;43;2;45
76;Occitanie;65;3;03;369;Pouyastruc;647;22;669
76;Occitanie;65;2;04;370;Pouzac;1115;38;1153
76;Occitanie;65;1;16;371;Préchac;234;10;244
76;Occitanie;65;3;17;372;Pujo;644;14;658
76;Occitanie;65;3;03;373;Puntous;165;4;169
76;Occitanie;65;3;03;374;Puydarrieux;232;1;233
76;Occitanie;65;3;13;375;Rabastens-de-Bigorre;1447;25;1472
76;Occitanie;65;2;14;376;Recurt;223;9;232
76;Occitanie;65;2;15;377;Réjaumont;158;8;166
76;Occitanie;65;3;14;378;Ricaud;67;2;69
76;Occitanie;65;2;08;379;Ris;15;0;15
76;Occitanie;65;3;03;380;Sabalos;149;1;150
76;Occitanie;65;2;14;381;Sabarros;34;0;34
76;Occitanie;65;2;15;382;Sacoué;74;3;77
76;Occitanie;65;3;03;383;Sadournin;193;2;195
76;Occitanie;65;2;08;384;Sailhan;173;1;174
76;Occitanie;65;2;08;385;Saint-Arroman;93;2;95
76;Occitanie;65;1;06;386;Saint-Créac;97;0;97
76;Occitanie;65;3;13;387;Saint-Lanne;128;2;130
76;Occitanie;65;2;08;388;Saint-Lary-Soulan;844;18;862
76;Occitanie;65;2;15;389;Saint-Laurent-de-Neste;943;38;981
76;Occitanie;65;3;17;390;Saint-Lézer;426;14;440
76;Occitanie;65;2;15;391;Sainte-Marie;59;0;59
76;Occitanie;65;3;07;392;Saint-Martin;445;8;453
76;Occitanie;65;1;16;393;Saint-Pastous;142;5;147
76;Occitanie;65;2;15;394;Saint-Paul;318;3;321
76;Occitanie;65;1;05;395;Saint-Pé-de-Bigorre;1159;19;1178
76;Occitanie;65;1;16;396;Saint-Savin;360;7;367
76;Occitanie;65;3;13;397;Saint-Sever-de-Rustan;165;3;168
76;Occitanie;65;2;15;398;Saléchan;254;2;256
76;Occitanie;65;1;16;399;Saligos;102;3;105
76;Occitanie;65;1;16;400;Salles;229;7;236
76;Occitanie;65;3;07;401;Salles-Adour;581;24;605
76;Occitanie;65;2;15;402;Samuran;25;0;25
76;Occitanie;65;3;17;403;Sanous;100;2;102
76;Occitanie;65;3;03;404;Sariac-Magnoac;154;3;157
76;Occitanie;65;2;14;405;Sarlabous;75;3;78
76;Occitanie;65;3;17;406;Sarniguet;257;5;262
76;Occitanie;65;2;15;407;Sarp;107;2;109
76;Occitanie;65;2;08;408;Sarrancolin;563;20;583
76;Occitanie;65;3;13;409;Sarriac-Bigorre;301;5;306
76;Occitanie;65;3;07;410;Sarrouilles;518;17;535
76;Occitanie;65;1;16;411;Sassis;77;6;83
76;Occitanie;65;3;13;412;Sauveterre;167;4;171
76;Occitanie;65;1;16;413;Sazos;139;4;143
76;Occitanie;65;3;13;414;Ségalas;79;4;83
76;Occitanie;65;1;05;415;Ségus;242;1;243
76;Occitanie;65;2;15;416;Seich;86;3;89
76;Occitanie;65;3;01;417;Séméac;5085;103;5188
76;Occitanie;65;3;13;418;Sénac;291;7;298
76;Occitanie;65;2;14;419;Sentous;68;0;68
76;Occitanie;65;1;16;420;Sère-en-Lavedan;77;2;79
76;Occitanie;65;1;06;421;Sère-Lanso;50;2;52
76;Occitanie;65;3;09;422;Séron;332;3;335
76;Occitanie;65;3;03;423;Sère-Rustaing;131;1;132
76;Occitanie;65;1;16;424;Sers;117;2;119
76;Occitanie;65;3;17;425;Siarrouy;447;7;454
76;Occitanie;65;3;14;426;Sinzos;132;6;138
76;Occitanie;65;2;15;427;Siradan;283;5;288
76;Occitanie;65;1;16;428;Sireix;63;1;64
76;Occitanie;65;3;13;429;Sombrun;206;8;214
76;Occitanie;65;3;03;430;Soréac;43;1;44
76;Occitanie;65;2;15;431;Sost;95;4;99
76;Occitanie;65;3;13;432;Soublecause;180;5;185
76;Occitanie;65;3;01;433;Soues;3066;58;3124
76;Occitanie;65;1;16;435;Soulom;274;4;278
76;Occitanie;65;3;03;436;Souyeaux;305;7;312
76;Occitanie;65;2;15;437;Tajan;129;3;132
76;Occitanie;65;3;17;438;Talazac;76;1;77
76;Occitanie;65;3;17;439;Tarasteix;271;3;274
76;Occitanie;65;3;99;440;Tarbes;42758;1063;43821
76;Occitanie;65;2;15;441;Thèbe;78;3;81
76;Occitanie;65;3;03;442;Thermes-Magnoac;211;1;212
76;Occitanie;65;3;03;443;Thuy;17;0;17
76;Occitanie;65;2;15;444;Tibiran-Jaunac;319;4;323
76;Occitanie;65;2;14;445;Tilhouse;227;6;233
76;Occitanie;65;3;13;446;Tostat;547;8;555
76;Occitanie;65;3;14;447;Tournay;1172;21;1193
76;Occitanie;65;3;03;448;Tournous-Darré;92;4;96
76;Occitanie;65;2;14;449;Tournous-Devant;90;5;95
76;Occitanie;65;2;08;450;Tramezaïgues;37;1;38
76;Occitanie;65;2;04;451;Trébons;753;14;767
76;Occitanie;65;3;03;452;Trie-sur-Baïse;1007;26;1033
76;Occitanie;65;2;15;453;Troubat;75;0;75
76;Occitanie;65;3;13;454;Trouley-Labarthe;104;1;105
76;Occitanie;65;2;15;455;Tuzaguet;438;9;447
76;Occitanie;65;2;15;456;Uglas;288;11;299
76;Occitanie;65;3;13;457;Ugnouas;83;1;84
76;Occitanie;65;1;16;458;Uz;31;1;32
76;Occitanie;65;2;14;459;Uzer;102;4;106
76;Occitanie;65;3;17;460;Vic-en-Bigorre;4843;268;5111
76;Occitanie;65;3;03;461;Vidou;112;1;113
76;Occitanie;65;3;13;462;Vidouze;243;9;252
76;Occitanie;65;1;16;463;Viella;85;1;86
76;Occitanie;65;3;07;464;Vielle-Adour;505;10;515
76;Occitanie;65;2;08;465;Vielle-Aure;325;10;335
76;Occitanie;65;2;08;466;Vielle-Louron;86;1;87
76;Occitanie;65;1;16;467;Vier-Bordes;98;6;104
76;Occitanie;65;3;03;468;Vieuzos;40;1;41
76;Occitanie;65;1;16;469;Viey;25;1;26
76;Occitanie;65;1;05;470;Viger;144;4;148
76;Occitanie;65;2;08;471;Vignec;215;8;223
76;Occitanie;65;3;13;472;Villefranque;76;5;81
76;Occitanie;65;1;16;473;Villelongue;397;15;412
76;Occitanie;65;3;03;474;Villembits;112;2;114
76;Occitanie;65;3;03;475;Villemur;60;1;61
76;Occitanie;65;3;17;476;Villenave-près-Béarn;64;4;68
76;Occitanie;65;3;17;477;Villenave-près-Marsac;101;2;103
76;Occitanie;65;1;16;478;Viscos;32;2;34
76;Occitanie;65;3;09;479;Visker;351;10;361
76;Occitanie;65;1;16;481;Barèges;159;5;164
76;Occitanie;65;2;15;482;Cantaous;442;11;453
76;Occitanie;66;1;17;001;L'Albère;73;1;74
76;Occitanie;66;1;12;002;Alénya;3645;61;3706
76;Occitanie;66;1;02;003;Amélie-les-Bains-Palalda;3542;47;3589
76;Occitanie;66;3;13;004;Les Angles;553;8;561
76;Occitanie;66;3;13;005;Angoustrine-Villeneuve-des-Escaldes;561;34;595
76;Occitanie;66;3;15;006;Ansignan;165;2;167
76;Occitanie;66;3;15;007;Arboussols;124;3;127
76;Occitanie;66;1;05;008;Argelès-sur-Mer;10260;248;10508
76;Occitanie;66;1;02;009;Arles-sur-Tech;2724;38;2762
76;Occitanie;66;3;13;010;Ayguatébia-Talau;36;0;36
76;Occitanie;66;1;12;011;Bages;4291;51;4342
76;Occitanie;66;2;14;012;Baho;3431;64;3495
76;Occitanie;66;3;02;013;Baillestavy;117;3;120
76;Occitanie;66;2;14;014;Baixas;2612;50;2662
76;Occitanie;66;1;01;015;Banyuls-dels-Aspres;1271;22;1293
76;Occitanie;66;1;05;016;Banyuls-sur-Mer;4738;77;4815
76;Occitanie;66;2;04;017;Le Barcarès;5771;40;5811
76;Occitanie;66;1;02;018;La Bastide;68;0;68
76;Occitanie;66;3;15;019;Bélesta;216;4;220
76;Occitanie;66;3;13;020;Bolquère;818;26;844
76;Occitanie;66;2;07;021;Bompas;7426;105;7531
76;Occitanie;66;3;02;022;Boule-d'Amont;55;0;55
76;Occitanie;66;3;02;023;Bouleternère;949;8;957
76;Occitanie;66;1;17;024;Le Boulou;5278;55;5333
76;Occitanie;66;3;13;025;Bourg-Madame;1207;75;1282
76;Occitanie;66;1;01;026;Brouilla;1532;32;1564
76;Occitanie;66;3;13;027;La Cabanasse;694;14;708
76;Occitanie;66;2;08;028;Cabestany;10301;206;10507
76;Occitanie;66;1;01;029;Caixas;134;1;135
76;Occitanie;66;2;14;030;Calce;213;2;215
76;Occitanie;66;1;01;032;Calmeilles;59;0;59
76;Occitanie;66;1;01;033;Camélas;460;13;473
76;Occitanie;66;3;13;034;Campôme;111;5;116
76;Occitanie;66;3;15;035;Campoussy;40;0;40
76;Occitanie;66;3;13;036;Canaveilles;24;0;24
76;Occitanie;66;2;03;037;Canet-en-Roussillon;12284;251;12535
76;Occitanie;66;2;10;038;Canohès;6344;115;6459
76;Occitanie;66;3;15;039;Caramany;137;1;138
76;Occitanie;66;3;02;040;Casefabre;41;1;42
76;Occitanie;66;2;15;041;Cases-de-Pène;940;20;960
76;Occitanie;66;2;15;042;Cassagnes;265;6;271
76;Occitanie;66;3;02;043;Casteil;136;2;138
76;Occitanie;66;1;01;044;Castelnou;293;6;299
76;Occitanie;66;3;13;045;Catllar;780;15;795
76;Occitanie;66;3;15;046;Caudiès-de-Fenouillèdes;603;11;614
76;Occitanie;66;3;13;047;Caudiès-de-Conflent;18;2;20
76;Occitanie;66;1;05;048;Cerbère;1345;16;1361
76;Occitanie;66;1;17;049;Céret;7857;233;8090
76;Occitanie;66;2;04;050;Claira;4470;54;4524
76;Occitanie;66;3;13;051;Clara-Villerach;265;8;273
76;Occitanie;66;3;13;052;Codalet;368;11;379
76;Occitanie;66;1;05;053;Collioure;2407;28;2435
76;Occitanie;66;3;13;054;Conat;60;3;63
76;Occitanie;66;3;16;055;Corbère;762;15;777
76;Occitanie;66;3;16;056;Corbère-les-Cabanes;1048;15;1063
76;Occitanie;66;3;02;057;Corneilla-de-Conflent;530;4;534
76;Occitanie;66;3;16;058;Corneilla-la-Rivière;1975;35;2010
76;Occitanie;66;1;12;059;Corneilla-del-Vercol;2327;28;2355
76;Occitanie;66;1;02;060;Corsavy;222;20;242
76;Occitanie;66;1;02;061;Coustouges;93;0;93
76;Occitanie;66;3;13;062;Dorres;169;7;176
76;Occitanie;66;1;17;063;Les Cluses;234;3;237
76;Occitanie;66;3;13;064;Égat;421;11;432
76;Occitanie;66;1;12;065;Elne;9248;116;9364
76;Occitanie;66;3;13;066;Enveitg;637;23;660
76;Occitanie;66;3;13;067;Err;668;22;690
76;Occitanie;66;3;13;068;Escaro;108;1;109
76;Occitanie;66;2;15;069;Espira-de-l'Agly;3475;135;3610
76;Occitanie;66;3;02;070;Espira-de-Conflent;165;4;169
76;Occitanie;66;2;15;071;Estagel;2049;18;2067
76;Occitanie;66;3;13;072;Estavar;477;9;486
76;Occitanie;66;3;02;073;Estoher;138;2;140
76;Occitanie;66;3;13;074;Eus;381;9;390
76;Occitanie;66;3;13;075;Eyne;141;9;150
76;Occitanie;66;3;15;076;Feilluns;65;0;65
76;Occitanie;66;3;15;077;Fenouillet;88;1;89
76;Occitanie;66;3;02;078;Fillols;189;7;196
76;Occitanie;66;3;02;079;Finestret;192;5;197
76;Occitanie;66;3;13;080;Fontpédrouse;117;2;119
76;Occitanie;66;3;13;081;Fontrabiouse;125;3;128
76;Occitanie;66;3;13;082;Formiguères;505;4;509
76;Occitanie;66;3;15;083;Fosse;41;0;41
76;Occitanie;66;1;01;084;Fourques;1311;19;1330
76;Occitanie;66;3;02;085;Fuilla;443;9;452
76;Occitanie;66;3;02;086;Glorianes;25;0;25
76;Occitanie;66;3;16;088;Ille-sur-Têt;5513;63;5576
76;Occitanie;66;3;02;089;Joch;321;6;327
76;Occitanie;66;3;13;090;Jujols;44;2;46
76;Occitanie;66;1;02;091;Lamanère;57;1;58
76;Occitanie;66;3;15;092;Lansac;90;0;90
76;Occitanie;66;1;17;093;Laroque-des-Albères;2140;41;2181
76;Occitanie;66;1;12;094;Latour-Bas-Elne;3158;46;3204
76;Occitanie;66;3;13;095;Latour-de-Carol;439;4;443
76;Occitanie;66;3;15;096;Latour-de-France;1038;12;1050
76;Occitanie;66;3;15;097;Lesquerde;139;4;143
76;Occitanie;66;3;13;098;La Llagonne;220;10;230
76;Occitanie;66;1;01;099;Llauro;317;2;319
76;Occitanie;66;3;13;100;Llo;171;3;174
76;Occitanie;66;2;01;101;Llupia;2074;42;2116
76;Occitanie;66;3;02;102;Mantet;29;1;30
76;Occitanie;66;3;02;103;Marquixanes;574;7;581
76;Occitanie;66;3;13;104;Los Masos;982;12;994
76;Occitanie;66;3;13;105;Matemale;277;5;282
76;Occitanie;66;1;17;106;Maureillas-las-Illas;2568;49;2617
76;Occitanie;66;3;15;107;Maury;794;6;800
76;Occitanie;66;3;16;108;Millas;4264;69;4333
76;Occitanie;66;3;13;109;Molitg-les-Bains;242;4;246
76;Occitanie;66;3;16;111;Montalba-le-Château;149;2;151
76;Occitanie;66;1;01;112;Montauriol;251;5;256
76;Occitanie;66;1;02;113;Montbolo;177;2;179
76;Occitanie;66;1;12;114;Montescot;1647;39;1686
76;Occitanie;66;1;17;115;Montesquieu-des-Albères;1235;23;1258
76;Occitanie;66;1;02;116;Montferrer;186;4;190
76;Occitanie;66;3;13;117;Mont-Louis;148;9;157
76;Occitanie;66;2;15;118;Montner;338;8;346
76;Occitanie;66;3;13;119;Mosset;318;7;325
76;Occitanie;66;3;13;120;Nahuja;76;1;77
76;Occitanie;66;3;16;121;Néfiach;1287;36;1323
76;Occitanie;66;3;13;122;Nohèdes;60;2;62
76;Occitanie;66;3;13;123;Nyer;151;0;151
76;Occitanie;66;3;13;124;Font-Romeu-Odeillo-Via;1840;183;2023
76;Occitanie;66;3;13;125;Olette;351;5;356
76;Occitanie;66;1;01;126;Oms;332;4;336
76;Occitanie;66;2;15;127;Opoul-Périllos;1192;15;1207
76;Occitanie;66;3;13;128;Oreilla;25;0;25
76;Occitanie;66;1;12;129;Ortaffa;1591;20;1611
76;Occitanie;66;3;13;130;Osséja;1350;75;1425
76;Occitanie;66;3;13;132;Palau-de-Cerdagne;417;10;427
76;Occitanie;66;1;05;133;Palau-del-Vidre;3094;45;3139
76;Occitanie;66;1;01;134;Passa;970;10;980
76;Occitanie;66;2;99;136;Perpignan;119344;1427;120771
76;Occitanie;66;1;17;137;Le Perthus;549;3;552
76;Occitanie;66;2;14;138;Peyrestortes;1527;25;1552
76;Occitanie;66;3;15;139;Pézilla-de-Conflent;40;0;40
76;Occitanie;66;2;14;140;Pézilla-la-Rivière;3812;55;3867
76;Occitanie;66;2;04;141;Pia;9849;96;9945
76;Occitanie;66;3;13;142;Planès;54;2;56
76;Occitanie;66;3;15;143;Planèzes;93;2;95
76;Occitanie;66;2;01;144;Pollestres;5229;85;5314
76;Occitanie;66;2;01;145;Ponteilla;2841;44;2885
76;Occitanie;66;3;13;146;Porta;115;7;122
76;Occitanie;66;3;13;147;Porté-Puymorens;105;1;106
76;Occitanie;66;1;05;148;Port-Vendres;4016;77;4093
76;Occitanie;66;3;13;149;Prades;6028;339;6367
76;Occitanie;66;1;02;150;Prats-de-Mollo-la-Preste;1175;19;1194
76;Occitanie;66;3;15;151;Prats-de-Sournia;78;3;81
76;Occitanie;66;3;15;152;Prugnanes;103;0;103
76;Occitanie;66;3;02;153;Prunet-et-Belpuig;48;0;48
76;Occitanie;66;3;13;154;Puyvalador;63;1;64
76;Occitanie;66;3;02;155;Py;80;0;80
76;Occitanie;66;3;15;156;Rabouillet;93;1;94
76;Occitanie;66;3;13;157;Railleu;26;1;27
76;Occitanie;66;3;15;158;Rasiguères;151;2;153
76;Occitanie;66;3;13;159;Réal;63;0;63
76;Occitanie;66;1;02;160;Reynès;1255;20;1275
76;Occitanie;66;3;13;161;Ria-Sirach;1348;30;1378
76;Occitanie;66;3;02;162;Rigarda;648;2;650
76;Occitanie;66;2;15;164;Rivesaltes;8888;142;9030
76;Occitanie;66;3;02;165;Rodès;628;6;634
76;Occitanie;66;3;02;166;Sahorre;391;7;398
76;Occitanie;66;3;13;167;Saillagouse;1146;27;1173
76;Occitanie;66;1;05;168;Saint-André;3422;52;3474
76;Occitanie;66;3;15;169;Saint-Arnac;111;1;112
76;Occitanie;66;1;01;170;Sainte-Colombe-de-la-Commanderie;161;2;163
76;Occitanie;66;1;03;171;Saint-Cyprien;11040;150;11190
76;Occitanie;66;2;14;172;Saint-Estève;11719;160;11879
76;Occitanie;66;3;16;173;Saint-Féliu-d'Amont;1194;20;1214
76;Occitanie;66;2;16;174;Saint-Féliu-d'Avall;2874;45;2919
76;Occitanie;66;1;17;175;Saint-Génis-des-Fontaines;2841;26;2867
76;Occitanie;66;2;04;176;Saint-Hippolyte;3198;31;3229
76;Occitanie;66;1;01;177;Saint-Jean-Lasseille;1541;17;1558
76;Occitanie;66;1;17;178;Saint-Jean-Pla-de-Corts;2273;45;2318
76;Occitanie;66;1;02;179;Saint-Laurent-de-Cerdans;1044;13;1057
76;Occitanie;66;2;04;180;Saint-Laurent-de-la-Salanque;10071;102;10173
76;Occitanie;66;3;13;181;Sainte-Léocadie;122;1;123
76;Occitanie;66;2;07;182;Sainte-Marie-la-Mer;4821;62;4883
76;Occitanie;66;1;02;183;Saint-Marsal;66;0;66
76;Occitanie;66;3;15;184;Saint-Martin-de-Fenouillet;52;3;55
76;Occitanie;66;3;02;185;Saint-Michel-de-Llotes;350;12;362
76;Occitanie;66;2;03;186;Saint-Nazaire;2784;43;2827
76;Occitanie;66;3;15;187;Saint-Paul-de-Fenouillet;1790;18;1808
76;Occitanie;66;3;13;188;Saint-Pierre-dels-Forcats;263;10;273
76;Occitanie;66;2;03;189;Saleilles;5564;105;5669
76;Occitanie;66;2;15;190;Salses-le-Château;3514;12;3526
76;Occitanie;66;3;13;191;Sansa;19;0;19
76;Occitanie;66;3;13;192;Sauto;90;1;91
76;Occitanie;66;3;13;193;Serdinya;232;5;237
76;Occitanie;66;1;02;194;Serralongue;219;2;221
76;Occitanie;66;2;16;195;Le Soler;7752;115;7867
76;Occitanie;66;1;17;196;Sorède;3343;50;3393
76;Occitanie;66;3;13;197;Souanyas;37;0;37
76;Occitanie;66;3;15;198;Sournia;498;5;503
76;Occitanie;66;1;02;199;Taillet;102;1;103
76;Occitanie;66;3;15;201;Tarerach;43;1;44
76;Occitanie;66;3;13;202;Targassonne;195;5;200
76;Occitanie;66;1;02;203;Taulis;56;0;56
76;Occitanie;66;3;02;204;Taurinya;332;11;343
76;Occitanie;66;2;15;205;Tautavel;859;21;880
76;Occitanie;66;1;02;206;Le Tech;93;0;93
76;Occitanie;66;1;01;207;Terrats;720;10;730
76;Occitanie;66;1;12;208;Théza;2127;99;2226
76;Occitanie;66;3;13;209;Thuès-Entre-Valls;40;2;42
76;Occitanie;66;1;01;210;Thuir;7924;135;8059
76;Occitanie;66;1;01;211;Tordères;172;7;179
76;Occitanie;66;2;04;212;Torreilles;3839;68;3907
76;Occitanie;66;2;11;213;Toulouges;7192;124;7316
76;Occitanie;66;1;01;214;Tresserre;1085;13;1098
76;Occitanie;66;3;15;215;Trévillach;160;0;160
76;Occitanie;66;3;15;216;Trilla;75;2;77
76;Occitanie;66;1;01;217;Trouillas;2174;24;2198
76;Occitanie;66;3;13;218;Ur;359;11;370
76;Occitanie;66;3;13;219;Urbanya;50;1;51
76;Occitanie;66;3;13;220;Valcebollère;38;1;39
76;Occitanie;66;3;02;221;Valmanya;34;0;34
76;Occitanie;66;3;02;222;Vernet-les-Bains;1450;46;1496
76;Occitanie;66;3;13;223;Villefranche-de-Conflent;210;5;215
76;Occitanie;66;2;07;224;Villelongue-de-la-Salanque;3248;36;3284
76;Occitanie;66;1;17;225;Villelongue-dels-Monts;1780;61;1841
76;Occitanie;66;1;01;226;Villemolaque;1390;24;1414
76;Occitanie;66;2;12;227;Villeneuve-de-la-Raho;3977;67;4044
76;Occitanie;66;2;14;228;Villeneuve-la-Rivière;1372;25;1397
76;Occitanie;66;3;02;230;Vinça;2131;26;2157
76;Occitanie;66;2;15;231;Vingrau;574;4;578
76;Occitanie;66;3;15;232;Vira;26;0;26
76;Occitanie;66;1;17;233;Vivès;175;4;179
76;Occitanie;66;3;15;234;Le Vivier;69;0;69
44;Grand Est;67;8;09;001;Achenheim;2338;32;2370
44;Grand Est;67;4;08;002;Adamswiller;390;3;393
44;Grand Est;67;5;11;003;Albé;441;16;457
44;Grand Est;67;4;14;004;Sommerau;1530;28;1558
44;Grand Est;67;4;02;005;Alteckendorf;850;18;868
44;Grand Est;67;4;14;006;Altenheim;213;1;214
44;Grand Est;67;3;10;008;Altorf;1363;22;1385
44;Grand Est;67;4;08;009;Altwiller;380;13;393
44;Grand Est;67;5;12;010;Andlau;1738;70;1808
44;Grand Est;67;5;16;011;Artolsheim;992;12;1004
44;Grand Est;67;2;23;012;Aschbach;647;18;665
44;Grand Est;67;4;08;013;Asswiller;274;3;277
44;Grand Est;67;3;10;016;Avolsheim;763;11;774
44;Grand Est;67;4;08;017;Baerendorf;298;5;303
44;Grand Est;67;3;14;018;Balbronn;670;9;679
44;Grand Est;67;5;16;019;Baldenheim;1182;18;1200
44;Grand Est;67;3;11;020;Barembach;838;7;845
44;Grand Est;67;5;12;021;Barr;7197;193;7390
44;Grand Est;67;5;11;022;Bassemberg;233;5;238
44;Grand Est;67;2;05;023;Batzendorf;978;21;999
44;Grand Est;67;2;23;025;Beinheim;1934;26;1960
44;Grand Est;67;3;11;026;Bellefosse;163;3;166
44;Grand Est;67;3;11;027;Belmont;177;0;177
44;Grand Est;67;5;04;028;Benfeld;5801;95;5896
44;Grand Est;67;4;08;029;Berg;360;4;364
44;Grand Est;67;3;10;030;Bergbieten;722;7;729
44;Grand Est;67;5;12;031;Bernardswiller;1437;44;1481
44;Grand Est;67;5;12;032;Bernardvillé;212;7;219
44;Grand Est;67;2;03;033;Bernolsheim;602;7;609
44;Grand Est;67;4;02;034;Berstett;2460;41;2501
44;Grand Est;67;2;05;035;Berstheim;444;15;459
44;Grand Est;67;4;08;036;Bettwiller;304;7;311
44;Grand Est;67;2;13;037;Biblisheim;365;5;370
44;Grand Est;67;2;03;038;Bietlenheim;298;2;300
44;Grand Est;67;2;03;039;Bilwisheim;515;11;526
44;Grand Est;67;5;16;040;Bindernheim;1040;10;1050
44;Grand Est;67;8;15;043;Bischheim;17353;209;17562
44;Grand Est;67;4;08;044;Bischholtz;259;0;259
44;Grand Est;67;3;10;045;Bischoffsheim;3329;58;3387
44;Grand Est;67;2;01;046;Bischwiller;12746;137;12883
44;Grand Est;67;4;08;047;Bissert;157;3;160
44;Grand Est;67;2;13;048;Bitschhoffen;460;15;475
44;Grand Est;67;8;09;049;Blaesheim;1301;20;1321
44;Grand Est;67;3;11;050;Blancherupt;34;0;34
44;Grand Est;67;5;12;051;Blienschwiller;313;11;324
44;Grand Est;67;3;10;052;Bœrsch;2442;64;2506
44;Grand Est;67;5;16;053;Bœsenbiesen;321;10;331
44;Grand Est;67;5;04;054;Bolsenheim;545;6;551
44;Grand Est;67;5;04;055;Boofzheim;1381;19;1400
44;Grand Est;67;5;16;056;Bootzheim;763;12;775
44;Grand Est;67;4;02;057;Bosselshausen;171;6;177
44;Grand Est;67;4;02;058;Bossendorf;391;4;395
44;Grand Est;67;3;11;059;Bourg-Bruche;411;6;417
44;Grand Est;67;5;12;060;Bourgheim;631;10;641
44;Grand Est;67;4;02;061;Bouxwiller;3757;77;3834
44;Grand Est;67;5;11;062;Breitenau;328;6;334
44;Grand Est;67;5;11;063;Breitenbach;651;16;667
44;Grand Est;67;8;09;065;Breuschwickersheim;1313;15;1328
44;Grand Est;67;3;11;066;La Broque;2629;89;2718
44;Grand Est;67;2;03;067;Brumath;10081;104;10185
44;Grand Est;67;4;02;068;Buswiller;280;2;282
44;Grand Est;67;2;23;069;Buhl;511;7;518
44;Grand Est;67;4;08;070;Burbach;278;3;281
44;Grand Est;67;4;08;071;Bust;464;11;475
44;Grand Est;67;4;08;072;Butten;663;22;685
44;Grand Est;67;5;16;073;Châtenois;4199;88;4287
44;Grand Est;67;2;23;074;Cleebourg;667;19;686
44;Grand Est;67;2;23;075;Climbach;429;7;436
44;Grand Est;67;3;11;076;Colroy-la-Roche;476;9;485
44;Grand Est;67;3;14;077;Cosswiller;583;14;597
44;Grand Est;67;3;14;078;Crastatt;270;3;273
44;Grand Est;67;2;23;079;Crœttwiller;181;3;184
44;Grand Est;67;3;10;080;Dachstein;1840;20;1860
44;Grand Est;67;3;10;081;Dahlenheim;785;12;797
44;Grand Est;67;2;01;082;Dalhunden;1204;11;1215
44;Grand Est;67;2;13;083;Dambach;754;12;766
44;Grand Est;67;5;12;084;Dambach-la-Ville;2215;41;2256
44;Grand Est;67;3;10;085;Dangolsheim;713;11;724
44;Grand Est;67;5;04;086;Daubensand;447;10;457
44;Grand Est;67;2;05;087;Dauendorf;1439;15;1454
44;Grand Est;67;4;08;088;Dehlingen;351;7;358
44;Grand Est;67;4;14;089;Dettwiller;2610;26;2636
44;Grand Est;67;5;04;090;Diebolsheim;675;43;718
44;Grand Est;67;4;08;091;Diedendorf;337;13;350
44;Grand Est;67;5;11;092;Dieffenbach-au-Val;631;27;658
44;Grand Est;67;2;13;093;Dieffenbach-lès-Wœrth;348;6;354
44;Grand Est;67;5;16;094;Dieffenthal;253;2;255
44;Grand Est;67;4;08;095;Diemeringen;1595;36;1631
44;Grand Est;67;4;14;096;Dimbsthal;318;11;329
44;Grand Est;67;4;02;097;Dingsheim;1233;17;1250
44;Grand Est;67;3;11;098;Dinsheim-sur-Bruche;1492;19;1511
44;Grand Est;67;4;08;099;Domfessel;281;4;285
44;Grand Est;67;2;03;100;Donnenheim;352;1;353
44;Grand Est;67;3;10;101;Dorlisheim;2613;32;2645
44;Grand Est;67;4;02;102;Dossenheim-Kochersberg;300;5;305
44;Grand Est;67;4;08;103;Dossenheim-sur-Zinsel;1038;25;1063
44;Grand Est;67;2;23;104;Drachenbronn-Birlenbach;608;15;623
44;Grand Est;67;4;08;105;Drulingen;1438;27;1465
44;Grand Est;67;2;01;106;Drusenheim;5268;47;5315
44;Grand Est;67;4;02;107;Duntzenheim;656;5;661
44;Grand Est;67;3;10;108;Duppigheim;1638;18;1656
44;Grand Est;67;4;02;109;Durningen;656;17;673
44;Grand Est;67;2;13;110;Durrenbach;1081;17;1098
44;Grand Est;67;4;08;111;Durstel;424;11;435
44;Grand Est;67;3;10;112;Duttlenheim;2865;30;2895
44;Grand Est;67;2;23;113;Eberbach-Seltz;422;7;429
44;Grand Est;67;5;16;115;Ebersheim;2287;23;2310
44;Grand Est;67;5;16;116;Ebersmunster;528;25;553
44;Grand Est;67;4;14;117;Eckartswiller;434;11;445
44;Grand Est;67;8;06;118;Eckbolsheim;7049;64;7113
44;Grand Est;67;8;03;119;Eckwersheim;1344;20;1364
44;Grand Est;67;5;12;120;Eichhoffen;527;11;538
44;Grand Est;67;5;16;121;Elsenheim;810;10;820
44;Grand Est;67;3;14;122;Wangenbourg-Engenthal;1332;15;1347
44;Grand Est;67;2;13;123;Engwiller;494;1;495
44;Grand Est;67;8;09;124;Entzheim;2453;25;2478
44;Grand Est;67;5;12;125;Epfig;2247;76;2323
44;Grand Est;67;4;08;126;Erckartswiller;299;6;305
44;Grand Est;67;3;10;127;Ergersheim;1410;14;1424
44;Grand Est;67;3;10;128;Ernolsheim-Bruche;1887;18;1905
44;Grand Est;67;4;14;129;Ernolsheim-lès-Saverne;595;6;601
44;Grand Est;67;5;04;130;Erstein;10661;123;10784
44;Grand Est;67;8;07;131;Eschau;5424;53;5477
44;Grand Est;67;2;13;132;Eschbach;944;11;955
44;Grand Est;67;4;08;133;Eschbourg;471;6;477
44;Grand Est;67;4;08;134;Eschwiller;191;0;191
44;Grand Est;67;4;02;135;Ettendorf;762;5;767
44;Grand Est;67;4;08;136;Eywiller;275;5;280
44;Grand Est;67;8;09;137;Fegersheim;5734;66;5800
44;Grand Est;67;4;02;138;Fessenheim-le-Bas;574;9;583
44;Grand Est;67;3;10;139;Flexbourg;474;9;483
44;Grand Est;67;2;01;140;Forstfeld;754;4;758
44;Grand Est;67;2;13;141;Forstheim;598;4;602
44;Grand Est;67;2;01;142;Fort-Louis;290;2;292
44;Grand Est;67;5;11;143;Fouchy;643;19;662
44;Grand Est;67;3;11;144;Fouday;337;3;340
44;Grand Est;67;4;14;145;Friedolsheim;258;6;264
44;Grand Est;67;5;04;146;Friesenheim;618;8;626
44;Grand Est;67;2;13;147;Frœschwiller;498;4;502
44;Grand Est;67;4;08;148;Frohmuhl;168;4;172
44;Grand Est;67;4;14;149;Furchhausen;421;7;428
44;Grand Est;67;4;02;150;Furdenheim;1366;23;1389
44;Grand Est;67;2;03;151;Gambsheim;5041;49;5090
44;Grand Est;67;8;09;152;Geispolsheim;7561;79;7640
44;Grand Est;67;4;02;153;Geiswiller-Zœbersdorf;397;3;400
44;Grand Est;67;5;04;154;Gerstheim;3449;55;3504
44;Grand Est;67;5;12;155;Gertwiller;1258;17;1275
44;Grand Est;67;2;03;156;Geudertheim;2586;31;2617
44;Grand Est;67;4;08;159;Gœrlingen;209;6;215
44;Grand Est;67;2;13;160;Gœrsdorf;1057;26;1083
44;Grand Est;67;4;14;161;Gottenhouse;380;11;391
44;Grand Est;67;4;14;162;Gottesheim;355;8;363
44;Grand Est;67;4;02;163;Gougenheim;544;13;557
44;Grand Est;67;5;12;164;Goxwiller;838;20;858
44;Grand Est;67;3;11;165;Grandfontaine;385;7;392
44;Grand Est;67;4;02;166;Grassendorf;250;4;254
44;Grand Est;67;3;10;167;Grendelbruch;1218;16;1234
44;Grand Est;67;3;11;168;Gresswiller;1666;24;1690
44;Grand Est;67;2;03;169;Gries;2874;34;2908
44;Grand Est;67;3;10;172;Griesheim-près-Molsheim;2228;40;2268
44;Grand Est;67;4;02;173;Griesheim-sur-Souffel;1201;16;1217
44;Grand Est;67;2;13;174;Gumbrechtshoffen;1167;8;1175
44;Grand Est;67;2;13;176;Gundershoffen;3712;62;3774
44;Grand Est;67;2;13;177;Gunstett;641;10;651
44;Grand Est;67;4;08;178;Gungwiller;277;5;282
44;Grand Est;67;4;14;179;Haegen;650;8;658
44;Grand Est;67;2;05;180;Haguenau;35196;561;35757
44;Grand Est;67;4;02;181;Handschuheim;272;6;278
44;Grand Est;67;8;09;182;Hangenbieten;1647;24;1671
44;Grand Est;67;4;08;183;Harskirchen;877;20;897
44;Grand Est;67;2;23;184;Hatten;1910;25;1935
44;Grand Est;67;4;14;185;Hattmatt;703;4;707
44;Grand Est;67;2;13;186;Hegeney;433;7;440
44;Grand Est;67;5;16;187;Heidolsheim;540;8;548
44;Grand Est;67;3;11;188;Heiligenberg;697;11;708
44;Grand Est;67;5;12;189;Heiligenstein;961;22;983
44;Grand Est;67;4;14;190;Hengwiller;195;2;197
44;Grand Est;67;4;08;191;Herbitzheim;1840;26;1866
44;Grand Est;67;5;04;192;Herbsheim;937;10;947
44;Grand Est;67;2;01;194;Herrlisheim;4731;73;4804
44;Grand Est;67;5;16;195;Hessenheim;619;10;629
44;Grand Est;67;5;16;196;Hilsenheim;2649;31;2680
44;Grand Est;67;5;04;197;Hindisheim;1510;21;1531
44;Grand Est;67;4;08;198;Hinsbourg;111;3;114
44;Grand Est;67;4;08;199;Hinsingen;82;1;83
44;Grand Est;67;5;04;200;Hipsheim;1001;8;1009
44;Grand Est;67;4;08;201;Hirschland;307;7;314
44;Grand Est;67;4;02;202;Hochfelden;4048;38;4086
44;Grand Est;67;2;05;203;Hochstett;384;5;389
44;Grand Est;67;8;06;204;Hœnheim;11304;81;11385
44;Grand Est;67;2;03;205;Hœrdt;4514;51;4565
44;Grand Est;67;2;23;206;Hoffen;1118;18;1136
44;Grand Est;67;3;14;208;Hohengœft;547;7;554
44;Grand Est;67;4;02;209;Hohfrankenheim;273;2;275
44;Grand Est;67;5;12;210;Le Hohwald;505;13;518
44;Grand Est;67;8;09;212;Holtzheim;3703;30;3733
44;Grand Est;67;2;23;213;Hunspach;632;16;648
44;Grand Est;67;4;02;214;Hurtigheim;978;7;985
44;Grand Est;67;2;05;215;Huttendorf;497;3;500
44;Grand Est;67;5;04;216;Huttenheim;2672;38;2710
44;Grand Est;67;5;04;217;Ichtratzheim;351;4;355
44;Grand Est;67;8;07;218;Illkirch-Graffenstaden;26698;691;27389
44;Grand Est;67;4;02;220;Ingenheim;327;2;329
44;Grand Est;67;2;23;221;Ingolsheim;347;5;352
44;Grand Est;67;4;08;222;Ingwiller;4048;37;4085
44;Grand Est;67;5;10;223;Innenheim;1183;7;1190
44;Grand Est;67;4;02;225;Issenhausen;113;2;115
44;Grand Est;67;4;02;226;Ittenheim;2112;24;2136
44;Grand Est;67;5;12;227;Itterswiller;237;4;241
44;Grand Est;67;4;02;228;Neugartheim-Ittlenheim;795;17;812
44;Grand Est;67;3;14;229;Jetterswiller;199;2;201
44;Grand Est;67;2;01;230;Kaltenhouse;2450;19;2469
44;Grand Est;67;2;01;231;Kauffenheim;212;2;214
44;Grand Est;67;2;23;232;Keffenach;204;6;210
44;Grand Est;67;5;04;233;Kertzfeld;1203;20;1223
44;Grand Est;67;4;08;234;Keskastel;1510;30;1540
44;Grand Est;67;2;23;235;Kesseldorf;427;2;429
44;Grand Est;67;4;02;236;Kienheim;549;10;559
44;Grand Est;67;2;03;237;Kilstett;2515;35;2550
44;Grand Est;67;2;13;238;Kindwiller;638;7;645
44;Grand Est;67;5;16;239;Kintzheim;1660;32;1692
44;Grand Est;67;3;10;240;Kirchheim;719;3;722
44;Grand Est;67;4;08;241;Kirrberg;147;4;151
44;Grand Est;67;4;02;242;Kirrwiller;526;5;531
44;Grand Est;67;4;14;244;Kleingœft;154;3;157
44;Grand Est;67;3;14;245;Knœrsheim;207;3;210
44;Grand Est;67;5;04;246;Kogenheim;1267;18;1285
44;Grand Est;67;8;09;247;Kolbsheim;973;21;994
44;Grand Est;67;5;12;248;Krautergersheim;1715;26;1741
44;Grand Est;67;2;03;249;Krautwiller;239;7;246
44;Grand Est;67;2;03;250;Kriegsheim;793;18;811
44;Grand Est;67;2;03;252;Kurtzenhouse;1079;12;1091
44;Grand Est;67;4;02;253;Kuttolsheim;637;10;647
44;Grand Est;67;2;13;254;Kutzenhausen;913;16;929
44;Grand Est;67;5;11;255;Lalaye;478;8;486
44;Grand Est;67;8;06;256;Lampertheim;3405;53;3458
44;Grand Est;67;2;13;257;Lampertsloch;706;15;721
44;Grand Est;67;4;14;258;Landersheim;193;3;196
44;Grand Est;67;2;13;259;Langensoultzbach;920;11;931
44;Grand Est;67;2;13;260;Laubach;321;5;326
44;Grand Est;67;2;23;261;Lauterbourg;2331;27;2358
44;Grand Est;67;2;13;263;Lembach;1548;42;1590
44;Grand Est;67;2;01;264;Leutenheim;829;12;841
44;Grand Est;67;4;08;265;Lichtenberg;550;7;557
44;Grand Est;67;5;04;266;Limersheim;664;8;672
44;Grand Est;67;8;09;267;Lingolsheim;19439;150;19589
44;Grand Est;67;8;09;268;Lipsheim;2664;30;2694
44;Grand Est;67;4;14;269;Littenheim;297;3;300
44;Grand Est;67;4;02;270;Lixhausen;390;1;391
44;Grand Est;67;2;13;271;Lobsann;648;7;655
44;Grand Est;67;4;14;272;Lochwiller;395;6;401
44;Grand Est;67;4;08;273;Lohr;515;6;521
44;Grand Est;67;4;08;274;Lorentzen;246;2;248
44;Grand Est;67;4;14;275;Lupstein;806;13;819
44;Grand Est;67;3;11;276;Lutzelhouse;1879;28;1907
44;Grand Est;67;5;16;277;Mackenheim;760;11;771
44;Grand Est;67;4;08;278;Mackwiller;547;13;560
44;Grand Est;67;4;14;279;Maennolsheim;233;5;238
44;Grand Est;67;5;11;280;Maisonsgoutte;798;18;816
44;Grand Est;67;5;16;281;Marckolsheim;4159;65;4224
44;Grand Est;67;3;10;282;Marlenheim;4250;65;4315
44;Grand Est;67;4;14;283;Marmoutier;2712;43;2755
44;Grand Est;67;5;04;285;Matzenheim;1461;108;1569
44;Grand Est;67;5;12;286;Meistratzheim;1500;19;1519
44;Grand Est;67;4;02;287;Melsheim;584;6;590
44;Grand Est;67;2;23;288;Memmelshoffen;324;4;328
44;Grand Est;67;4;08;289;Menchhoffen;635;10;645
44;Grand Est;67;2;13;290;Merkwiller-Pechelbronn;922;17;939
44;Grand Est;67;2;13;291;Mertzwiller;3363;40;3403
44;Grand Est;67;2;13;292;Mietesheim;669;12;681
44;Grand Est;67;4;02;293;Minversheim;652;11;663
44;Grand Est;67;5;12;295;Mittelbergheim;620;24;644
44;Grand Est;67;8;06;296;Mittelhausbergen;2086;24;2110
44;Grand Est;67;2;03;298;Mittelschaeffolsheim;569;8;577
44;Grand Est;67;3;10;299;Mollkirch;905;25;930
44;Grand Est;67;3;10;300;Molsheim;9343;132;9475
44;Grand Est;67;2;03;301;Mommenheim;2126;20;2146
44;Grand Est;67;4;14;302;Monswiller;2032;37;2069
44;Grand Est;67;2;13;303;Morsbronn-les-Bains;684;12;696
44;Grand Est;67;2;05;304;Morschwiller;576;13;589
44;Grand Est;67;2;23;305;Mothern;1955;21;1976
44;Grand Est;67;3;11;306;Muhlbach-sur-Bruche;643;54;697
44;Grand Est;67;4;08;307;Mulhausen;463;5;468
44;Grand Est;67;2;23;308;Munchhausen;802;9;811
44;Grand Est;67;8;06;309;Mundolsheim;4749;62;4811
44;Grand Est;67;5;16;310;Mussig;1169;34;1203
44;Grand Est;67;5;16;311;Muttersholtz;2136;28;2164
44;Grand Est;67;4;02;312;Mutzenhouse;477;9;486
44;Grand Est;67;3;11;313;Mutzig;6063;53;6116
44;Grand Est;67;3;11;314;Natzwiller;531;8;539
44;Grand Est;67;2;23;315;Neewiller-près-Lauterbourg;668;14;682
44;Grand Est;67;5;11;317;Neubois;671;17;688
44;Grand Est;67;2;01;319;Neuhaeusel;365;3;368
44;Grand Est;67;5;11;320;Neuve-Église;623;10;633
44;Grand Est;67;3;11;321;Neuviller-la-Roche;331;8;339
44;Grand Est;67;4;08;322;Neuwiller-lès-Saverne;1102;13;1115
44;Grand Est;67;2;13;324;Niederbronn-les-Bains;4381;68;4449
44;Grand Est;67;3;11;325;Niederhaslach;1398;17;1415
44;Grand Est;67;8;06;326;Niederhausbergen;1663;13;1676
44;Grand Est;67;2;23;327;Niederlauterbach;961;22;983
44;Grand Est;67;2;13;328;Niedermodern;877;7;884
44;Grand Est;67;5;12;329;Niedernai;1268;22;1290
44;Grand Est;67;2;23;330;Niederrœdern;927;9;936
44;Grand Est;67;2;05;331;Niederschaeffolsheim;1380;13;1393
44;Grand Est;67;4;08;333;Niedersoultzbach;292;5;297
44;Grand Est;67;2;13;334;Niedersteinbach;115;1;116
44;Grand Est;67;3;10;335;Nordheim;925;16;941
44;Grand Est;67;5;04;336;Nordhouse;1740;30;1770
44;Grand Est;67;5;12;337;Nothalten;456;16;472
44;Grand Est;67;5;04;338;Obenheim;1349;23;1372
44;Grand Est;67;2;23;339;Betschdorf;4183;47;4230
44;Grand Est;67;2;13;340;Oberbronn;1554;27;1581
44;Grand Est;67;2;13;341;Oberdorf-Spachbach;390;2;392
44;Grand Est;67;3;11;342;Oberhaslach;1760;29;1789
44;Grand Est;67;8;06;343;Oberhausbergen;5363;56;5419
44;Grand Est;67;2;23;344;Oberhoffen-lès-Wissembourg;318;4;322
44;Grand Est;67;2;01;345;Oberhoffen-sur-Moder;3497;27;3524
44;Grand Est;67;2;23;346;Oberlauterbach;547;11;558
44;Grand Est;67;4;02;347;Obermodern-Zutzendorf;1685;22;1707
44;Grand Est;67;5;12;348;Obernai;11765;456;12221
44;Grand Est;67;2;23;349;Oberrœdern;531;9;540
44;Grand Est;67;8;09;350;Oberschaeffolsheim;2279;24;2303
44;Grand Est;67;2;23;351;Seebach;1699;38;1737
44;Grand Est;67;4;02;352;Obersoultzbach;409;8;417
44;Grand Est;67;2;13;353;Obersteinbach;231;2;233
44;Grand Est;67;3;10;354;Odratzheim;515;9;524
44;Grand Est;67;4;08;355;Oermingen;1167;28;1195
44;Grand Est;67;2;01;356;Offendorf;2518;23;2541
44;Grand Est;67;2;13;358;Offwiller;802;13;815
44;Grand Est;67;2;05;359;Ohlungen;1305;23;1328
44;Grand Est;67;5;16;360;Ohnenheim;1071;14;1085
44;Grand Est;67;2;03;361;Olwisheim;500;7;507
44;Grand Est;67;5;16;362;Orschwiller;589;5;594
44;Grand Est;67;8;09;363;Osthoffen;816;17;833
44;Grand Est;67;5;04;364;Osthouse;930;17;947
44;Grand Est;67;8;07;365;Ostwald;12723;129;12852
44;Grand Est;67;4;14;366;Ottersthal;782;18;800
44;Grand Est;67;4;14;367;Otterswiller;1312;32;1344
44;Grand Est;67;3;10;368;Ottrott;1537;31;1568
44;Grand Est;67;4;08;369;Ottwiller;260;5;265
44;Grand Est;67;4;08;370;Petersbach;660;12;672
44;Grand Est;67;4;08;371;La Petite-Pierre;624;4;628
44;Grand Est;67;2;89;372;Val-de-Moder;5040;59;5099
44;Grand Est;67;4;08;373;Pfalzweyer;318;4;322
44;Grand Est;67;4;02;375;Pfulgriesheim;1307;17;1324
44;Grand Est;67;3;11;377;Plaine;997;11;1008
44;Grand Est;67;8;07;378;Plobsheim;4465;42;4507
44;Grand Est;67;2;13;379;Preuschdorf;896;15;911
44;Grand Est;67;4;14;380;Printzheim;203;4;207
44;Grand Est;67;4;08;381;Puberg;359;5;364
44;Grand Est;67;4;02;382;Quatzenheim;782;18;800
44;Grand Est;67;3;14;383;Rangen;183;5;188
44;Grand Est;67;3;11;384;Ranrupt;313;6;319
44;Grand Est;67;4;08;385;Ratzwiller;245;2;247
44;Grand Est;67;4;08;386;Rauwiller;209;2;211
44;Grand Est;67;5;12;387;Reichsfeld;298;9;307
44;Grand Est;67;2;13;388;Reichshoffen;5402;84;5486
44;Grand Est;67;8;06;389;Reichstett;4397;41;4438
44;Grand Est;67;4;14;391;Reinhardsmunster;448;6;454
44;Grand Est;67;4;08;392;Reipertswiller;850;12;862
44;Grand Est;67;2;23;394;Retschwiller;279;6;285
44;Grand Est;67;4;14;395;Reutenbourg;393;10;403
44;Grand Est;67;4;08;396;Rexingen;201;1;202
44;Grand Est;67;5;04;397;Rhinau;2670;31;2701
44;Grand Est;67;5;16;398;Richtolsheim;360;2;362
44;Grand Est;67;2;23;400;Riedseltz;1108;20;1128
44;Grand Est;67;4;08;401;Rimsdorf;306;10;316
44;Grand Est;67;4;02;403;Ringendorf;439;11;450
44;Grand Est;67;2;23;404;Rittershoffen;908;16;924
44;Grand Est;67;2;01;405;Rœschwoog;2281;50;2331
44;Grand Est;67;4;02;406;Rohr;340;3;343
44;Grand Est;67;2;01;407;Rohrwiller;1613;13;1626
44;Grand Est;67;3;14;408;Romanswiller;1214;17;1231
44;Grand Est;67;2;01;409;Roppenheim;1010;8;1018
44;Grand Est;67;3;10;410;Rosenwiller;661;14;675
44;Grand Est;67;3;10;411;Rosheim;5221;112;5333
44;Grand Est;67;5;04;412;Rossfeld;1024;9;1033
44;Grand Est;67;4;08;413;Rosteig;522;11;533
44;Grand Est;67;3;11;414;Rothau;1550;20;1570
44;Grand Est;67;2;13;415;Rothbach;470;1;471
44;Grand Est;67;2;23;416;Rott;469;10;479
44;Grand Est;67;2;03;417;Rottelsheim;297;9;306
44;Grand Est;67;2;01;418;Rountzenheim-Auenheim;1929;35;1964
44;Grand Est;67;3;11;420;Russ;1240;16;1256
44;Grand Est;67;3;11;421;Saales;828;12;840
44;Grand Est;67;5;16;422;Saasenheim;592;10;602
44;Grand Est;67;4;14;423;Saessolsheim;586;7;593
44;Grand Est;67;3;11;424;Saint-Blaise-la-Roche;237;0;237
44;Grand Est;67;4;14;425;Saint-Jean-Saverne;533;13;546
44;Grand Est;67;5;11;426;Saint-Martin;362;1;363
44;Grand Est;67;5;11;427;Saint-Maurice;341;14;355
44;Grand Est;67;3;10;428;Saint-Nabor;492;12;504
44;Grand Est;67;5;12;429;Saint-Pierre;627;12;639
44;Grand Est;67;5;11;430;Saint-Pierre-Bois;763;25;788
44;Grand Est;67;2;23;432;Salmbach;584;11;595
44;Grand Est;67;5;04;433;Sand;1376;10;1386
44;Grand Est;67;4;08;434;Sarre-Union;2796;43;2839
44;Grand Est;67;4;08;435;Sarrewerden;837;21;858
44;Grand Est;67;3;11;436;Saulxures;501;12;513
44;Grand Est;67;4;14;437;Saverne;11378;306;11684
44;Grand Est;67;5;04;438;Schaeffersheim;821;13;834
44;Grand Est;67;2;23;440;Schaffhouse-près-Seltz;553;12;565
44;Grand Est;67;4;02;441;Schalkendorf;330;5;335
44;Grand Est;67;3;10;442;Scharrachbergheim-Irmstett;1242;61;1303
44;Grand Est;67;2;23;443;Scheibenhard;842;20;862
44;Grand Est;67;4;02;444;Scherlenheim;121;3;124
44;Grand Est;67;5;16;445;Scherwiller;3217;53;3270
44;Grand Est;67;4;08;446;Schillersdorf;430;11;441
44;Grand Est;67;8;15;447;Schiltigheim;33780;198;33978
44;Grand Est;67;3;11;448;Schirmeck;2149;49;2198
44;Grand Est;67;2;01;449;Schirrhein;2258;21;2279
44;Grand Est;67;2;01;450;Schirrhoffen;695;16;711
44;Grand Est;67;2;23;451;Schleithal;1394;32;1426
44;Grand Est;67;4;02;452;Schnersheim;1713;32;1745
44;Grand Est;67;5;16;453;Schœnau;613;8;621
44;Grand Est;67;4;08;454;Schœnbourg;400;8;408
44;Grand Est;67;2;23;455;Schœnenbourg;696;11;707
44;Grand Est;67;4;08;456;Schopperten;450;10;460
44;Grand Est;67;2;05;458;Schweighouse-sur-Moder;4942;61;5003
44;Grand Est;67;4;14;459;Schwenheim;746;17;763
44;Grand Est;67;4;02;460;Schwindratzheim;1715;22;1737
44;Grand Est;67;5;16;461;Schwobsheim;327;14;341
44;Grand Est;67;5;16;462;Sélestat;19242;265;19507
44;Grand Est;67;2;23;463;Seltz;3162;34;3196
44;Grand Est;67;5;04;464;Sermersheim;949;13;962
44;Grand Est;67;2;01;465;Sessenheim;2324;33;2357
44;Grand Est;67;2;23;466;Siegen;509;9;518
44;Grand Est;67;4;08;467;Siewiller;383;7;390
44;Grand Est;67;4;08;468;Siltzheim;623;16;639
44;Grand Est;67;3;11;470;Solbach;99;1;100
44;Grand Est;67;8;06;471;Souffelweyersheim;7994;62;8056
44;Grand Est;67;2;01;472;Soufflenheim;4827;55;4882
44;Grand Est;67;3;10;473;Soultz-les-Bains;961;18;979
44;Grand Est;67;2;23;474;Soultz-sous-Forêts;3190;35;3225
44;Grand Est;67;4;08;475;Sparsbach;230;3;233
44;Grand Est;67;2;01;476;Stattmatten;740;6;746
44;Grand Est;67;5;11;477;Steige;607;18;625
44;Grand Est;67;4;14;478;Steinbourg;1940;28;1968
44;Grand Est;67;2;23;479;Steinseltz;597;22;619
44;Grand Est;67;3;11;480;Still;1811;26;1837
44;Grand Est;67;5;12;481;Stotzheim;1089;14;1103
44;Grand Est;67;8;99;482;Strasbourg;287228;2878;290106
44;Grand Est;67;4;08;483;Struth;233;4;237
44;Grand Est;67;2;23;484;Stundwiller;487;10;497
44;Grand Est;67;4;02;485;Stutzheim-Offenheim;1593;26;1619
44;Grand Est;67;5;16;486;Sundhouse;1851;24;1875
44;Grand Est;67;2;23;487;Surbourg;1714;25;1739
44;Grand Est;67;4;08;488;Thal-Drulingen;186;4;190
44;Grand Est;67;4;14;489;Thal-Marmoutier;811;19;830
44;Grand Est;67;5;11;490;Thanvillé;586;18;604
44;Grand Est;67;4;08;491;Tieffenbach;249;0;249
44;Grand Est;67;3;14;492;Traenheim;649;16;665
44;Grand Est;67;5;11;493;Triembach-au-Val;440;10;450
44;Grand Est;67;2;23;494;Trimbach;584;11;595
44;Grand Est;67;4;02;495;Truchtersheim;4267;99;4366
44;Grand Est;67;2;05;497;Uhlwiller;677;14;691
44;Grand Est;67;2;13;498;Uhrwiller;705;6;711
44;Grand Est;67;5;11;499;Urbeis;318;14;332
44;Grand Est;67;3;11;500;Urmatt;1457;35;1492
44;Grand Est;67;5;04;501;Uttenheim;561;4;565
44;Grand Est;67;2;13;502;Uttenhoffen;209;2;211
44;Grand Est;67;4;02;503;Uttwiller;160;2;162
44;Grand Est;67;5;12;504;Valff;1397;15;1412
44;Grand Est;67;5;16;505;La Vancelle;401;13;414
44;Grand Est;67;8;03;506;Vendenheim;5971;69;6040
44;Grand Est;67;5;11;507;Villé;1802;33;1835
44;Grand Est;67;4;08;508;Vœllerdingen;417;19;436
44;Grand Est;67;4;08;509;Volksberg;351;3;354
44;Grand Est;67;2;05;510;Wahlenheim;599;1;600
44;Grand Est;67;2;13;511;Walbourg;948;274;1222
44;Grand Est;67;3;11;513;Waldersbach;129;1;130
44;Grand Est;67;4;08;514;Waldhambach;632;9;641
44;Grand Est;67;4;14;515;Waldolwisheim;568;9;577
44;Grand Est;67;4;02;516;Waltenheim-sur-Zorn;665;8;673
44;Grand Est;67;3;10;517;Wangen;670;11;681
44;Grand Est;67;8;03;519;La Wantzenau;5881;112;5993
44;Grand Est;67;3;14;520;Wasselonne;5711;65;5776
44;Grand Est;67;4;08;521;Weinbourg;450;3;453
44;Grand Est;67;4;08;522;Weislingen;546;7;553
44;Grand Est;67;2;03;523;Weitbruch;2766;37;2803
44;Grand Est;67;4;08;524;Weiterswiller;521;8;529
44;Grand Est;67;3;14;525;Westhoffen;1636;26;1662
44;Grand Est;67;5;04;526;Westhouse;1571;18;1589
44;Grand Est;67;4;14;527;Westhouse-Marmoutier;335;8;343
44;Grand Est;67;4;08;528;Weyer;565;9;574
44;Grand Est;67;2;03;529;Weyersheim;3398;35;3433
44;Grand Est;67;4;02;530;Wickersheim-Wilshausen;377;6;383
44;Grand Est;67;3;11;531;Wildersbach;285;6;291
44;Grand Est;67;4;02;532;Willgottheim;1088;18;1106
44;Grand Est;67;4;02;534;Wilwisheim;732;3;735
44;Grand Est;67;4;08;535;Wimmenau;1057;21;1078
44;Grand Est;67;2;13;536;Windstein;158;1;159
44;Grand Est;67;2;13;537;Wingen;446;6;452
44;Grand Est;67;4;08;538;Wingen-sur-Moder;1585;21;1606
44;Grand Est;67;4;02;539;Wingersheim les Quatre Bans;2330;42;2372
44;Grand Est;67;2;05;540;Wintershouse;873;12;885
44;Grand Est;67;2;23;541;Wintzenbach;533;2;535
44;Grand Est;67;4;02;542;Wintzenheim-Kochersberg;482;3;485
44;Grand Est;67;3;11;543;Wisches;2089;29;2118
44;Grand Est;67;2;23;544;Wissembourg;7487;213;7700
44;Grand Est;67;5;04;545;Witternheim;503;7;510
44;Grand Est;67;2;05;546;Wittersheim;671;5;676
44;Grand Est;67;5;16;547;Wittisheim;2057;25;2082
44;Grand Est;67;4;02;548;Wiwersheim;881;13;894
44;Grand Est;67;2;13;550;Wœrth;1726;23;1749
44;Grand Est;67;8;06;551;Wolfisheim;4174;56;4230
44;Grand Est;67;4;08;552;Wolfskirchen;346;10;356
44;Grand Est;67;4;14;553;Wolschheim;317;4;321
44;Grand Est;67;3;10;554;Wolxheim;969;13;982
44;Grand Est;67;3;14;555;Zehnacker;249;3;252
44;Grand Est;67;3;14;556;Zeinheim;203;3;206
44;Grand Est;67;5;12;557;Zellwiller;812;12;824
44;Grand Est;67;2;13;558;Zinswiller;748;13;761
44;Grand Est;67;4;08;559;Zittersheim;249;2;251
44;Grand Est;68;2;06;001;Algolsheim;1124;13;1137
44;Grand Est;68;1;09;002;Altenach;389;4;393
44;Grand Est;68;1;01;004;Altkirch;5659;130;5789
44;Grand Est;68;2;15;005;Ammerschwihr;1761;48;1809
44;Grand Est;68;1;09;006;Bernwiller;1197;28;1225
44;Grand Est;68;2;05;007;Andolsheim;2182;73;2255
44;Grand Est;68;2;06;008;Appenwihr;578;11;589
44;Grand Est;68;2;06;009;Artzenheim;863;11;874
44;Grand Est;68;1;01;010;Aspach;1120;20;1140
44;Grand Est;68;6;03;011;Aspach-le-Bas;1317;26;1343
44;Grand Est;68;6;03;012;Aspach-Michelbach;1771;44;1815
44;Grand Est;68;4;14;013;Attenschwiller;986;22;1008
44;Grand Est;68;2;15;014;Aubure;370;9;379
44;Grand Est;68;4;13;015;Baldersheim;2667;48;2715
44;Grand Est;68;2;06;016;Balgau;985;19;1004
44;Grand Est;68;1;09;017;Ballersdorf;816;17;833
44;Grand Est;68;1;09;018;Balschwiller;731;16;747
44;Grand Est;68;2;06;019;Baltzenheim;566;8;574
44;Grand Est;68;4;13;020;Bantzenheim;1594;33;1627
44;Grand Est;68;4;02;021;Bartenheim;3987;85;4072
44;Grand Est;68;4;13;022;Battenheim;1594;14;1608
44;Grand Est;68;2;15;023;Beblenheim;939;24;963
44;Grand Est;68;1;09;024;Bellemagny;162;6;168
44;Grand Est;68;1;01;025;Bendorf;236;3;239
44;Grand Est;68;2;15;026;Bennwihr;1393;28;1421
44;Grand Est;68;1;01;027;Berentzwiller;341;9;350
44;Grand Est;68;2;15;028;Bergheim;2070;48;2118
44;Grand Est;68;6;07;029;Bergholtz;1096;32;1128
44;Grand Est;68;6;07;030;Bergholtzzell;424;14;438
44;Grand Est;68;4;17;032;Berrwiller;1195;36;1231
44;Grand Est;68;1;01;033;Bettendorf;441;8;449
44;Grand Est;68;1;01;034;Bettlach;312;16;328
44;Grand Est;68;1;01;035;Biederthal;323;14;337
44;Grand Est;68;2;06;036;Biesheim;2530;55;2585
44;Grand Est;68;6;06;037;Biltzheim;467;7;474
44;Grand Est;68;2;05;038;Bischwihr;1118;26;1144
44;Grand Est;68;1;01;039;Bisel;546;15;561
44;Grand Est;68;6;03;040;Bitschwiller-lès-Thann;1988;37;2025
44;Grand Est;68;2;06;041;Blodelsheim;1999;26;2025
44;Grand Est;68;4;14;042;Blotzheim;4661;116;4777
44;Grand Est;68;4;17;043;Bollwiller;4122;57;4179
44;Grand Est;68;2;15;044;Le Bonhomme;741;30;771
44;Grand Est;68;6;03;045;Bourbach-le-Bas;555;16;571
44;Grand Est;68;6;03;046;Bourbach-le-Haut;417;10;427
44;Grand Est;68;1;01;049;Bouxwiller;439;15;454
44;Grand Est;68;1;09;050;Bréchaumont;404;13;417
44;Grand Est;68;2;16;051;Breitenbach-Haut-Rhin;823;16;839
44;Grand Est;68;1;09;052;Bretten;184;3;187
44;Grand Est;68;4;02;054;Brinckheim;417;8;425
44;Grand Est;68;4;02;055;Bruebach;1052;33;1085
44;Grand Est;68;4;02;056;Brunstatt-Didenheim;8163;214;8377
44;Grand Est;68;1;09;057;Buethwiller;279;5;284
44;Grand Est;68;6;07;058;Buhl;3354;37;3391
44;Grand Est;68;6;09;059;Burnhaupt-le-Bas;1921;45;1966
44;Grand Est;68;6;09;060;Burnhaupt-le-Haut;1749;46;1795
44;Grand Est;68;4;14;061;Buschwiller;1060;17;1077
44;Grand Est;68;1;01;062;Carspach;2045;105;2150
44;Grand Est;68;6;03;063;Cernay;11476;208;11684
44;Grand Est;68;4;13;064;Chalampé;970;19;989
44;Grand Est;68;1;09;065;Chavannes-sur-l'Étang;708;10;718
44;Grand Est;68;2;98;066;Colmar;68682;1074;69756
44;Grand Est;68;1;01;067;Courtavon;354;2;356
44;Grand Est;68;1;09;068;Dannemarie;2262;36;2298
44;Grand Est;68;2;06;069;Dessenheim;1491;32;1523
44;Grand Est;68;1;09;071;Diefmatten;297;6;303
44;Grand Est;68;4;02;072;Dietwiller;1430;53;1483
44;Grand Est;68;6;09;073;Dolleren;479;11;490
44;Grand Est;68;1;01;074;Durlinsdorf;558;7;565
44;Grand Est;68;1;01;075;Durmenach;824;17;841
44;Grand Est;68;2;06;076;Durrenentzen;964;11;975
44;Grand Est;68;1;09;077;Eglingen;371;10;381
44;Grand Est;68;2;16;078;Eguisheim;1721;41;1762
44;Grand Est;68;1;09;079;Elbach;255;0;255
44;Grand Est;68;1;01;080;Emlingen;302;3;305
44;Grand Est;68;1;01;081;Saint-Bernard;570;9;579
44;Grand Est;68;6;06;082;Ensisheim;7512;70;7582
44;Grand Est;68;2;16;083;Eschbach-au-Val;364;13;377
44;Grand Est;68;4;02;084;Eschentzwiller;1479;48;1527
44;Grand Est;68;1;09;085;Eteimbes;378;5;383
44;Grand Est;68;1;09;086;Falkwiller;207;10;217
44;Grand Est;68;1;01;087;Feldbach;461;11;472
44;Grand Est;68;4;17;088;Feldkirch;997;20;1017
44;Grand Est;68;6;03;089;Fellering;1601;25;1626
44;Grand Est;68;1;01;090;Ferrette;812;13;825
44;Grand Est;68;2;06;091;Fessenheim;2267;47;2314
44;Grand Est;68;1;01;092;Fislis;393;6;399
44;Grand Est;68;4;02;093;Flaxlanden;1438;48;1486
44;Grand Est;68;4;14;094;Folgensbourg;941;14;955
44;Grand Est;68;2;05;095;Fortschwihr;1168;40;1208
44;Grand Est;68;1;01;096;Franken;367;4;371
44;Grand Est;68;2;15;097;Fréland;1316;32;1348
44;Grand Est;68;1;09;098;Friesen;650;7;657
44;Grand Est;68;1;01;099;Frœningen;778;18;796
44;Grand Est;68;1;09;100;Fulleren;339;14;353
44;Grand Est;68;4;08;101;Galfingue;821;18;839
44;Grand Est;68;6;03;102;Geishouse;439;10;449
44;Grand Est;68;4;02;103;Geispitzen;502;9;511
44;Grand Est;68;2;06;104;Geiswasser;296;5;301
44;Grand Est;68;1;09;105;Gildwiller;259;15;274
44;Grand Est;68;6;03;106;Goldbach-Altenbach;279;6;285
44;Grand Est;68;1;09;107;Gommersdorf;374;8;382
44;Grand Est;68;2;16;109;Griesbach-au-Val;696;14;710
44;Grand Est;68;2;05;110;Grussenheim;806;18;824
44;Grand Est;68;6;16;111;Gueberschwihr;854;25;879
44;Grand Est;68;6;07;112;Guebwiller;11020;305;11325
44;Grand Est;68;2;15;113;Guémar;1422;28;1450
44;Grand Est;68;1;09;114;Guevenatten;142;1;143
44;Grand Est;68;6;09;115;Guewenheim;1291;21;1312
44;Grand Est;68;6;16;116;Gundolsheim;716;22;738
44;Grand Est;68;2;16;117;Gunsbach;889;18;907
44;Grand Est;68;4;13;118;Habsheim;4999;87;5086
44;Grand Est;68;1;09;119;Hagenbach;743;16;759
44;Grand Est;68;4;14;120;Hagenthal-le-Bas;1245;28;1273
44;Grand Est;68;4;14;121;Hagenthal-le-Haut;706;19;725
44;Grand Est;68;6;07;122;Hartmannswiller;637;10;647
44;Grand Est;68;6;16;123;Hattstatt;784;28;812
44;Grand Est;68;1;01;124;Hausgauen;380;10;390
44;Grand Est;68;1;09;125;Hecken;518;9;527
44;Grand Est;68;4;14;126;Hégenheim;3369;73;3442
44;Grand Est;68;1;01;127;Heidwiller;645;14;659
44;Grand Est;68;1;01;128;Heimersdorf;662;15;677
44;Grand Est;68;4;08;129;Heimsbrunn;1327;50;1377
44;Grand Est;68;2;06;130;Heiteren;1036;20;1056
44;Grand Est;68;1;01;131;Heiwiller;165;1;166
44;Grand Est;68;4;02;132;Helfrantzkirch;716;18;734
44;Grand Est;68;2;16;134;Herrlisheim-près-Colmar;1859;28;1887
44;Grand Est;68;4;14;135;Hésingue;2770;54;2824
44;Grand Est;68;2;06;136;Hettenschlag;327;11;338
44;Grand Est;68;1;09;137;Hindlingen;621;9;630
44;Grand Est;68;1;01;138;Hirsingue;2120;52;2172
44;Grand Est;68;1;01;139;Hirtzbach;1462;22;1484
44;Grand Est;68;2;06;140;Hirtzfelden;1302;15;1317
44;Grand Est;68;1;01;141;Hochstatt;2170;58;2228
44;Grand Est;68;2;16;142;Hohrod;375;12;387
44;Grand Est;68;2;05;143;Porte du Ried;1823;59;1882
44;Grand Est;68;4;13;144;Hombourg;1346;26;1372
44;Grand Est;68;2;05;145;Horbourg-Wihr;6234;118;6352
44;Grand Est;68;2;05;146;Houssen;2327;23;2350
44;Grand Est;68;2;15;147;Hunawihr;606;8;614
44;Grand Est;68;1;01;148;Hundsbach;359;8;367
44;Grand Est;68;4;14;149;Huningue;7261;97;7358
44;Grand Est;68;2;16;150;Husseren-les-Châteaux;514;13;527
44;Grand Est;68;6;03;151;Husseren-Wesserling;1048;11;1059
44;Grand Est;68;1;01;152;Illfurth;2473;39;2512
44;Grand Est;68;2;15;153;Illhaeusern;730;14;744
44;Grand Est;68;4;12;154;Illzach;14784;201;14985
44;Grand Est;68;2;04;155;Ingersheim;4680;75;4755
44;Grand Est;68;6;07;156;Issenheim;3418;47;3465
44;Grand Est;68;2;05;157;Jebsheim;1367;39;1406
44;Grand Est;68;1;01;158;Jettingen;500;15;515
44;Grand Est;68;6;07;159;Jungholtz;911;25;936
44;Grand Est;68;4;02;160;Kappelen;585;24;609
44;Grand Est;68;2;15;161;Katzenthal;537;23;560
44;Grand Est;68;2;15;162;Kaysersberg Vignoble;4394;92;4486
44;Grand Est;68;4;02;163;Kembs;5496;102;5598
44;Grand Est;68;1;01;165;Kiffis;242;10;252
44;Grand Est;68;4;08;166;Kingersheim;13263;150;13413
44;Grand Est;68;6;09;167;Kirchberg;734;22;756
44;Grand Est;68;4;14;168;Knœringue;376;7;383
44;Grand Est;68;1;01;169;Kœstlach;506;10;516
44;Grand Est;68;4;02;170;Kœtzingue;586;24;610
44;Grand Est;68;6;03;171;Kruth;945;12;957
44;Grand Est;68;2;06;172;Kunheim;1795;30;1825
44;Grand Est;68;2;15;173;Labaroche;2122;76;2198
44;Grand Est;68;4;02;174;Landser;1650;25;1675
44;Grand Est;68;2;15;175;Lapoutroie;1871;40;1911
44;Grand Est;68;1;09;176;Largitzen;324;4;328
44;Grand Est;68;6;07;177;Lautenbach;1492;38;1530
44;Grand Est;68;6;07;178;Lautenbachzell;950;14;964
44;Grand Est;68;6;09;179;Lauw;917;15;932
44;Grand Est;68;6;03;180;Leimbach;909;29;938
44;Grand Est;68;1;01;181;Levoncourt;248;4;252
44;Grand Est;68;4;14;182;Leymen;1212;27;1239
44;Grand Est;68;4;14;183;Liebenswiller;183;4;187
44;Grand Est;68;1;01;184;Liebsdorf;303;9;312
44;Grand Est;68;2;15;185;Lièpvre;1684;32;1716
44;Grand Est;68;1;01;186;Ligsdorf;307;10;317
44;Grand Est;68;1;01;187;Linsdorf;333;10;343
44;Grand Est;68;6;07;188;Linthal;584;19;603
44;Grand Est;68;2;06;189;Logelheim;855;26;881
44;Grand Est;68;1;01;190;Lucelle;33;0;33
44;Grand Est;68;1;01;191;Luemschwiller;760;23;783
44;Grand Est;68;1;09;192;Valdieu-Lutran;427;7;434
44;Grand Est;68;2;16;193;Luttenbach-près-Munster;751;9;760
44;Grand Est;68;1;01;194;Lutter;283;5;288
44;Grand Est;68;4;08;195;Lutterbach;6247;98;6345
44;Grand Est;68;1;09;196;Magny;300;5;305
44;Grand Est;68;4;02;197;Magstatt-le-Bas;485;10;495
44;Grand Est;68;4;02;198;Magstatt-le-Haut;286;8;294
44;Grand Est;68;6;03;199;Malmerspach;502;2;504
44;Grand Est;68;1;09;200;Manspach;533;12;545
44;Grand Est;68;6;09;201;Masevaux-Niederbruck;3720;79;3799
44;Grand Est;68;1;09;202;Mertzen;202;4;206
44;Grand Est;68;6;07;203;Merxheim;1247;26;1273
44;Grand Est;68;2;16;204;Metzeral;1042;15;1057
44;Grand Est;68;6;06;205;Meyenheim;1830;19;1849
44;Grand Est;68;4;14;207;Michelbach-le-Bas;697;9;706
44;Grand Est;68;4;14;208;Michelbach-le-Haut;597;11;608
44;Grand Est;68;2;15;209;Mittelwihr;834;16;850
44;Grand Est;68;2;16;210;Mittlach;327;1;328
44;Grand Est;68;6;03;211;Mitzach;386;8;394
44;Grand Est;68;1;01;212;Mœrnach;519;12;531
44;Grand Est;68;6;03;213;Mollau;341;10;351
44;Grand Est;68;1;09;214;Montreux-Jeune;378;8;386
44;Grand Est;68;1;09;215;Montreux-Vieux;908;7;915
44;Grand Est;68;1;09;216;Mooslargue;409;6;415
44;Grand Est;68;6;03;217;Moosch;1640;20;1660
44;Grand Est;68;4;08;218;Morschwiller-le-Bas;3692;76;3768
44;Grand Est;68;6;09;219;Le Haut Soultzbach;881;24;905
44;Grand Est;68;1;01;221;Muespach;926;13;939
44;Grand Est;68;1;01;222;Muespach-le-Haut;1057;19;1076
44;Grand Est;68;2;16;223;Muhlbach-sur-Munster;782;14;796
44;Grand Est;68;4;99;224;Mulhouse;108312;1219;109531
44;Grand Est;68;2;06;225;Munchhouse;1561;28;1589
44;Grand Est;68;2;16;226;Munster;4699;84;4783
44;Grand Est;68;2;05;227;Muntzenheim;1286;34;1320
44;Grand Est;68;6;06;228;Munwiller;464;12;476
44;Grand Est;68;6;07;229;Murbach;163;3;166
44;Grand Est;68;2;06;230;Nambsheim;584;7;591
44;Grand Est;68;2;06;231;Neuf-Brisach;1963;16;1979
44;Grand Est;68;4;14;232;Neuwiller;484;7;491
44;Grand Est;68;6;06;234;Niederentzen;733;11;744
44;Grand Est;68;6;06;235;Niederhergheim;1147;16;1163
44;Grand Est;68;2;16;237;Niedermorschwihr;558;15;573
44;Grand Est;68;4;13;238;Niffer;945;25;970
44;Grand Est;68;6;09;239;Oberbruck;390;15;405
44;Grand Est;68;1;01;240;Illtal;1319;19;1338
44;Grand Est;68;6;06;241;Oberentzen;665;9;674
44;Grand Est;68;6;06;242;Oberhergheim;1245;26;1271
44;Grand Est;68;1;01;243;Oberlarg;140;1;141
44;Grand Est;68;2;16;244;Obermorschwihr;358;6;364
44;Grand Est;68;1;01;245;Obermorschwiller;412;15;427
44;Grand Est;68;2;06;246;Obersaasheim;1018;13;1031
44;Grand Est;68;6;03;247;Oderen;1260;14;1274
44;Grand Est;68;1;01;248;Oltingue;673;20;693
44;Grand Est;68;2;15;249;Orbey;3467;66;3533
44;Grand Est;68;6;07;250;Orschwihr;1041;18;1059
44;Grand Est;68;6;16;251;Osenbach;859;22;881
44;Grand Est;68;2;15;252;Ostheim;1654;30;1684
44;Grand Est;68;4;13;253;Ottmarsheim;1973;30;2003
44;Grand Est;68;4;13;254;Petit-Landau;827;18;845
44;Grand Est;68;6;16;255;Pfaffenheim;1386;42;1428
44;Grand Est;68;4;08;256;Pfastatt;9723;131;9854
44;Grand Est;68;1;09;257;Pfetterhouse;966;23;989
44;Grand Est;68;4;17;258;Pulversheim;3017;77;3094
44;Grand Est;68;1;01;259;Raedersdorf;515;7;522
44;Grand Est;68;6;07;260;Raedersheim;1113;26;1139
44;Grand Est;68;6;03;261;Rammersmatt;229;6;235
44;Grand Est;68;6;03;262;Ranspach;801;17;818
44;Grand Est;68;4;14;263;Ranspach-le-Bas;635;13;648
44;Grand Est;68;4;14;264;Ranspach-le-Haut;628;11;639
44;Grand Est;68;4;02;265;Rantzwiller;797;23;820
44;Grand Est;68;6;06;266;Réguisheim;1990;30;2020
44;Grand Est;68;4;08;267;Reiningue;1979;25;2004
44;Grand Est;68;1;09;268;Retzwiller;704;10;714
44;Grand Est;68;2;15;269;Ribeauvillé;4665;176;4841
44;Grand Est;68;4;08;270;Richwiller;3692;59;3751
44;Grand Est;68;4;13;271;Riedisheim;12520;326;12846
44;Grand Est;68;1;01;273;Riespach;632;40;672
44;Grand Est;68;6;07;274;Rimbach-près-Guebwiller;188;0;188
44;Grand Est;68;6;09;275;Rimbach-près-Masevaux;446;11;457
44;Grand Est;68;6;07;276;Rimbachzell;192;2;194
44;Grand Est;68;2;15;277;Riquewihr;1090;19;1109
44;Grand Est;68;4;13;278;Rixheim;14204;201;14405
44;Grand Est;68;6;03;279;Roderen;902;30;932
44;Grand Est;68;2;15;280;Rodern;374;6;380
44;Grand Est;68;2;06;281;Roggenhouse;466;13;479
44;Grand Est;68;1;09;282;Romagny;280;5;285
44;Grand Est;68;2;15;283;Rombach-le-Franc;771;23;794
44;Grand Est;68;1;01;284;Roppentzwiller;696;10;706
44;Grand Est;68;2;15;285;Rorschwihr;371;8;379
44;Grand Est;68;4;14;286;Rosenau;2371;49;2420
44;Grand Est;68;6;16;287;Rouffach;4302;236;4538
44;Grand Est;68;1;01;288;Ruederbach;401;4;405
44;Grand Est;68;4;17;289;Ruelisheim;2329;37;2366
44;Grand Est;68;2;06;290;Rustenhart;888;16;904
44;Grand Est;68;2;06;291;Rumersheim-le-Haut;1059;27;1086
44;Grand Est;68;6;03;292;Saint-Amarin;2233;43;2276
44;Grand Est;68;1;09;293;Saint-Cosme;83;1;84
44;Grand Est;68;2;15;294;Sainte-Croix-aux-Mines;1908;30;1938
44;Grand Est;68;2;05;295;Sainte-Croix-en-Plaine;3029;66;3095
44;Grand Est;68;2;15;296;Saint-Hippolyte;993;14;1007
44;Grand Est;68;4;14;297;Saint-Louis;22413;287;22700
44;Grand Est;68;2;15;298;Sainte-Marie-aux-Mines;5054;127;5181
44;Grand Est;68;1;09;299;Saint-Ulrich;312;0;312
44;Grand Est;68;4;13;300;Sausheim;5479;125;5604
44;Grand Est;68;4;02;301;Schlierbach;1269;25;1294
44;Grand Est;68;6;03;302;Schweighouse-Thann;752;30;782
44;Grand Est;68;1;01;303;Schwoben;229;7;236
44;Grand Est;68;6;09;304;Sentheim;1561;39;1600
44;Grand Est;68;1;09;305;Seppois-le-Bas;1390;28;1418
44;Grand Est;68;1;09;306;Seppois-le-Haut;507;8;515
44;Grand Est;68;6;09;307;Sewen;498;10;508
44;Grand Est;68;6;09;308;Sickert;325;12;337
44;Grand Est;68;4;02;309;Sierentz;3842;76;3918
44;Grand Est;68;2;16;311;Sondernach;598;12;610
44;Grand Est;68;1;01;312;Sondersdorf;318;6;324
44;Grand Est;68;6;09;313;Soppe-le-Bas;775;11;786
44;Grand Est;68;6;07;315;Soultz-Haut-Rhin;7048;134;7182
44;Grand Est;68;2;16;316;Soultzbach-les-Bains;730;21;751
44;Grand Est;68;2;16;317;Soultzeren;1106;19;1125
44;Grand Est;68;6;16;318;Soultzmatt;2392;52;2444
44;Grand Est;68;1;01;320;Spechbach;1369;47;1416
44;Grand Est;68;4;17;321;Staffelfelden;4046;62;4108
44;Grand Est;68;6;03;322;Steinbach;1349;29;1378
44;Grand Est;68;4;02;323;Steinbrunn-le-Bas;809;24;833
44;Grand Est;68;4;02;324;Steinbrunn-le-Haut;611;17;628
44;Grand Est;68;1;01;325;Steinsoultz;764;9;773
44;Grand Est;68;1;09;326;Sternenberg;153;5;158
44;Grand Est;68;4;02;327;Stetten;350;7;357
44;Grand Est;68;6;03;328;Storckensohn;201;1;202
44;Grand Est;68;2;16;329;Stosswihr;1349;34;1383
44;Grand Est;68;1;09;330;Strueth;338;8;346
44;Grand Est;68;2;05;331;Sundhoffen;1939;58;1997
44;Grand Est;68;1;01;332;Tagolsheim;949;13;962
44;Grand Est;68;1;01;333;Tagsdorf;296;6;302
44;Grand Est;68;6;03;334;Thann;7767;148;7915
44;Grand Est;68;2;15;335;Thannenkirch;464;6;470
44;Grand Est;68;1;09;336;Traubach-le-Bas;459;8;467
44;Grand Est;68;1;09;337;Traubach-le-Haut;605;11;616
44;Grand Est;68;2;16;338;Turckheim;3831;80;3911
44;Grand Est;68;1;09;340;Ueberstrass;373;15;388
44;Grand Est;68;4;02;341;Uffheim;946;30;976
44;Grand Est;68;6;03;342;Uffholtz;1698;43;1741
44;Grand Est;68;4;17;343;Ungersheim;2381;34;2415
44;Grand Est;68;6;03;344;Urbès;438;10;448
44;Grand Est;68;2;06;345;Urschenheim;757;27;784
44;Grand Est;68;1;01;347;Vieux-Ferrette;693;22;715
44;Grand Est;68;6;03;348;Vieux-Thann;2815;51;2866
44;Grand Est;68;4;14;349;Village-Neuf;4421;95;4516
44;Grand Est;68;2;16;350;Vœgtlinshoffen;477;15;492
44;Grand Est;68;2;06;351;Vogelgrun;639;13;652
44;Grand Est;68;2;06;352;Volgelsheim;2680;24;2704
44;Grand Est;68;4;02;353;Wahlbach;491;17;508
44;Grand Est;68;2;16;354;Walbach;920;37;957
44;Grand Est;68;1;01;355;Waldighofen;1543;28;1571
44;Grand Est;68;1;01;356;Walheim;880;21;901
44;Grand Est;68;4;02;357;Waltenheim;514;17;531
44;Grand Est;68;2;16;358;Wasserbourg;471;11;482
44;Grand Est;68;6;03;359;Wattwiller;1663;59;1722
44;Grand Est;68;2;06;360;Weckolsheim;653;4;657
44;Grand Est;68;6;09;361;Wegscheid;320;5;325
44;Grand Est;68;4;14;362;Wentzwiller;771;15;786
44;Grand Est;68;1;01;363;Werentzhouse;587;12;599
44;Grand Est;68;6;16;364;Westhalten;992;19;1011
44;Grand Est;68;2;16;365;Wettolsheim;1745;64;1809
44;Grand Est;68;2;05;366;Wickerschwihr;711;30;741
44;Grand Est;68;2;06;367;Widensolen;1178;21;1199
44;Grand Est;68;2;16;368;Wihr-au-Val;1242;35;1277
44;Grand Est;68;6;03;370;Wildenstein;169;2;171
44;Grand Est;68;1;01;371;Willer;310;9;319
44;Grand Est;68;6;03;372;Willer-sur-Thur;1780;39;1819
44;Grand Est;68;1;01;373;Winkel;300;12;312
44;Grand Est;68;2;16;374;Wintzenheim;7853;408;8261
44;Grand Est;68;4;17;375;Wittelsheim;10362;137;10499
44;Grand Est;68;4;17;376;Wittenheim;14776;111;14887
44;Grand Est;68;1;01;377;Wittersdorf;794;19;813
44;Grand Est;68;1;09;378;Wolfersdorf;380;4;384
44;Grand Est;68;2;06;379;Wolfgantzen;1036;20;1056
44;Grand Est;68;1;01;380;Wolschwiller;443;11;454
44;Grand Est;68;6;07;381;Wuenheim;799;16;815
44;Grand Est;68;4;02;382;Zaessingue;379;4;383
44;Grand Est;68;2;15;383;Zellenberg;320;8;328
44;Grand Est;68;4;02;384;Zillisheim;2538;61;2599
44;Grand Est;68;2;16;385;Zimmerbach;837;25;862
44;Grand Est;68;4;02;386;Zimmersheim;1041;22;1063
84;Auvergne-Rhône-Alpes;69;2;10;001;Affoux;391;3;394
84;Auvergne-Rhône-Alpes;69;2;11;002;Aigueperse;245;1;246
84;Auvergne-Rhône-Alpes;69;1;00;003;Albigny-sur-Saône;2947;42;2989
84;Auvergne-Rhône-Alpes;69;2;04;004;Alix;768;24;792
84;Auvergne-Rhône-Alpes;69;2;01;005;Ambérieux;584;9;593
84;Auvergne-Rhône-Alpes;69;2;11;006;Amplepuis;4919;119;5038
84;Auvergne-Rhône-Alpes;69;1;08;007;Ampuis;2749;45;2794
84;Auvergne-Rhône-Alpes;69;2;10;008;Ancy;668;15;683
84;Auvergne-Rhône-Alpes;69;2;01;009;Anse;7538;164;7702
84;Auvergne-Rhône-Alpes;69;2;02;010;L'Arbresle;6410;196;6606
84;Auvergne-Rhône-Alpes;69;2;03;012;Les Ardillats;611;15;626
84;Auvergne-Rhône-Alpes;69;2;07;013;Arnas;3897;82;3979
84;Auvergne-Rhône-Alpes;69;1;12;014;Aveize;1129;22;1151
84;Auvergne-Rhône-Alpes;69;2;11;016;Azolette;121;0;121
84;Auvergne-Rhône-Alpes;69;2;04;017;Bagnols;745;21;766
84;Auvergne-Rhône-Alpes;69;2;03;018;Beaujeu;2148;32;2180
84;Auvergne-Rhône-Alpes;69;2;03;019;Belleville-en-Beaujolais;13314;277;13591
84;Auvergne-Rhône-Alpes;69;2;04;020;Belmont-d'Azergues;681;19;700
84;Auvergne-Rhône-Alpes;69;2;02;021;Bessenay;2340;80;2420
84;Auvergne-Rhône-Alpes;69;2;02;022;Bibost;558;16;574
84;Auvergne-Rhône-Alpes;69;2;07;023;Blacé;1635;25;1660
84;Auvergne-Rhône-Alpes;69;2;04;024;Val d'Oingt;4122;103;4225
84;Auvergne-Rhône-Alpes;69;2;04;026;Le Breuil;548;10;558
84;Auvergne-Rhône-Alpes;69;1;05;027;Brignais;12097;175;12272
84;Auvergne-Rhône-Alpes;69;1;05;028;Brindas;6478;111;6589
84;Auvergne-Rhône-Alpes;69;1;00;029;Bron;42244;401;42645
84;Auvergne-Rhône-Alpes;69;1;02;030;Brullioles;818;15;833
84;Auvergne-Rhône-Alpes;69;1;02;031;Brussieu;1379;104;1483
84;Auvergne-Rhône-Alpes;69;2;04;032;Bully;1988;36;2024
84;Auvergne-Rhône-Alpes;69;1;00;033;Cailloux-sur-Fontaines;2883;74;2957
84;Auvergne-Rhône-Alpes;69;1;00;034;Caluire-et-Cuire;43294;622;43916
84;Auvergne-Rhône-Alpes;69;2;03;035;Cenves;381;7;388
84;Auvergne-Rhône-Alpes;69;2;03;036;Cercié;1138;22;1160
84;Auvergne-Rhône-Alpes;69;2;10;037;Chambost-Allières;833;12;845
84;Auvergne-Rhône-Alpes;69;1;02;038;Chambost-Longessaigne;928;25;953
84;Auvergne-Rhône-Alpes;69;2;04;039;Chamelet;694;10;704
84;Auvergne-Rhône-Alpes;69;1;00;040;Champagne-au-Mont-d'Or;5748;48;5796
84;Auvergne-Rhône-Alpes;69;1;12;042;La Chapelle-sur-Coise;566;15;581
84;Auvergne-Rhône-Alpes;69;1;05;043;Chaponost;8846;173;9019
84;Auvergne-Rhône-Alpes;69;1;00;044;Charbonnières-les-Bains;5170;146;5316
84;Auvergne-Rhône-Alpes;69;2;03;045;Charentay;1248;68;1316
84;Auvergne-Rhône-Alpes;69;1;00;046;Charly;4563;138;4701
84;Auvergne-Rhône-Alpes;69;2;04;047;Charnay;1051;21;1072
84;Auvergne-Rhône-Alpes;69;2;01;049;Chasselay;2791;65;2856
84;Auvergne-Rhône-Alpes;69;2;04;050;Châtillon;2113;42;2155
84;Auvergne-Rhône-Alpes;69;1;08;051;Chaussan;1170;33;1203
84;Auvergne-Rhône-Alpes;69;2;01;052;Chazay-d'Azergues;4132;113;4245
84;Auvergne-Rhône-Alpes;69;2;03;053;Chénas;543;13;556
84;Auvergne-Rhône-Alpes;69;2;11;054;Chénelette;343;2;345
84;Auvergne-Rhône-Alpes;69;2;01;055;Les Chères;1448;27;1475
84;Auvergne-Rhône-Alpes;69;2;04;056;Chessy;2107;52;2159
84;Auvergne-Rhône-Alpes;69;2;02;057;Chevinay;582;13;595
84;Auvergne-Rhône-Alpes;69;2;03;058;Chiroubles;384;9;393
84;Auvergne-Rhône-Alpes;69;2;01;059;Civrieux-d'Azergues;1537;28;1565
84;Auvergne-Rhône-Alpes;69;2;11;060;Claveisolles;576;83;659
84;Auvergne-Rhône-Alpes;69;2;04;061;Cogny;1188;34;1222
84;Auvergne-Rhône-Alpes;69;1;12;062;Coise;778;23;801
84;Auvergne-Rhône-Alpes;69;1;00;063;Collonges-au-Mont-d'Or;4315;86;4401
84;Auvergne-Rhône-Alpes;69;1;08;064;Condrieu;3957;83;4040
84;Auvergne-Rhône-Alpes;69;2;03;065;Corcelles-en-Beaujolais;965;15;980
84;Auvergne-Rhône-Alpes;69;2;11;066;Cours;4390;80;4470
84;Auvergne-Rhône-Alpes;69;2;02;067;Courzieu;1168;21;1189
84;Auvergne-Rhône-Alpes;69;1;00;068;Couzon-au-Mont-d'Or;2454;48;2502
84;Auvergne-Rhône-Alpes;69;1;00;069;Craponne;11248;184;11432
84;Auvergne-Rhône-Alpes;69;2;11;070;Cublize;1266;28;1294
84;Auvergne-Rhône-Alpes;69;1;00;071;Curis-au-Mont-d'Or;1179;27;1206
84;Auvergne-Rhône-Alpes;69;1;00;072;Dardilly;8752;612;9364
84;Auvergne-Rhône-Alpes;69;2;07;074;Denicé;1550;40;1590
84;Auvergne-Rhône-Alpes;69;2;10;075;Dième;193;2;195
84;Auvergne-Rhône-Alpes;69;2;01;076;Dommartin;2595;101;2696
84;Auvergne-Rhône-Alpes;69;2;03;077;Dracé;965;12;977
84;Auvergne-Rhône-Alpes;69;1;12;078;Duerne;837;16;853
84;Auvergne-Rhône-Alpes;69;1;08;080;Échalas;1901;16;1917
84;Auvergne-Rhône-Alpes;69;1;00;081;Écully;18948;385;19333
84;Auvergne-Rhône-Alpes;69;2;03;082;Émeringes;270;8;278
84;Auvergne-Rhône-Alpes;69;2;02;083;Éveux;1164;39;1203
84;Auvergne-Rhône-Alpes;69;2;03;084;Fleurie;1282;22;1304
84;Auvergne-Rhône-Alpes;69;1;00;085;Fleurieu-sur-Saône;1492;42;1534
84;Auvergne-Rhône-Alpes;69;2;02;086;Fleurieux-sur-l'Arbresle;2290;63;2353
84;Auvergne-Rhône-Alpes;69;1;00;087;Fontaines-Saint-Martin;3033;73;3106
84;Auvergne-Rhône-Alpes;69;1;00;088;Fontaines-sur-Saône;7066;97;7163
84;Auvergne-Rhône-Alpes;69;1;00;089;Francheville;14906;258;15164
84;Auvergne-Rhône-Alpes;69;2;04;090;Frontenas;809;24;833
84;Auvergne-Rhône-Alpes;69;1;00;091;Givors;20285;104;20389
84;Auvergne-Rhône-Alpes;69;2;07;092;Gleizé;7496;345;7841
84;Auvergne-Rhône-Alpes;69;2;10;093;Grandris;1187;19;1206
84;Auvergne-Rhône-Alpes;69;1;05;094;Grézieu-la-Varenne;6062;115;6177
84;Auvergne-Rhône-Alpes;69;1;12;095;Grézieu-le-Marché;827;17;844
84;Auvergne-Rhône-Alpes;69;1;00;096;Grigny;9706;75;9781
84;Auvergne-Rhône-Alpes;69;1;08;097;Les Haies;772;20;792
84;Auvergne-Rhône-Alpes;69;1;02;098;Les Halles;508;7;515
84;Auvergne-Rhône-Alpes;69;1;02;099;Haute-Rivoire;1442;28;1470
84;Auvergne-Rhône-Alpes;69;1;00;100;Irigny;8750;121;8871
84;Auvergne-Rhône-Alpes;69;2;10;102;Joux;734;12;746
84;Auvergne-Rhône-Alpes;69;2;03;103;Juliénas;899;22;921
84;Auvergne-Rhône-Alpes;69;2;03;104;Jullié;432;9;441
84;Auvergne-Rhône-Alpes;69;2;07;105;Lacenas;1021;37;1058
84;Auvergne-Rhône-Alpes;69;2;01;106;Lachassagne;1181;24;1205
84;Auvergne-Rhône-Alpes;69;2;10;107;Lamure-sur-Azergues;1055;66;1121
84;Auvergne-Rhône-Alpes;69;2;03;108;Lancié;1043;22;1065
84;Auvergne-Rhône-Alpes;69;2;03;109;Lantignié;861;27;888
84;Auvergne-Rhône-Alpes;69;1;12;110;Larajasse;1862;30;1892
84;Auvergne-Rhône-Alpes;69;2;04;111;Légny;673;17;690
84;Auvergne-Rhône-Alpes;69;2;01;112;Lentilly;6480;155;6635
84;Auvergne-Rhône-Alpes;69;2;04;113;Létra;901;27;928
84;Auvergne-Rhône-Alpes;69;2;07;115;Limas;4871;98;4969
84;Auvergne-Rhône-Alpes;69;1;00;116;Limonest;3648;102;3750
84;Auvergne-Rhône-Alpes;69;1;00;117;Lissieu;3134;75;3209
84;Auvergne-Rhône-Alpes;69;1;08;118;Loire-sur-Rhône;2618;32;2650
84;Auvergne-Rhône-Alpes;69;1;08;119;Longes;977;8;985
84;Auvergne-Rhône-Alpes;69;1;02;120;Longessaigne;595;16;611
84;Auvergne-Rhône-Alpes;69;2;01;121;Lozanne;2729;45;2774
84;Auvergne-Rhône-Alpes;69;2;01;122;Lucenay;1916;53;1969
84;Auvergne-Rhône-Alpes;69;2;03;124;Marchampt;459;9;468
84;Auvergne-Rhône-Alpes;69;2;01;125;Marcilly-d'Azergues;876;15;891
84;Auvergne-Rhône-Alpes;69;2;01;126;Marcy;768;28;796
84;Auvergne-Rhône-Alpes;69;1;00;127;Marcy-l'Étoile;3549;64;3613
84;Auvergne-Rhône-Alpes;69;2;11;130;Meaux-la-Montagne;233;3;236
84;Auvergne-Rhône-Alpes;69;1;05;131;Messimy;3402;85;3487
84;Auvergne-Rhône-Alpes;69;1;12;132;Meys;847;15;862
84;Auvergne-Rhône-Alpes;69;1;09;133;Millery;4318;80;4398
84;Auvergne-Rhône-Alpes;69;2;04;134;Moiré;227;10;237
84;Auvergne-Rhône-Alpes;69;2;11;135;Deux-Grosnes;1911;53;1964
84;Auvergne-Rhône-Alpes;69;1;09;136;Montagny;3118;55;3173
84;Auvergne-Rhône-Alpes;69;2;07;137;Montmelas-Saint-Sorlin;516;7;523
84;Auvergne-Rhône-Alpes;69;1;02;138;Montromant;445;9;454
84;Auvergne-Rhône-Alpes;69;1;02;139;Montrottier;1378;77;1455
84;Auvergne-Rhône-Alpes;69;2;01;140;Morancé;1995;46;2041
84;Auvergne-Rhône-Alpes;69;1;08;141;Mornant;6144;172;6316
84;Auvergne-Rhône-Alpes;69;1;00;142;La Mulatière;6524;73;6597
84;Auvergne-Rhône-Alpes;69;1;00;143;Neuville-sur-Saône;7562;88;7650
84;Auvergne-Rhône-Alpes;69;2;03;145;Odenas;921;25;946
84;Auvergne-Rhône-Alpes;69;1;09;148;Orliénas;2541;71;2612
84;Auvergne-Rhône-Alpes;69;1;00;149;Oullins;26553;278;26831
84;Auvergne-Rhône-Alpes;69;2;07;151;Le Perréon;1524;32;1556
84;Auvergne-Rhône-Alpes;69;1;00;152;Pierre-Bénite;10397;60;10457
84;Auvergne-Rhône-Alpes;69;1;00;153;Poleymieux-au-Mont-d'Or;1377;28;1405
84;Auvergne-Rhône-Alpes;69;1;12;154;Pollionnay;2845;53;2898
84;Auvergne-Rhône-Alpes;69;1;12;155;Pomeys;1132;31;1163
84;Auvergne-Rhône-Alpes;69;2;01;156;Pommiers;2713;82;2795
84;Auvergne-Rhône-Alpes;69;2;10;157;Vindry-sur-Turdine;5279;88;5367
84;Auvergne-Rhône-Alpes;69;2;04;159;Porte des Pierres Dorées;3907;93;4000
84;Auvergne-Rhône-Alpes;69;2;11;160;Poule-les-Écharmeaux;1065;18;1083
84;Auvergne-Rhône-Alpes;69;2;11;161;Propières;487;11;498
84;Auvergne-Rhône-Alpes;69;2;03;162;Quincié-en-Beaujolais;1331;34;1365
84;Auvergne-Rhône-Alpes;69;1;00;163;Quincieux;3495;50;3545
84;Auvergne-Rhône-Alpes;69;2;11;164;Ranchal;322;10;332
84;Auvergne-Rhône-Alpes;69;2;03;165;Régnié-Durette;1126;25;1151
84;Auvergne-Rhône-Alpes;69;1;08;166;Riverie;328;2;330
84;Auvergne-Rhône-Alpes;69;2;07;167;Rivolet;589;11;600
84;Auvergne-Rhône-Alpes;69;1;00;168;Rochetaillée-sur-Saône;1536;41;1577
84;Auvergne-Rhône-Alpes;69;2;11;169;Ronno;639;23;662
84;Auvergne-Rhône-Alpes;69;1;12;170;Rontalon;1157;18;1175
84;Auvergne-Rhône-Alpes;69;2;02;171;Sain-Bel;2363;26;2389
84;Auvergne-Rhône-Alpes;69;2;07;172;Salles-Arbuissonnas-en-Beaujolais;761;27;788
84;Auvergne-Rhône-Alpes;69;2;10;173;Sarcey;1016;25;1041
84;Auvergne-Rhône-Alpes;69;2;10;174;Les Sauvages;614;11;625
84;Auvergne-Rhône-Alpes;69;2;02;175;Savigny;1996;56;2052
84;Auvergne-Rhône-Alpes;69;1;08;176;Soucieu-en-Jarrest;4590;84;4674
84;Auvergne-Rhône-Alpes;69;2;02;177;Sourcieux-les-Mines;2064;46;2110
84;Auvergne-Rhône-Alpes;69;1;02;178;Souzy;825;20;845
84;Auvergne-Rhône-Alpes;69;1;08;179;Beauvallon;4055;74;4129
84;Auvergne-Rhône-Alpes;69;1;12;180;Saint-André-la-Côte;288;9;297
84;Auvergne-Rhône-Alpes;69;2;10;181;Saint-Appolinaire;223;1;224
84;Auvergne-Rhône-Alpes;69;2;11;182;Saint-Bonnet-des-Bruyères;356;2;358
84;Auvergne-Rhône-Alpes;69;2;11;183;Saint-Bonnet-le-Troncy;317;2;319
84;Auvergne-Rhône-Alpes;69;1;12;184;Sainte-Catherine;991;21;1012
84;Auvergne-Rhône-Alpes;69;2;11;186;Saint-Clément-de-Vers;213;4;217
84;Auvergne-Rhône-Alpes;69;1;02;187;Saint-Clément-les-Places;654;21;675
84;Auvergne-Rhône-Alpes;69;2;10;188;Saint-Clément-sur-Valsonne;908;9;917
84;Auvergne-Rhône-Alpes;69;1;08;189;Sainte-Colombe;1884;29;1913
84;Auvergne-Rhône-Alpes;69;1;12;190;Sainte-Consorce;2028;87;2115
84;Auvergne-Rhône-Alpes;69;1;00;191;Saint-Cyr-au-Mont-d'Or;5747;142;5889
84;Auvergne-Rhône-Alpes;69;2;07;192;Saint-Cyr-le-Chatoux;153;7;160
84;Auvergne-Rhône-Alpes;69;1;08;193;Saint-Cyr-sur-le-Rhône;1269;32;1301
84;Auvergne-Rhône-Alpes;69;1;00;194;Saint-Didier-au-Mont-d'Or;7006;158;7164
84;Auvergne-Rhône-Alpes;69;2;03;196;Saint-Didier-sur-Beaujeu;617;11;628
84;Auvergne-Rhône-Alpes;69;2;07;197;Saint-Étienne-des-Oullières;2210;48;2258
84;Auvergne-Rhône-Alpes;69;2;03;198;Saint-Étienne-la-Varenne;756;11;767
84;Auvergne-Rhône-Alpes;69;1;00;199;Saint-Fons;19617;61;19678
84;Auvergne-Rhône-Alpes;69;2;10;200;Saint-Forgeux;1472;31;1503
84;Auvergne-Rhône-Alpes;69;1;02;201;Sainte-Foy-l'Argentière;1286;25;1311
84;Auvergne-Rhône-Alpes;69;1;00;202;Sainte-Foy-lès-Lyon;22175;392;22567
84;Auvergne-Rhône-Alpes;69;1;02;203;Saint-Genis-l'Argentière;1018;17;1035
84;Auvergne-Rhône-Alpes;69;1;00;204;Saint-Genis-Laval;20914;477;21391
84;Auvergne-Rhône-Alpes;69;1;00;205;Saint-Genis-les-Ollières;5158;92;5250
84;Auvergne-Rhône-Alpes;69;2;07;206;Saint-Georges-de-Reneins;4409;92;4501
84;Auvergne-Rhône-Alpes;69;1;00;207;Saint-Germain-au-Mont-d'Or;3001;47;3048
84;Auvergne-Rhône-Alpes;69;2;04;208;Saint-Germain-Nuelles;2262;60;2322
84;Auvergne-Rhône-Alpes;69;2;11;209;Saint-Igny-de-Vers;566;16;582
84;Auvergne-Rhône-Alpes;69;2;04;212;Saint-Jean-des-Vignes;479;11;490
84;Auvergne-Rhône-Alpes;69;2;11;214;Saint-Jean-la-Bussière;1204;25;1229
84;Auvergne-Rhône-Alpes;69;2;07;215;Saint-Julien;879;20;899
84;Auvergne-Rhône-Alpes;69;2;02;216;Saint-Julien-sur-Bibost;566;11;577
84;Auvergne-Rhône-Alpes;69;2;10;217;Saint-Just-d'Avray;748;22;770
84;Auvergne-Rhône-Alpes;69;2;03;218;Saint-Lager;1048;17;1065
84;Auvergne-Rhône-Alpes;69;1;08;219;Saint-Laurent-d'Agny;2133;63;2196
84;Auvergne-Rhône-Alpes;69;1;02;220;Saint-Laurent-de-Chamousset;1805;113;1918
84;Auvergne-Rhône-Alpes;69;2;10;225;Saint-Marcel-l'Éclairé;541;14;555
84;Auvergne-Rhône-Alpes;69;1;12;227;Saint-Martin-en-Haut;3853;189;4042
84;Auvergne-Rhône-Alpes;69;1;08;228;Chabanière;4224;93;4317
84;Auvergne-Rhône-Alpes;69;2;11;229;Saint-Nizier-d'Azergues;800;14;814
84;Auvergne-Rhône-Alpes;69;2;04;230;Sainte-Paule;320;6;326
84;Auvergne-Rhône-Alpes;69;2;02;231;Saint-Pierre-la-Palud;2596;60;2656
84;Auvergne-Rhône-Alpes;69;1;00;233;Saint-Romain-au-Mont-d'Or;1228;50;1278
84;Auvergne-Rhône-Alpes;69;2;10;234;Saint-Romain-de-Popey;1583;73;1656
84;Auvergne-Rhône-Alpes;69;1;08;235;Saint-Romain-en-Gal;1967;106;2073
84;Auvergne-Rhône-Alpes;69;1;08;236;Saint-Romain-en-Gier;590;7;597
84;Auvergne-Rhône-Alpes;69;1;12;238;Saint-Symphorien-sur-Coise;3710;96;3806
84;Auvergne-Rhône-Alpes;69;2;04;239;Saint-Vérand;1212;25;1237
84;Auvergne-Rhône-Alpes;69;2;11;240;Saint-Vincent-de-Reins;617;6;623
84;Auvergne-Rhône-Alpes;69;1;09;241;Taluyers;2590;61;2651
84;Auvergne-Rhône-Alpes;69;2;03;242;Taponas;927;13;940
84;Auvergne-Rhône-Alpes;69;2;10;243;Tarare;10490;273;10763
84;Auvergne-Rhône-Alpes;69;1;00;244;Tassin-la-Demi-Lune;22286;351;22637
84;Auvergne-Rhône-Alpes;69;2;04;245;Ternand;710;25;735
84;Auvergne-Rhône-Alpes;69;2;04;246;Theizé;1295;35;1330
84;Auvergne-Rhône-Alpes;69;2;11;248;Thizy-les-Bourgs;6020;126;6146
84;Auvergne-Rhône-Alpes;69;1;12;249;Thurins;3053;63;3116
84;Auvergne-Rhône-Alpes;69;1;00;250;La Tour-de-Salvagny;4117;99;4216
84;Auvergne-Rhône-Alpes;69;1;08;252;Trèves;745;9;754
84;Auvergne-Rhône-Alpes;69;1;08;253;Tupin-et-Semons;637;10;647
84;Auvergne-Rhône-Alpes;69;2;10;254;Valsonne;971;10;981
84;Auvergne-Rhône-Alpes;69;1;12;255;Vaugneray;6080;111;6191
84;Auvergne-Rhône-Alpes;69;1;00;256;Vaulx-en-Velin;52795;221;53016
84;Auvergne-Rhône-Alpes;69;2;07;257;Vaux-en-Beaujolais;1086;19;1105
84;Auvergne-Rhône-Alpes;69;2;03;258;Vauxrenard;322;7;329
84;Auvergne-Rhône-Alpes;69;1;00;259;Vénissieux;67285;266;67551
84;Auvergne-Rhône-Alpes;69;1;00;260;Vernaison;4999;56;5055
84;Auvergne-Rhône-Alpes;69;2;03;261;Vernay;104;1;105
84;Auvergne-Rhône-Alpes;69;1;02;263;Villechenève;881;19;900
84;Auvergne-Rhône-Alpes;69;2;13;264;Villefranche-sur-Saône;36291;419;36710
84;Auvergne-Rhône-Alpes;69;2;04;265;Ville-sur-Jarnioux;802;33;835
84;Auvergne-Rhône-Alpes;69;1;00;266;Villeurbanne;152212;1082;153294
84;Auvergne-Rhône-Alpes;69;2;03;267;Villié-Morgon;2137;114;2251
84;Auvergne-Rhône-Alpes;69;1;05;268;Vourles;3367;91;3458
84;Auvergne-Rhône-Alpes;69;1;12;269;Yzeron;992;24;1016
84;Auvergne-Rhône-Alpes;69;1;09;270;Chaponnay;4355;67;4422
84;Auvergne-Rhône-Alpes;69;1;00;271;Chassieu;10638;152;10790
84;Auvergne-Rhône-Alpes;69;1;09;272;Communay;4242;85;4327
84;Auvergne-Rhône-Alpes;69;1;00;273;Corbas;11196;73;11269
84;Auvergne-Rhône-Alpes;69;1;00;275;Décines-Charpieu;28930;139;29069
84;Auvergne-Rhône-Alpes;69;1;00;276;Feyzin;9902;52;9954
84;Auvergne-Rhône-Alpes;69;1;06;277;Genas;13181;221;13402
84;Auvergne-Rhône-Alpes;69;1;00;278;Genay;5509;105;5614
84;Auvergne-Rhône-Alpes;69;1;00;279;Jonage;6076;76;6152
84;Auvergne-Rhône-Alpes;69;1;06;280;Jons;1528;13;1541
84;Auvergne-Rhône-Alpes;69;1;09;281;Marennes;1912;23;1935
84;Auvergne-Rhône-Alpes;69;1;00;282;Meyzieu;34640;301;34941
84;Auvergne-Rhône-Alpes;69;1;00;283;Mions;13707;146;13853
84;Auvergne-Rhône-Alpes;69;1;00;284;Montanay;3230;116;3346
84;Auvergne-Rhône-Alpes;69;1;06;285;Pusignan;4191;38;4229
84;Auvergne-Rhône-Alpes;69;1;00;286;Rillieux-la-Pape;30697;366;31063
84;Auvergne-Rhône-Alpes;69;1;06;287;Saint-Bonnet-de-Mure;6875;108;6983
84;Auvergne-Rhône-Alpes;69;1;06;288;Saint-Laurent-de-Mure;5458;67;5525
84;Auvergne-Rhône-Alpes;69;1;06;289;Saint-Pierre-de-Chandieu;4579;82;4661
84;Auvergne-Rhône-Alpes;69;1;00;290;Saint-Priest;46927;284;47211
84;Auvergne-Rhône-Alpes;69;1;09;291;Saint-Symphorien-d'Ozon;5789;56;5845
84;Auvergne-Rhône-Alpes;69;1;00;292;Sathonay-Camp;6497;63;6560
84;Auvergne-Rhône-Alpes;69;1;00;293;Sathonay-Village;2369;48;2417
84;Auvergne-Rhône-Alpes;69;1;09;294;Sérézin-du-Rhône;2772;37;2809
84;Auvergne-Rhône-Alpes;69;1;09;295;Simandres;1810;9;1819
84;Auvergne-Rhône-Alpes;69;1;00;296;Solaize;2986;33;3019
84;Auvergne-Rhône-Alpes;69;1;09;297;Ternay;5512;74;5586
84;Auvergne-Rhône-Alpes;69;1;06;298;Toussieu;3188;28;3216
84;Auvergne-Rhône-Alpes;69;1;06;299;Colombier-Saugnieu;2700;42;2742
84;Auvergne-Rhône-Alpes;69;1;00;381;Lyon 1er Arrondissement;29641;782;30423
84;Auvergne-Rhône-Alpes;69;1;00;382;Lyon 2e Arrondissement;31303;386;31689
84;Auvergne-Rhône-Alpes;69;1;00;383;Lyon 3e Arrondissement;102725;1006;103731
84;Auvergne-Rhône-Alpes;69;1;00;384;Lyon 4e Arrondissement;36064;406;36470
84;Auvergne-Rhône-Alpes;69;1;00;385;Lyon 5e Arrondissement;49664;1085;50749
84;Auvergne-Rhône-Alpes;69;1;00;386;Lyon 6e Arrondissement;52862;884;53746
84;Auvergne-Rhône-Alpes;69;1;00;387;Lyon 7e Arrondissement;82573;493;83066
84;Auvergne-Rhône-Alpes;69;1;00;388;Lyon 8e Arrondissement;86154;1022;87176
84;Auvergne-Rhône-Alpes;69;1;00;389;Lyon 9e Arrondissement;51983;537;52520
27;Bourgogne-Franche-Comté;70;1;13;001;Abelcourt;357;4;361
27;Bourgogne-Franche-Comté;70;2;05;002;Aboncourt-Gesincourt;209;7;216
27;Bourgogne-Franche-Comté;70;2;01;003;Achey;69;2;71
27;Bourgogne-Franche-Comté;70;1;06;004;Adelans-et-le-Val-de-Bithaine;307;2;309
27;Bourgogne-Franche-Comté;70;1;17;005;Aillevans;134;2;136
27;Bourgogne-Franche-Comté;70;1;13;006;Aillevillers-et-Lyaumont;1490;102;1592
27;Bourgogne-Franche-Comté;70;1;08;007;Ailloncourt;304;6;310
27;Bourgogne-Franche-Comté;70;1;13;008;Ainvelle;148;2;150
27;Bourgogne-Franche-Comté;70;2;05;009;Aisey-et-Richecourt;102;1;103
27;Bourgogne-Franche-Comté;70;1;05;010;Alaincourt;104;1;105
27;Bourgogne-Franche-Comté;70;1;10;011;Amage;317;4;321
27;Bourgogne-Franche-Comté;70;2;11;012;Amance;656;11;667
27;Bourgogne-Franche-Comté;70;1;05;013;Ambiévillers;67;0;67
27;Bourgogne-Franche-Comté;70;1;07;014;Amblans-et-Velotte;399;6;405
27;Bourgogne-Franche-Comté;70;2;11;015;Amoncourt;274;6;280
27;Bourgogne-Franche-Comté;70;1;10;016;Amont-et-Effreney;162;2;164
27;Bourgogne-Franche-Comté;70;1;11;017;Anchenoncourt-et-Chazel;240;2;242
27;Bourgogne-Franche-Comté;70;2;02;018;Ancier;512;4;516
27;Bourgogne-Franche-Comté;70;2;15;019;Andelarre;143;4;147
27;Bourgogne-Franche-Comté;70;2;15;020;Andelarrot;244;2;246
27;Bourgogne-Franche-Comté;70;1;07;021;Andornay;191;5;196
27;Bourgogne-Franche-Comté;70;2;02;022;Angirey;147;3;150
27;Bourgogne-Franche-Comté;70;1;11;023;Anjeux;143;3;146
27;Bourgogne-Franche-Comté;70;2;02;024;Apremont;446;14;460
27;Bourgogne-Franche-Comté;70;2;05;025;Arbecey;242;4;246
27;Bourgogne-Franche-Comté;70;2;02;026;Arc-lès-Gray;2533;26;2559
27;Bourgogne-Franche-Comté;70;2;01;027;Argillières;71;1;72
27;Bourgogne-Franche-Comté;70;2;14;028;Aroz;143;3;146
27;Bourgogne-Franche-Comté;70;1;07;029;Arpenans;239;2;241
27;Bourgogne-Franche-Comté;70;2;09;030;Arsans;45;1;46
27;Bourgogne-Franche-Comté;70;1;17;031;Athesans-Étroitefontaine;644;17;661
27;Bourgogne-Franche-Comté;70;2;01;032;Attricourt;45;0;45
27;Bourgogne-Franche-Comté;70;2;05;035;Augicourt;177;4;181
27;Bourgogne-Franche-Comté;70;2;12;036;Aulx-lès-Cromary;159;2;161
27;Bourgogne-Franche-Comté;70;2;01;037;Autet;258;21;279
27;Bourgogne-Franche-Comté;70;2;12;038;Authoison;315;9;324
27;Bourgogne-Franche-Comté;70;2;09;039;Autoreille;355;4;359
27;Bourgogne-Franche-Comté;70;2;17;040;Autrey-lès-Cerre;239;3;242
27;Bourgogne-Franche-Comté;70;2;01;041;Autrey-lès-Gray;377;9;386
27;Bourgogne-Franche-Comté;70;1;17;042;Autrey-le-Vay;103;1;104
27;Bourgogne-Franche-Comté;70;2;01;043;Auvet-et-la-Chapelotte;237;3;240
27;Bourgogne-Franche-Comté;70;2;11;044;Auxon;408;12;420
27;Bourgogne-Franche-Comté;70;2;09;045;Avrigney-Virey;419;7;426
27;Bourgogne-Franche-Comté;70;1;07;046;Les Aynans;367;7;374
27;Bourgogne-Franche-Comté;70;2;14;047;Baignes;107;2;109
27;Bourgogne-Franche-Comté;70;2;09;048;Bard-lès-Pesmes;139;3;142
27;Bourgogne-Franche-Comté;70;2;05;049;Barges;97;2;99
27;Bourgogne-Franche-Comté;70;2;12;050;La Barre;98;0;98
27;Bourgogne-Franche-Comté;70;1;05;051;La Basse-Vaivre;34;0;34
27;Bourgogne-Franche-Comté;70;1;11;052;Bassigney;121;3;124
27;Bourgogne-Franche-Comté;70;2;14;053;Les Bâties;77;1;78
27;Bourgogne-Franche-Comté;70;2;02;054;Battrans;241;4;245
27;Bourgogne-Franche-Comté;70;1;08;055;Baudoncourt;500;7;507
27;Bourgogne-Franche-Comté;70;2;11;056;Baulay;310;1;311
27;Bourgogne-Franche-Comté;70;2;09;057;Bay;149;2;151
27;Bourgogne-Franche-Comté;70;2;14;058;Beaujeu-Saint-Vallier-Pierrejux-et-Quitteur;931;14;945
27;Bourgogne-Franche-Comté;70;2;12;059;Beaumotte-Aubertans;470;8;478
27;Bourgogne-Franche-Comté;70;2;09;060;Beaumotte-lès-Pin;294;3;297
27;Bourgogne-Franche-Comté;70;1;10;061;Belfahy;85;0;85
27;Bourgogne-Franche-Comté;70;1;10;062;Belmont;142;5;147
27;Bourgogne-Franche-Comté;70;1;10;063;Belonchamp;210;3;213
27;Bourgogne-Franche-Comté;70;1;04;064;Belverne;149;3;152
27;Bourgogne-Franche-Comté;70;2;12;065;Besnans;77;1;78
27;Bourgogne-Franche-Comté;70;2;05;066;Betaucourt;180;1;181
27;Bourgogne-Franche-Comté;70;1;06;067;Betoncourt-lès-Brotte;126;0;126
27;Bourgogne-Franche-Comté;70;1;11;069;Betoncourt-Saint-Pancras;46;0;46
27;Bourgogne-Franche-Comté;70;2;05;070;Betoncourt-sur-Mance;28;2;30
27;Bourgogne-Franche-Comté;70;1;10;071;Beulotte-Saint-Laurent;56;0;56
27;Bourgogne-Franche-Comté;70;1;17;072;Beveuge;83;2;85
27;Bourgogne-Franche-Comté;70;2;05;074;Blondefontaine;244;3;247
27;Bourgogne-Franche-Comté;70;2;09;075;Bonboillon;199;2;201
27;Bourgogne-Franche-Comté;70;2;09;076;Bonnevent-Velloreille;376;8;384
27;Bourgogne-Franche-Comté;70;2;17;077;Borey;221;4;225
27;Bourgogne-Franche-Comté;70;2;05;078;Bougey;93;2;95
27;Bourgogne-Franche-Comté;70;2;11;079;Bougnon;524;12;536
27;Bourgogne-Franche-Comté;70;2;01;080;Bouhans-et-Feurg;238;4;242
27;Bourgogne-Franche-Comté;70;1;06;081;Bouhans-lès-Lure;324;4;328
27;Bourgogne-Franche-Comté;70;2;12;082;Bouhans-lès-Montbozon;130;2;132
27;Bourgogne-Franche-Comté;70;1;11;083;Bouligney;404;10;414
27;Bourgogne-Franche-Comté;70;2;12;084;Boulot;663;10;673
27;Bourgogne-Franche-Comté;70;2;12;085;Boult;680;13;693
27;Bourgogne-Franche-Comté;70;2;05;086;Bourbévelle;75;0;75
27;Bourgogne-Franche-Comté;70;2;11;087;Bourguignon-lès-Conflans;147;3;150
27;Bourgogne-Franche-Comté;70;2;14;088;Bourguignon-lès-la-Charité;117;2;119
27;Bourgogne-Franche-Comté;70;2;05;089;Bourguignon-lès-Morey;46;0;46
27;Bourgogne-Franche-Comté;70;2;14;090;Boursières;60;2;62
27;Bourgogne-Franche-Comté;70;2;05;091;Bousseraucourt;47;1;48
27;Bourgogne-Franche-Comté;70;2;09;092;Bresilley;177;3;180
27;Bourgogne-Franche-Comté;70;1;08;093;Breuches;654;8;662
27;Bourgogne-Franche-Comté;70;1;10;094;Breuchotte;301;5;306
27;Bourgogne-Franche-Comté;70;2;11;095;Breurey-lès-Faverney;654;11;665
27;Bourgogne-Franche-Comté;70;1;03;096;Brevilliers;635;17;652
27;Bourgogne-Franche-Comté;70;1;13;097;Briaucourt;238;8;246
27;Bourgogne-Franche-Comté;70;1;08;098;Brotte-lès-Luxeuil;211;4;215
27;Bourgogne-Franche-Comté;70;2;01;099;Brotte-lès-Ray;76;1;77
27;Bourgogne-Franche-Comté;70;2;01;100;Broye-les-Loups-et-Verfontaine;133;0;133
27;Bourgogne-Franche-Comté;70;2;09;101;Broye-Aubigney-Montseugny;501;5;506
27;Bourgogne-Franche-Comté;70;2;09;102;Brussey;277;10;287
27;Bourgogne-Franche-Comté;70;1;10;103;La Bruyère;221;3;224
27;Bourgogne-Franche-Comté;70;2;09;104;Bucey-lès-Gy;590;13;603
27;Bourgogne-Franche-Comté;70;2;14;105;Bucey-lès-Traves;137;1;138
27;Bourgogne-Franche-Comté;70;2;11;106;Buffignécourt;113;2;115
27;Bourgogne-Franche-Comté;70;2;12;107;Bussières;437;4;441
27;Bourgogne-Franche-Comté;70;2;12;109;Buthiers;306;2;308
27;Bourgogne-Franche-Comté;70;2;17;111;Calmoutier;275;3;278
27;Bourgogne-Franche-Comté;70;2;05;112;Cemboing;174;5;179
27;Bourgogne-Franche-Comté;70;2;12;113;Cenans;132;3;135
27;Bourgogne-Franche-Comté;70;2;05;114;Cendrecourt;205;2;207
27;Bourgogne-Franche-Comté;70;2;17;115;Cerre-lès-Noroy;236;5;241
27;Bourgogne-Franche-Comté;70;1;03;116;Chagey;617;12;629
27;Bourgogne-Franche-Comté;70;1;03;117;Châlonvillars;1238;33;1271
27;Bourgogne-Franche-Comté;70;2;12;118;Chambornay-lès-Bellevaux;194;2;196
27;Bourgogne-Franche-Comté;70;2;09;119;Chambornay-lès-Pin;357;12;369
27;Bourgogne-Franche-Comté;70;1;03;120;Champagney;3745;72;3817
27;Bourgogne-Franche-Comté;70;1;04;121;Champey;878;16;894
27;Bourgogne-Franche-Comté;70;2;01;122;Champlitte;1633;32;1665
27;Bourgogne-Franche-Comté;70;2;02;124;Champtonnay;92;1;93
27;Bourgogne-Franche-Comté;70;2;02;125;Champvans;176;2;178
27;Bourgogne-Franche-Comté;70;2;09;126;Chancey;197;6;203
27;Bourgogne-Franche-Comté;70;2;14;127;Chantes;110;6;116
27;Bourgogne-Franche-Comté;70;1;08;128;La Chapelle-lès-Luxeuil;387;3;390
27;Bourgogne-Franche-Comté;70;2;14;129;La Chapelle-Saint-Quillain;162;3;165
27;Bourgogne-Franche-Comté;70;2;09;130;Charcenne;318;8;326
27;Bourgogne-Franche-Comté;70;2;01;132;Chargey-lès-Gray;704;67;771
27;Bourgogne-Franche-Comté;70;2;05;133;Chargey-lès-Port;235;7;242
27;Bourgogne-Franche-Comté;70;2;15;134;Chariez;204;2;206
27;Bourgogne-Franche-Comté;70;2;05;135;Charmes-Saint-Valbert;34;1;35
27;Bourgogne-Franche-Comté;70;2;15;136;Charmoille;489;9;498
27;Bourgogne-Franche-Comté;70;2;12;137;Chassey-lès-Montbozon;215;8;223
27;Bourgogne-Franche-Comté;70;2;14;138;Chassey-lès-Scey;124;3;127
27;Bourgogne-Franche-Comté;70;1;06;140;Châteney;67;1;68
27;Bourgogne-Franche-Comté;70;1;06;141;Châtenois;118;2;120
27;Bourgogne-Franche-Comté;70;2;09;142;Chaumercenne;190;2;192
27;Bourgogne-Franche-Comté;70;2;05;143;Chauvirey-le-Châtel;124;6;130
27;Bourgogne-Franche-Comté;70;2;05;144;Chauvirey-le-Vieil;33;1;34
27;Bourgogne-Franche-Comté;70;2;12;145;Chaux-la-Lotière;480;10;490
27;Bourgogne-Franche-Comté;70;2;11;146;Chaux-lès-Port;164;4;168
27;Bourgogne-Franche-Comté;70;1;04;147;Chavanne;228;4;232
27;Bourgogne-Franche-Comté;70;2;14;148;Chemilly;86;1;87
27;Bourgogne-Franche-Comté;70;1;04;149;Chenebier;693;17;710
27;Bourgogne-Franche-Comté;70;2;09;150;Chenevrey-et-Morogne;320;2;322
27;Bourgogne-Franche-Comté;70;2;09;151;Chevigney;36;0;36
27;Bourgogne-Franche-Comté;70;2;09;152;Choye;475;37;512
27;Bourgogne-Franche-Comté;70;2;05;153;Cintrey;96;1;97
27;Bourgogne-Franche-Comté;70;2;12;154;Cirey;371;6;377
27;Bourgogne-Franche-Comté;70;1;08;155;Citers;799;15;814
27;Bourgogne-Franche-Comté;70;2;09;156;Citey;111;1;112
27;Bourgogne-Franche-Comté;70;1;03;157;Clairegoutte;361;10;371
27;Bourgogne-Franche-Comté;70;2;14;158;Clans;105;1;106
27;Bourgogne-Franche-Comté;70;2;12;159;Cognières;89;0;89
27;Bourgogne-Franche-Comté;70;1;04;160;Coisevaux;317;19;336
27;Bourgogne-Franche-Comté;70;2;17;162;Colombe-lès-Vesoul;459;13;472
27;Bourgogne-Franche-Comté;70;2;16;163;Colombier;443;8;451
27;Bourgogne-Franche-Comté;70;2;17;164;Colombotte;89;2;91
27;Bourgogne-Franche-Comté;70;2;05;165;Combeaufontaine;542;42;584
27;Bourgogne-Franche-Comté;70;2;16;166;Comberjon;154;5;159
27;Bourgogne-Franche-Comté;70;2;11;167;Conflandey;353;13;366
27;Bourgogne-Franche-Comté;70;1;13;168;Conflans-sur-Lanterne;620;17;637
27;Bourgogne-Franche-Comté;70;2;05;169;Confracourt;220;5;225
27;Bourgogne-Franche-Comté;70;2;11;170;Contréglise;122;2;124
27;Bourgogne-Franche-Comté;70;1;13;171;Corbenay;1263;29;1292
27;Bourgogne-Franche-Comté;70;1;10;172;La Corbière;109;0;109
27;Bourgogne-Franche-Comté;70;2;12;174;Cordonnet;143;2;145
27;Bourgogne-Franche-Comté;70;2;05;175;Cornot;136;3;139
27;Bourgogne-Franche-Comté;70;1;10;176;Corravillers;191;3;194
27;Bourgogne-Franche-Comté;70;2;05;177;Corre;603;15;618
27;Bourgogne-Franche-Comté;70;1;07;178;La Côte;526;10;536
27;Bourgogne-Franche-Comté;70;2;16;179;Coulevon;168;3;171
27;Bourgogne-Franche-Comté;70;1;17;180;Courchaton;441;10;451
27;Bourgogne-Franche-Comté;70;2;09;181;Courcuire;132;0;132
27;Bourgogne-Franche-Comté;70;1;04;182;Courmont;142;0;142
27;Bourgogne-Franche-Comté;70;2;01;183;Courtesoult-et-Gatey;60;0;60
27;Bourgogne-Franche-Comté;70;1;04;184;Couthenans;707;21;728
27;Bourgogne-Franche-Comté;70;2;02;185;Cresancey;187;9;196
27;Bourgogne-Franche-Comté;70;1;06;186;La Creuse;73;1;74
27;Bourgogne-Franche-Comté;70;1;17;187;Crevans-et-la-Chapelle-lès-Granges;263;3;266
27;Bourgogne-Franche-Comté;70;1;06;188;Creveney;54;1;55
27;Bourgogne-Franche-Comté;70;2;12;189;Cromary;250;4;254
27;Bourgogne-Franche-Comté;70;2;11;190;Cubry-lès-Faverney;181;3;184
27;Bourgogne-Franche-Comté;70;2;09;192;Cugney;206;2;208
27;Bourgogne-Franche-Comté;70;2;09;193;Cult;232;3;235
27;Bourgogne-Franche-Comté;70;1;11;194;Cuve;134;8;142
27;Bourgogne-Franche-Comté;70;1;06;195;Dambenoît-lès-Colombe;272;4;276
27;Bourgogne-Franche-Comté;70;1;11;196;Dampierre-lès-Conflans;250;9;259
27;Bourgogne-Franche-Comté;70;2;12;197;Dampierre-sur-Linotte;794;15;809
27;Bourgogne-Franche-Comté;70;2;01;198;Dampierre-sur-Salon;1240;25;1265
27;Bourgogne-Franche-Comté;70;2;17;199;Dampvalley-lès-Colombe;116;0;116
27;Bourgogne-Franche-Comté;70;1;11;200;Dampvalley-Saint-Pancras;39;1;40
27;Bourgogne-Franche-Comté;70;2;01;201;Delain;209;1;210
27;Bourgogne-Franche-Comté;70;1;05;202;Demangevelle;273;7;280
27;Bourgogne-Franche-Comté;70;2;17;203;La Demie;149;2;151
27;Bourgogne-Franche-Comté;70;2;01;204;Denèvre;156;4;160
27;Bourgogne-Franche-Comté;70;1;03;205;Échavanne;202;2;204
27;Bourgogne-Franche-Comté;70;1;03;206;Échenans-sous-Mont-Vaudois;555;7;562
27;Bourgogne-Franche-Comté;70;2;15;207;Échenoz-la-Méline;3249;69;3318
27;Bourgogne-Franche-Comté;70;2;12;208;Échenoz-le-Sec;292;5;297
27;Bourgogne-Franche-Comté;70;1;10;210;Écromagny;154;5;159
27;Bourgogne-Franche-Comté;70;2;01;211;Écuelle;65;2;67
27;Bourgogne-Franche-Comté;70;1;13;213;Éhuns;225;5;230
27;Bourgogne-Franche-Comté;70;2;11;214;Équevilley;122;5;127
27;Bourgogne-Franche-Comté;70;1;03;215;Errevet;244;11;255
27;Bourgogne-Franche-Comté;70;1;08;216;Esboz-Brest;439;24;463
27;Bourgogne-Franche-Comté;70;1;10;217;Esmoulières;97;1;98
27;Bourgogne-Franche-Comté;70;2;02;218;Esmoulins;134;1;135
27;Bourgogne-Franche-Comté;70;1;17;219;Esprels;735;15;750
27;Bourgogne-Franche-Comté;70;2;02;220;Essertenne-et-Cecey;407;6;413
27;Bourgogne-Franche-Comté;70;1;04;221;Étobon;288;4;292
27;Bourgogne-Franche-Comté;70;2;14;222;Étrelles-et-la-Montbleuse;78;1;79
27;Bourgogne-Franche-Comté;70;2;09;224;Étuz;674;14;688
27;Bourgogne-Franche-Comté;70;2;01;225;Fahy-lès-Autrey;104;2;106
27;Bourgogne-Franche-Comté;70;1;17;226;Fallon;309;3;312
27;Bourgogne-Franche-Comté;70;1;10;227;Faucogney-et-la-Mer;477;15;492
27;Bourgogne-Franche-Comté;70;2;11;228;Faverney;980;11;991
27;Bourgogne-Franche-Comté;70;1;07;229;Faymont;260;6;266
27;Bourgogne-Franche-Comté;70;2;01;230;Fédry;98;4;102
27;Bourgogne-Franche-Comté;70;2;01;231;Ferrières-lès-Ray;35;0;35
27;Bourgogne-Franche-Comté;70;2;14;232;Ferrières-lès-Scey;130;5;135
27;Bourgogne-Franche-Comté;70;1;10;233;Les Fessey;135;2;137
27;Bourgogne-Franche-Comté;70;2;12;234;Filain;226;11;237
27;Bourgogne-Franche-Comté;70;2;11;235;Flagy;145;4;149
27;Bourgogne-Franche-Comté;70;2;11;236;Fleurey-lès-Faverney;467;9;476
27;Bourgogne-Franche-Comté;70;2;01;237;Fleurey-lès-Lavoncourt;97;0;97
27;Bourgogne-Franche-Comté;70;1;13;238;Fleurey-lès-Saint-Loup;137;4;141
27;Bourgogne-Franche-Comté;70;2;12;239;Fondremand;201;5;206
27;Bourgogne-Franche-Comté;70;1;13;240;Fontaine-lès-Luxeuil;1327;24;1351
27;Bourgogne-Franche-Comté;70;1;11;242;Fontenois-la-Ville;133;0;133
27;Bourgogne-Franche-Comté;70;2;12;243;Fontenois-lès-Montbozon;337;12;349
27;Bourgogne-Franche-Comté;70;2;05;244;Fouchécourt;111;0;111
27;Bourgogne-Franche-Comté;70;1;88;245;Fougerolles-Saint-Valbert;3797;123;3920
27;Bourgogne-Franche-Comté;70;2;01;247;Fouvent-Saint-Andoche;212;3;215
27;Bourgogne-Franche-Comté;70;1;03;248;Frahier-et-Chatebier;1379;35;1414
27;Bourgogne-Franche-Comté;70;1;13;249;Francalmont;119;3;122
27;Bourgogne-Franche-Comté;70;1;06;250;Franchevelle;451;6;457
27;Bourgogne-Franche-Comté;70;2;01;251;Francourt;100;4;104
27;Bourgogne-Franche-Comté;70;2;01;252;Framont;178;3;181
27;Bourgogne-Franche-Comté;70;2;14;253;Frasne-le-Château;297;28;325
27;Bourgogne-Franche-Comté;70;1;03;254;Frédéric-Fontaine;253;7;260
27;Bourgogne-Franche-Comté;70;2;14;255;Fresne-Saint-Mamès;497;4;501
27;Bourgogne-Franche-Comté;70;1;10;256;Fresse;710;12;722
27;Bourgogne-Franche-Comté;70;2;14;257;Fretigney-et-Velloreille;742;14;756
27;Bourgogne-Franche-Comté;70;1;08;258;Froideconche;1990;46;2036
27;Bourgogne-Franche-Comté;70;1;06;259;Froideterre;370;6;376
27;Bourgogne-Franche-Comté;70;1;07;260;Frotey-lès-Lure;686;20;706
27;Bourgogne-Franche-Comté;70;2;16;261;Frotey-lès-Vesoul;1361;33;1394
27;Bourgogne-Franche-Comté;70;1;07;262;Genevreuille;161;4;165
27;Bourgogne-Franche-Comté;70;1;06;263;Genevrey;238;2;240
27;Bourgogne-Franche-Comté;70;1;17;264;Georfans;50;0;50
27;Bourgogne-Franche-Comté;70;2;02;265;Germigney;151;5;156
27;Bourgogne-Franche-Comté;70;2;05;267;Gevigney-et-Mercey;485;7;492
27;Bourgogne-Franche-Comté;70;2;09;268;Gézier-et-Fontenelay;213;4;217
27;Bourgogne-Franche-Comté;70;1;11;269;Girefontaine;35;1;36
27;Bourgogne-Franche-Comté;70;1;17;271;Gouhenans;374;11;385
27;Bourgogne-Franche-Comté;70;2;05;272;Gourgeon;186;11;197
27;Bourgogne-Franche-Comté;70;1;17;273;Grammont;67;1;68
27;Bourgogne-Franche-Comté;70;2;01;274;Grandecourt;48;0;48
27;Bourgogne-Franche-Comté;70;2;14;275;Grandvelle-et-le-Perrenot;393;5;398
27;Bourgogne-Franche-Comté;70;1;17;276;Granges-la-Ville;184;8;192
27;Bourgogne-Franche-Comté;70;1;17;277;Granges-le-Bourg;381;9;390
27;Bourgogne-Franche-Comté;70;2;11;278;Grattery;215;4;219
27;Bourgogne-Franche-Comté;70;2;02;279;Gray;5553;424;5977
27;Bourgogne-Franche-Comté;70;2;02;280;Gray-la-Ville;937;36;973
27;Bourgogne-Franche-Comté;70;2;09;282;Gy;1012;20;1032
27;Bourgogne-Franche-Comté;70;1;10;283;Haut-du-Them-Château-Lambert;442;7;449
27;Bourgogne-Franche-Comté;70;1;13;284;Hautevelle;268;8;276
27;Bourgogne-Franche-Comté;70;1;97;285;Héricourt;10646;272;10918
27;Bourgogne-Franche-Comté;70;2;09;286;Hugier;128;3;131
27;Bourgogne-Franche-Comté;70;1;05;287;Hurecourt;44;0;44
27;Bourgogne-Franche-Comté;70;2;12;288;Hyet;120;1;121
27;Bourgogne-Franche-Comté;70;2;02;289;Igny;210;2;212
27;Bourgogne-Franche-Comté;70;1;11;290;Jasney;203;6;209
27;Bourgogne-Franche-Comté;70;2;05;291;Jonvelle;124;3;127
27;Bourgogne-Franche-Comté;70;2;05;292;Jussey;1548;34;1582
27;Bourgogne-Franche-Comté;70;2;05;293;Lambrey;77;2;79
27;Bourgogne-Franche-Comté;70;1;10;294;Lantenot;357;4;361
27;Bourgogne-Franche-Comté;70;1;10;295;La Lanterne-et-les-Armonts;220;5;225
27;Bourgogne-Franche-Comté;70;2;12;296;Larians-et-Munans;271;2;273
27;Bourgogne-Franche-Comté;70;2;01;297;Larret;60;0;60
27;Bourgogne-Franche-Comté;70;2;05;298;Lavigney;117;0;117
27;Bourgogne-Franche-Comté;70;2;01;299;Lavoncourt;311;2;313
27;Bourgogne-Franche-Comté;70;2;14;301;Lieffrans;56;0;56
27;Bourgogne-Franche-Comté;70;2;09;302;Lieucourt;77;1;78
27;Bourgogne-Franche-Comté;70;2;17;303;Liévans;153;1;154
27;Bourgogne-Franche-Comté;70;1;06;304;Linexert;122;1;123
27;Bourgogne-Franche-Comté;70;2;01;305;Lœuilley;103;2;105
27;Bourgogne-Franche-Comté;70;1;07;306;Lomont;460;13;473
27;Bourgogne-Franche-Comté;70;1;17;307;Longevelle;124;7;131
27;Bourgogne-Franche-Comté;70;1;10;308;La Longine;222;6;228
27;Bourgogne-Franche-Comté;70;2;12;309;Loulans-Verchamp;453;10;463
27;Bourgogne-Franche-Comté;70;1;98;310;Lure;8046;185;8231
27;Bourgogne-Franche-Comté;70;1;08;311;Luxeuil-les-Bains;6623;273;6896
27;Bourgogne-Franche-Comté;70;1;03;312;Luze;759;21;780
27;Bourgogne-Franche-Comté;70;1;07;313;Lyoffans;395;5;400
27;Bourgogne-Franche-Comté;70;1;10;314;Magnivray;168;6;174
27;Bourgogne-Franche-Comté;70;1;13;315;Magnoncourt;408;11;419
27;Bourgogne-Franche-Comté;70;2;12;316;Le Magnoray;83;4;87
27;Bourgogne-Franche-Comté;70;1;17;317;Les Magny;141;4;145
27;Bourgogne-Franche-Comté;70;1;07;318;Magny-Danigon;431;15;446
27;Bourgogne-Franche-Comté;70;1;07;319;Magny-Jobert;124;3;127
27;Bourgogne-Franche-Comté;70;2;05;320;Magny-lès-Jussey;98;3;101
27;Bourgogne-Franche-Comté;70;1;07;321;Magny-Vernois;1400;29;1429
27;Bourgogne-Franche-Comté;70;1;13;322;Mailleroncourt-Charette;284;6;290
27;Bourgogne-Franche-Comté;70;1;11;323;Mailleroncourt-Saint-Pancras;197;1;198
27;Bourgogne-Franche-Comté;70;2;14;324;Mailley-et-Chazelot;645;15;660
27;Bourgogne-Franche-Comté;70;2;12;325;Maizières;372;3;375
27;Bourgogne-Franche-Comté;70;2;12;326;La Malachère;309;3;312
27;Bourgogne-Franche-Comté;70;2;09;327;Malans;134;3;137
27;Bourgogne-Franche-Comté;70;1;06;328;Malbouhans;327;6;333
27;Bourgogne-Franche-Comté;70;2;05;329;Malvillers;61;4;65
27;Bourgogne-Franche-Comté;70;1;03;330;Mandrevillars;287;7;294
27;Bourgogne-Franche-Comté;70;2;02;331;Mantoche;440;20;460
27;Bourgogne-Franche-Comté;70;1;17;332;Marast;56;1;57
27;Bourgogne-Franche-Comté;70;2;09;334;Marnay;1508;24;1532
27;Bourgogne-Franche-Comté;70;2;12;335;Maussans;62;2;64
27;Bourgogne-Franche-Comté;70;1;17;336;Mélecey;137;3;140
27;Bourgogne-Franche-Comté;70;2;05;337;Melin;59;1;60
27;Bourgogne-Franche-Comté;70;1;11;338;Melincourt;228;7;235
27;Bourgogne-Franche-Comté;70;1;10;339;Mélisey;1674;31;1705
27;Bourgogne-Franche-Comté;70;2;01;340;Membrey;214;27;241
27;Bourgogne-Franche-Comté;70;2;11;341;Menoux;300;3;303
27;Bourgogne-Franche-Comté;70;2;14;342;Mercey-sur-Saône;136;1;137
27;Bourgogne-Franche-Comté;70;2;11;343;Mersuay;285;5;290
27;Bourgogne-Franche-Comté;70;1;13;344;Meurcourt;339;9;348
27;Bourgogne-Franche-Comté;70;1;17;347;Mignavillers;356;8;364
27;Bourgogne-Franche-Comté;70;1;07;348;Moffans-et-Vacheresse;620;12;632
27;Bourgogne-Franche-Comté;70;1;17;349;Moimay;235;3;238
27;Bourgogne-Franche-Comté;70;2;05;350;Molay;65;0;65
27;Bourgogne-Franche-Comté;70;1;07;351;Mollans;228;3;231
27;Bourgogne-Franche-Comté;70;1;10;352;La Montagne;37;0;37
27;Bourgogne-Franche-Comté;70;2;09;353;Montagney;503;8;511
27;Bourgogne-Franche-Comté;70;2;12;355;Montarlot-lès-Rioz;302;4;306
27;Bourgogne-Franche-Comté;70;2;09;356;Montboillon;278;6;284
27;Bourgogne-Franche-Comté;70;2;12;357;Montbozon;543;87;630
27;Bourgogne-Franche-Comté;70;2;16;358;Montcey;272;4;276
27;Bourgogne-Franche-Comté;70;2;05;359;Montcourt;55;0;55
27;Bourgogne-Franche-Comté;70;1;05;360;Montdoré;78;1;79
27;Bourgogne-Franche-Comté;70;1;10;361;Montessaux;158;5;163
27;Bourgogne-Franche-Comté;70;2;05;362;Montigny-lès-Cherlieu;138;4;142
27;Bourgogne-Franche-Comté;70;2;15;363;Montigny-lès-Vesoul;645;15;660
27;Bourgogne-Franche-Comté;70;2;17;364;Montjustin-et-Velotte;119;1;120
27;Bourgogne-Franche-Comté;70;2;09;366;Villers-Chemin-et-Mont-lès-Étrelles;123;0;123
27;Bourgogne-Franche-Comté;70;2;15;367;Mont-le-Vernois;184;4;188
27;Bourgogne-Franche-Comté;70;2;01;368;Montot;132;3;135
27;Bourgogne-Franche-Comté;70;2;01;369;Mont-Saint-Léger;48;0;48
27;Bourgogne-Franche-Comté;70;2;01;371;Montureux-et-Prantigny;203;1;204
27;Bourgogne-Franche-Comté;70;2;11;372;Montureux-lès-Baulay;152;4;156
27;Bourgogne-Franche-Comté;70;2;05;373;La Roche-Morey;285;4;289
27;Bourgogne-Franche-Comté;70;2;09;374;Motey-Besuche;95;2;97
27;Bourgogne-Franche-Comté;70;2;02;376;Nantilly;463;10;473
27;Bourgogne-Franche-Comté;70;2;16;378;Navenne;1623;50;1673
27;Bourgogne-Franche-Comté;70;2;13;380;Neurey-en-Vaux;176;4;180
27;Bourgogne-Franche-Comté;70;2;17;381;Neurey-lès-la-Demie;341;10;351
27;Bourgogne-Franche-Comté;70;2;12;383;Neuvelle-lès-Cromary;417;4;421
27;Bourgogne-Franche-Comté;70;2;14;384;Neuvelle-lès-la-Charité;224;3;227
27;Bourgogne-Franche-Comté;70;1;06;385;La Neuvelle-lès-Lure;333;10;343
27;Bourgogne-Franche-Comté;70;2;05;386;La Neuvelle-lès-Scey;177;2;179
27;Bourgogne-Franche-Comté;70;2;14;387;Noidans-le-Ferroux;662;10;672
27;Bourgogne-Franche-Comté;70;2;15;388;Noidans-lès-Vesoul;1978;75;2053
27;Bourgogne-Franche-Comté;70;2;02;389;Noiron;58;2;60
27;Bourgogne-Franche-Comté;70;2;17;390;Noroy-le-Bourg;502;11;513
27;Bourgogne-Franche-Comté;70;2;05;392;Oigney;34;2;36
27;Bourgogne-Franche-Comté;70;2;14;393;Oiselay-et-Grachaux;430;6;436
27;Bourgogne-Franche-Comté;70;2;02;394;Onay;60;4;64
27;Bourgogne-Franche-Comté;70;1;17;395;Oppenans;52;0;52
27;Bourgogne-Franche-Comté;70;1;17;396;Oricourt;39;2;41
27;Bourgogne-Franche-Comté;70;2;12;397;Ormenans;81;0;81
27;Bourgogne-Franche-Comté;70;1;08;398;Ormoiche;66;0;66
27;Bourgogne-Franche-Comté;70;2;05;399;Ormoy;208;7;215
27;Bourgogne-Franche-Comté;70;2;05;400;Ouge;108;2;110
27;Bourgogne-Franche-Comté;70;2;14;401;Ovanches;132;1;133
27;Bourgogne-Franche-Comté;70;2;01;402;Oyrières;371;11;382
27;Bourgogne-Franche-Comté;70;1;07;403;Palante;243;3;246
27;Bourgogne-Franche-Comté;70;1;05;404;Passavant-la-Rochère;576;16;592
27;Bourgogne-Franche-Comté;70;2;12;405;Pennesières;194;4;198
27;Bourgogne-Franche-Comté;70;2;01;406;Percey-le-Grand;76;1;77
27;Bourgogne-Franche-Comté;70;2;12;407;Perrouse;272;5;277
27;Bourgogne-Franche-Comté;70;2;09;408;Pesmes;1068;29;1097
27;Bourgogne-Franche-Comté;70;2;01;409;Pierrecourt;115;2;117
27;Bourgogne-Franche-Comté;70;2;09;410;Pin;699;3;702
27;Bourgogne-Franche-Comté;70;1;11;411;La Pisseure;38;0;38
27;Bourgogne-Franche-Comté;70;1;11;412;Plainemont;71;0;71
27;Bourgogne-Franche-Comté;70;1;03;413;Plancher-Bas;1903;36;1939
27;Bourgogne-Franche-Comté;70;1;03;414;Plancher-les-Mines;960;15;975
27;Bourgogne-Franche-Comté;70;2;11;415;Polaincourt-et-Clairefontaine;658;9;667
27;Bourgogne-Franche-Comté;70;1;07;416;Pomoy;204;5;209
27;Bourgogne-Franche-Comté;70;2;14;417;Pontcey;306;3;309
27;Bourgogne-Franche-Comté;70;2;14;418;La Romaine;518;4;522
27;Bourgogne-Franche-Comté;70;1;05;419;Pont-du-Bois;107;4;111
27;Bourgogne-Franche-Comté;70;1;17;420;Pont-sur-l'Ognon;63;0;63
27;Bourgogne-Franche-Comté;70;2;11;421;Port-sur-Saône;2954;55;3009
27;Bourgogne-Franche-Comté;70;2;01;422;Poyans;145;1;146
27;Bourgogne-Franche-Comté;70;2;05;423;Preigney;113;3;116
27;Bourgogne-Franche-Comté;70;1;10;425;La Proiselière-et-Langle;148;6;154
27;Bourgogne-Franche-Comté;70;2;11;426;Provenchère;251;7;258
27;Bourgogne-Franche-Comté;70;2;05;427;Purgerot;335;9;344
27;Bourgogne-Franche-Comté;70;2;15;428;Pusey;1455;49;1504
27;Bourgogne-Franche-Comté;70;2;15;429;Pusy-et-Épenoux;547;14;561
27;Bourgogne-Franche-Comté;70;2;05;430;La Quarte;69;1;70
27;Bourgogne-Franche-Comté;70;2;12;431;Quenoche;249;3;252
27;Bourgogne-Franche-Comté;70;1;06;432;Quers;326;7;333
27;Bourgogne-Franche-Comté;70;2;16;433;Quincey;1396;38;1434
27;Bourgogne-Franche-Comté;70;1;10;435;Raddon-et-Chapendu;829;22;851
27;Bourgogne-Franche-Comté;70;2;05;436;Raincourt;116;0;116
27;Bourgogne-Franche-Comté;70;2;05;437;Ranzevelle;16;0;16
27;Bourgogne-Franche-Comté;70;2;01;438;Ray-sur-Saône;212;3;215
27;Bourgogne-Franche-Comté;70;2;14;439;Raze;355;7;362
27;Bourgogne-Franche-Comté;70;2;01;440;Recologne;33;2;35
27;Bourgogne-Franche-Comté;70;2;12;441;Recologne-lès-Rioz;253;3;256
27;Bourgogne-Franche-Comté;70;2;01;442;Renaucourt;109;3;112
27;Bourgogne-Franche-Comté;70;2;09;443;La Grande-Résie;89;1;90
27;Bourgogne-Franche-Comté;70;2;09;444;La Résie-Saint-Martin;163;1;164
27;Bourgogne-Franche-Comté;70;1;10;445;Rignovelle;115;1;116
27;Bourgogne-Franche-Comté;70;2;01;446;Rigny;604;9;613
27;Bourgogne-Franche-Comté;70;2;12;447;Rioz;2297;75;2372
27;Bourgogne-Franche-Comté;70;2;01;448;Roche-et-Raucourt;152;2;154
27;Bourgogne-Franche-Comté;70;2;12;449;Roche-sur-Linotte-et-Sorans-les-Cordiers;62;0;62
27;Bourgogne-Franche-Comté;70;2;05;450;La Rochelle;40;0;40
27;Bourgogne-Franche-Comté;70;1;06;451;Ronchamp;2735;28;2763
27;Bourgogne-Franche-Comté;70;2;14;452;Rosey;254;3;257
27;Bourgogne-Franche-Comté;70;1;10;453;La Rosière;81;3;84
27;Bourgogne-Franche-Comté;70;2;05;454;Rosières-sur-Mance;48;2;50
27;Bourgogne-Franche-Comté;70;1;07;455;Roye;1493;24;1517
27;Bourgogne-Franche-Comté;70;2;12;456;Ruhans;148;5;153
27;Bourgogne-Franche-Comté;70;2;14;457;Rupt-sur-Saône;107;3;110
27;Bourgogne-Franche-Comté;70;1;10;459;Saint-Barthélemy;1101;25;1126
27;Bourgogne-Franche-Comté;70;1;10;460;Saint-Bresson;430;9;439
27;Bourgogne-Franche-Comté;70;2;02;461;Saint-Broing;116;2;118
27;Bourgogne-Franche-Comté;70;1;17;462;Saint-Ferjeux;80;2;82
27;Bourgogne-Franche-Comté;70;2;14;463;Saint-Gand;144;1;145
27;Bourgogne-Franche-Comté;70;1;06;464;Saint-Germain;1353;23;1376
27;Bourgogne-Franche-Comté;70;2;02;466;Saint-Loup-Nantouard;124;3;127
27;Bourgogne-Franche-Comté;70;1;13;467;Saint-Loup-sur-Semouse;3150;66;3216
27;Bourgogne-Franche-Comté;70;2;05;468;Saint-Marcel;90;1;91
27;Bourgogne-Franche-Comté;70;1;10;469;Sainte-Marie-en-Chanois;211;4;215
27;Bourgogne-Franche-Comté;70;1;13;470;Sainte-Marie-en-Chaux;160;2;162
27;Bourgogne-Franche-Comté;70;2;14;471;Sainte-Reine;25;1;26
27;Bourgogne-Franche-Comté;70;2;11;472;Saint-Rémy-en-Comté;485;4;489
27;Bourgogne-Franche-Comté;70;1;08;473;Saint-Sauveur;1929;32;1961
27;Bourgogne-Franche-Comté;70;1;17;474;Saint-Sulpice;127;2;129
27;Bourgogne-Franche-Comté;70;2;11;476;Saponcourt;65;1;66
27;Bourgogne-Franche-Comté;70;1;04;477;Saulnot;773;13;786
27;Bourgogne-Franche-Comté;70;1;06;478;Saulx;888;15;903
27;Bourgogne-Franche-Comté;70;2;02;479;Sauvigney-lès-Gray;98;4;102
27;Bourgogne-Franche-Comté;70;2;09;480;Sauvigney-lès-Pesmes;134;6;140
27;Bourgogne-Franche-Comté;70;2;01;481;Savoyeux;205;4;209
27;Bourgogne-Franche-Comté;70;2;14;482;Scey-sur-Saône-et-Saint-Albin;1543;25;1568
27;Bourgogne-Franche-Comté;70;2;11;483;Scye;137;5;142
27;Bourgogne-Franche-Comté;70;1;17;484;Secenans;178;3;181
27;Bourgogne-Franche-Comté;70;1;05;485;Selles;202;5;207
27;Bourgogne-Franche-Comté;70;2;05;486;Semmadon;111;3;114
27;Bourgogne-Franche-Comté;70;1;17;487;Senargent-Mignafans;291;3;294
27;Bourgogne-Franche-Comté;70;2;11;488;Senoncourt;194;1;195
27;Bourgogne-Franche-Comté;70;1;10;489;Servance-Miellin;788;6;794
27;Bourgogne-Franche-Comté;70;1;06;490;Servigney;123;1;124
27;Bourgogne-Franche-Comté;70;2;14;491;Seveux-Motey;480;14;494
27;Bourgogne-Franche-Comté;70;2;14;492;Soing-Cubry-Charentenay;579;10;589
27;Bourgogne-Franche-Comté;70;2;12;493;Sorans-lès-Breurey;462;8;470
27;Bourgogne-Franche-Comté;70;2;09;494;Sornay;347;6;353
27;Bourgogne-Franche-Comté;70;2;05;496;Tartécourt;25;1;26
27;Bourgogne-Franche-Comté;70;1;10;498;Ternuay-Melay-et-Saint-Hilaire;460;14;474
27;Bourgogne-Franche-Comté;70;2;01;499;Theuley;103;2;105
27;Bourgogne-Franche-Comté;70;2;12;500;Thieffrans;167;11;178
27;Bourgogne-Franche-Comté;70;2;12;501;Thiénans;98;3;101
27;Bourgogne-Franche-Comté;70;2;01;502;Tincey-et-Pontrebeau;85;0;85
27;Bourgogne-Franche-Comté;70;2;12;503;Traitiéfontaine;162;2;164
27;Bourgogne-Franche-Comté;70;2;14;504;Traves;360;13;373
27;Bourgogne-Franche-Comté;70;2;02;505;Le Tremblois;162;7;169
27;Bourgogne-Franche-Comté;70;1;04;506;Trémoins;388;13;401
27;Bourgogne-Franche-Comté;70;2;12;507;Trésilley;246;6;252
27;Bourgogne-Franche-Comté;70;2;09;509;Tromarey;113;0;113
27;Bourgogne-Franche-Comté;70;2;09;510;Vadans;130;3;133
27;Bourgogne-Franche-Comté;70;2;01;511;Vaite;226;3;229
27;Bourgogne-Franche-Comté;70;1;13;512;La Vaivre;219;5;224
27;Bourgogne-Franche-Comté;70;2;15;513;Vaivre-et-Montoille;2418;55;2473
27;Bourgogne-Franche-Comté;70;2;09;514;Valay;670;11;681
27;Bourgogne-Franche-Comté;70;1;07;515;Le Val-de-Gouhenans;67;1;68
27;Bourgogne-Franche-Comté;70;2;17;516;Vallerois-le-Bois;245;3;248
27;Bourgogne-Franche-Comté;70;2;17;517;Vallerois-Lorioz;395;18;413
27;Bourgogne-Franche-Comté;70;2;11;518;Le Val-Saint-Éloi;98;2;100
27;Bourgogne-Franche-Comté;70;2;12;519;Vandelans;110;0;110
27;Bourgogne-Franche-Comté;70;2;01;520;Vanne;115;3;118
27;Bourgogne-Franche-Comté;70;2;09;521;Vantoux-et-Longevelle;183;4;187
27;Bourgogne-Franche-Comté;70;2;16;522;Varogne;158;3;161
27;Bourgogne-Franche-Comté;70;2;01;523;Vars;197;3;200
27;Bourgogne-Franche-Comté;70;2;11;524;Vauchoux;113;3;116
27;Bourgogne-Franche-Comté;70;2;01;525;Vauconcourt-Nervezain;211;3;214
27;Bourgogne-Franche-Comté;70;1;05;526;Vauvillers;625;14;639
27;Bourgogne-Franche-Comté;70;2;14;527;Vaux-le-Moncelot;75;1;76
27;Bourgogne-Franche-Comté;70;2;02;528;Velesmes-Échevanne;486;9;495
27;Bourgogne-Franche-Comté;70;2;02;529;Velet;385;16;401
27;Bourgogne-Franche-Comté;70;1;17;530;Vellechevreux-et-Courbenans;120;0;120
27;Bourgogne-Franche-Comté;70;2;09;531;Velleclaire;104;1;105
27;Bourgogne-Franche-Comté;70;2;12;532;Vellefaux;519;6;525
27;Bourgogne-Franche-Comté;70;2;09;533;Vellefrey-et-Vellefrange;121;0;121
27;Bourgogne-Franche-Comté;70;2;16;534;Vellefrie;125;1;126
27;Bourgogne-Franche-Comté;70;2;14;535;Velleguindry-et-Levrecey;153;1;154
27;Bourgogne-Franche-Comté;70;2;14;536;Velle-le-Châtel;132;2;134
27;Bourgogne-Franche-Comté;70;1;06;537;Velleminfroy;294;6;300
27;Bourgogne-Franche-Comté;70;2;14;538;Vellemoz;82;0;82
27;Bourgogne-Franche-Comté;70;2;14;539;Vellexon-Queutrey-et-Vaudey;455;12;467
27;Bourgogne-Franche-Comté;70;2;09;540;Velloreille-lès-Choye;80;4;84
27;Bourgogne-Franche-Comté;70;1;13;541;Velorcey;204;4;208
27;Bourgogne-Franche-Comté;70;2;09;542;Venère;209;5;214
27;Bourgogne-Franche-Comté;70;1;17;544;La Vergenne;115;2;117
27;Bourgogne-Franche-Comté;70;2;11;545;Venisey;127;3;130
27;Bourgogne-Franche-Comté;70;2;01;546;Vereux;219;22;241
27;Bourgogne-Franche-Comté;70;1;04;547;Verlans;168;3;171
27;Bourgogne-Franche-Comté;70;2;05;548;Vernois-sur-Mance;141;1;142
27;Bourgogne-Franche-Comté;70;2;14;549;La Vernotte;78;1;79
27;Bourgogne-Franche-Comté;70;2;99;550;Vesoul;14914;749;15663
27;Bourgogne-Franche-Comté;70;1;17;552;Villafans;215;3;218
27;Bourgogne-Franche-Comté;70;1;17;553;Villargent;116;2;118
27;Bourgogne-Franche-Comté;70;2;05;554;Villars-le-Pautel;191;1;192
27;Bourgogne-Franche-Comté;70;1;13;555;La Villedieu-en-Fontenette;171;1;172
27;Bourgogne-Franche-Comté;70;2;09;557;Villefrancon;133;4;137
27;Bourgogne-Franche-Comté;70;2;16;558;La Villeneuve-Bellenoye-et-la-Maize;140;2;142
27;Bourgogne-Franche-Comté;70;2;16;559;Villeparois;195;4;199
27;Bourgogne-Franche-Comté;70;2;12;560;Villers-Bouton;165;2;167
27;Bourgogne-Franche-Comté;70;1;17;561;Villersexel;1423;108;1531
27;Bourgogne-Franche-Comté;70;1;17;562;Villers-la-Ville;154;3;157
27;Bourgogne-Franche-Comté;70;2;17;563;Villers-le-Sec;533;13;546
27;Bourgogne-Franche-Comté;70;1;13;564;Villers-lès-Luxeuil;310;16;326
27;Bourgogne-Franche-Comté;70;2;12;565;Villers-Pater;52;2;54
27;Bourgogne-Franche-Comté;70;2;11;566;Villers-sur-Port;200;5;205
27;Bourgogne-Franche-Comté;70;1;04;567;Villers-sur-Saulnot;134;9;143
27;Bourgogne-Franche-Comté;70;2;01;568;Villers-Vaudey;57;4;61
27;Bourgogne-Franche-Comté;70;2;16;569;Vilory;61;1;62
27;Bourgogne-Franche-Comté;70;1;13;571;Visoncourt;39;3;42
27;Bourgogne-Franche-Comté;70;2;05;572;Vitrey-sur-Mance;290;5;295
27;Bourgogne-Franche-Comté;70;1;10;573;La Voivre;125;1;126
27;Bourgogne-Franche-Comté;70;2;01;574;Volon;57;0;57
27;Bourgogne-Franche-Comté;70;2;12;575;Voray-sur-l'Ognon;841;16;857
27;Bourgogne-Franche-Comté;70;2;05;576;Vougécourt;151;1;152
27;Bourgogne-Franche-Comté;70;1;07;577;Vouhenans;379;9;388
27;Bourgogne-Franche-Comté;70;2;09;578;Vregille;174;2;176
27;Bourgogne-Franche-Comté;70;1;04;579;Vyans-le-Val;428;16;444
27;Bourgogne-Franche-Comté;70;2;14;580;Vy-le-Ferroux;152;5;157
27;Bourgogne-Franche-Comté;70;1;07;581;Vy-lès-Lure;704;16;720
27;Bourgogne-Franche-Comté;70;2;14;582;Vy-lès-Rupt;81;0;81
27;Bourgogne-Franche-Comté;70;2;12;583;Vy-lès-Filain;130;1;131
27;Bourgogne-Franche-Comté;71;4;14;001;L'Abergement-de-Cuisery;799;15;814
27;Bourgogne-Franche-Comté;71;4;24;002;L'Abergement-Sainte-Colombe;1243;20;1263
27;Bourgogne-Franche-Comté;71;2;16;003;Allerey-sur-Saône;795;6;801
27;Bourgogne-Franche-Comté;71;2;24;004;Allériot;1164;25;1189
27;Bourgogne-Franche-Comté;71;2;04;005;Aluze;251;10;261
27;Bourgogne-Franche-Comté;71;3;10;006;Amanzé;185;5;190
27;Bourgogne-Franche-Comté;71;5;11;007;Ameugny;167;4;171
27;Bourgogne-Franche-Comté;71;3;10;008;Anglure-sous-Dun;151;7;158
27;Bourgogne-Franche-Comté;71;1;01;009;Anost;719;14;733
27;Bourgogne-Franche-Comté;71;1;02;010;Antully;864;10;874
27;Bourgogne-Franche-Comté;71;3;25;011;Anzy-le-Duc;444;86;530
27;Bourgogne-Franche-Comté;71;3;25;012;Artaix;331;15;346
27;Bourgogne-Franche-Comté;71;4;26;013;Authumes;272;5;277
27;Bourgogne-Franche-Comté;71;1;96;014;Autun;12987;1022;14009
27;Bourgogne-Franche-Comté;71;1;02;015;Auxy;914;29;943
27;Bourgogne-Franche-Comté;71;5;19;016;Azé;1082;27;1109
27;Bourgogne-Franche-Comté;71;3;09;017;Ballore;95;4;99
27;Bourgogne-Franche-Comté;71;4;14;018;Bantanges;547;11;558
27;Bourgogne-Franche-Comté;71;2;17;019;Barizey;143;7;150
27;Bourgogne-Franche-Comté;71;1;01;020;Barnay;98;2;100
27;Bourgogne-Franche-Comté;71;3;09;021;Baron;291;22;313
27;Bourgogne-Franche-Comté;71;3;10;022;Baudemont;625;9;634
27;Bourgogne-Franche-Comté;71;4;24;023;Baudrières;956;26;982
27;Bourgogne-Franche-Comté;71;3;25;024;Baugy;509;17;526
27;Bourgogne-Franche-Comté;71;3;09;025;Beaubery;358;8;366
27;Bourgogne-Franche-Comté;71;2;29;026;Beaumont-sur-Grosne;337;13;350
27;Bourgogne-Franche-Comté;71;4;26;027;Beaurepaire-en-Bresse;721;7;728
27;Bourgogne-Franche-Comté;71;4;26;028;Beauvernois;106;3;109
27;Bourgogne-Franche-Comté;71;4;26;029;Bellevesvre;292;4;296
27;Bourgogne-Franche-Comté;71;5;11;030;Bergesserin;203;4;207
27;Bourgogne-Franche-Comté;71;5;11;031;Berzé-le-Châtel;59;1;60
27;Bourgogne-Franche-Comté;71;5;19;032;Berzé-la-Ville;690;14;704
27;Bourgogne-Franche-Comté;71;2;16;033;Bey;861;19;880
27;Bourgogne-Franche-Comté;71;2;17;034;Bissey-sous-Cruchaud;335;7;342
27;Bourgogne-Franche-Comté;71;5;19;035;Bissy-la-Mâconnaise;204;3;207
27;Bourgogne-Franche-Comté;71;2;11;036;Bissy-sous-Uxelles;69;0;69
27;Bourgogne-Franche-Comté;71;2;17;037;Bissy-sur-Fley;84;6;90
27;Bourgogne-Franche-Comté;71;1;03;038;Les Bizots;468;13;481
27;Bourgogne-Franche-Comté;71;5;11;039;Blanot;181;1;182
27;Bourgogne-Franche-Comté;71;1;03;040;Blanzy;6060;140;6200
27;Bourgogne-Franche-Comté;71;3;10;041;Bois-Sainte-Marie;190;2;192
27;Bourgogne-Franche-Comté;71;5;11;042;Bonnay;318;7;325
27;Bourgogne-Franche-Comté;71;2;16;043;Les Bordes;83;3;86
27;Bourgogne-Franche-Comté;71;4;26;044;Bosjean;296;6;302
27;Bourgogne-Franche-Comté;71;4;26;045;Bouhans;179;6;185
27;Bourgogne-Franche-Comté;71;1;02;046;La Boulaye;94;0;94
27;Bourgogne-Franche-Comté;71;3;15;047;Bourbon-Lancy;4713;72;4785
27;Bourgogne-Franche-Comté;71;3;25;048;Bourg-le-Comte;175;2;177
27;Bourgogne-Franche-Comté;71;5;08;050;Bourgvilain;340;7;347
27;Bourgogne-Franche-Comté;71;2;04;051;Bouzeron;130;7;137
27;Bourgogne-Franche-Comté;71;2;29;052;Boyer;729;11;740
27;Bourgogne-Franche-Comté;71;2;16;054;Bragny-sur-Saône;685;13;698
27;Bourgogne-Franche-Comté;71;4;20;056;Branges;2354;37;2391
27;Bourgogne-Franche-Comté;71;5;11;057;Bray;124;3;127
27;Bourgogne-Franche-Comté;71;2;29;058;Bresse-sur-Grosne;185;11;196
27;Bourgogne-Franche-Comté;71;1;13;059;Le Breuil;3538;67;3605
27;Bourgogne-Franche-Comté;71;3;10;060;Briant;228;2;230
27;Bourgogne-Franche-Comté;71;4;14;061;Brienne;460;16;476
27;Bourgogne-Franche-Comté;71;1;02;062;Brion;292;8;300
27;Bourgogne-Franche-Comté;71;1;02;063;Broye;753;14;767
27;Bourgogne-Franche-Comté;71;4;20;064;Bruailles;985;25;1010
27;Bourgogne-Franche-Comté;71;5;11;065;Buffières;273;8;281
27;Bourgogne-Franche-Comté;71;5;19;066;Burgy;119;3;122
27;Bourgogne-Franche-Comté;71;2;11;067;Burnand;124;3;127
27;Bourgogne-Franche-Comté;71;5;11;068;Burzy;57;2;59
27;Bourgogne-Franche-Comté;71;5;19;069;Bussières;579;27;606
27;Bourgogne-Franche-Comté;71;2;17;070;Buxy;2138;85;2223
27;Bourgogne-Franche-Comté;71;3;25;071;Céron;263;8;271
27;Bourgogne-Franche-Comté;71;2;17;072;Cersot;141;2;143
27;Bourgogne-Franche-Comté;71;2;04;073;Chagny;5528;80;5608
27;Bourgogne-Franche-Comté;71;5;08;074;Chaintré;564;19;583
27;Bourgogne-Franche-Comté;71;3;15;075;Chalmoux;627;11;638
27;Bourgogne-Franche-Comté;71;2;97;076;Chalon-sur-Saône;45056;1521;46577
27;Bourgogne-Franche-Comté;71;3;25;077;Chambilly;513;4;517
27;Bourgogne-Franche-Comté;71;2;04;078;Chamilly;151;3;154
27;Bourgogne-Franche-Comté;71;4;14;079;Champagnat;463;11;474
27;Bourgogne-Franche-Comté;71;2;29;080;Champagny-sous-Uxelles;97;0;97
27;Bourgogne-Franche-Comté;71;2;05;081;Champforgeuil;2588;56;2644
27;Bourgogne-Franche-Comté;71;3;09;082;Champlecy;223;3;226
27;Bourgogne-Franche-Comté;71;5;08;084;Chânes;529;11;540
27;Bourgogne-Franche-Comté;71;2;04;085;Change;222;2;224
27;Bourgogne-Franche-Comté;71;3;09;086;Changy;466;9;475
27;Bourgogne-Franche-Comté;71;2;11;087;Chapaize;165;1;166
27;Bourgogne-Franche-Comté;71;3;18;088;La Chapelle-au-Mans;226;12;238
27;Bourgogne-Franche-Comté;71;2;29;089;La Chapelle-de-Bragny;238;2;240
27;Bourgogne-Franche-Comté;71;5;08;090;La Chapelle-de-Guinchay;4171;53;4224
27;Bourgogne-Franche-Comté;71;5;08;091;La Chapelle-du-Mont-de-France;189;2;191
27;Bourgogne-Franche-Comté;71;4;20;092;La Chapelle-Naude;504;13;517
27;Bourgogne-Franche-Comté;71;4;26;093;La Chapelle-Saint-Sauveur;662;18;680
27;Bourgogne-Franche-Comté;71;5;29;094;La Chapelle-sous-Brancion;139;2;141
27;Bourgogne-Franche-Comté;71;3;10;095;La Chapelle-sous-Dun;437;10;447
27;Bourgogne-Franche-Comté;71;1;02;096;La Chapelle-sous-Uchon;192;2;194
27;Bourgogne-Franche-Comté;71;4;14;097;La Chapelle-Thècle;480;12;492
27;Bourgogne-Franche-Comté;71;1;02;098;Charbonnat;250;4;254
27;Bourgogne-Franche-Comté;71;5;19;099;Charbonnières;316;14;330
27;Bourgogne-Franche-Comté;71;5;29;100;Chardonnay;203;0;203
27;Bourgogne-Franche-Comté;71;4;26;101;Charette-Varennes;452;8;460
27;Bourgogne-Franche-Comté;71;2;27;102;La Charmée;688;24;712
27;Bourgogne-Franche-Comté;71;1;02;103;Charmoy;274;6;280
27;Bourgogne-Franche-Comté;71;2;16;104;Charnay-lès-Chalon;190;7;197
27;Bourgogne-Franche-Comté;71;5;21;105;Charnay-lès-Mâcon;7742;297;8039
27;Bourgogne-Franche-Comté;71;3;09;106;Charolles;2888;438;3326
27;Bourgogne-Franche-Comté;71;2;04;107;Charrecey;331;10;341
27;Bourgogne-Franche-Comté;71;5;08;108;Chasselas;168;5;173
27;Bourgogne-Franche-Comté;71;2;04;109;Chassey-le-Camp;352;2;354
27;Bourgogne-Franche-Comté;71;3;10;110;Chassigny-sous-Dun;565;10;575
27;Bourgogne-Franche-Comté;71;3;18;111;Chassy;305;11;316
27;Bourgogne-Franche-Comté;71;5;11;112;Château;228;8;236
27;Bourgogne-Franche-Comté;71;3;10;113;Châteauneuf;98;0;98
27;Bourgogne-Franche-Comté;71;2;17;115;Châtel-Moron;92;4;96
27;Bourgogne-Franche-Comté;71;3;10;116;Châtenay;169;2;171
27;Bourgogne-Franche-Comté;71;2;24;117;Châtenoy-en-Bresse;1095;31;1126
27;Bourgogne-Franche-Comté;71;2;07;118;Châtenoy-le-Royal;6148;143;6291
27;Bourgogne-Franche-Comté;71;2;04;119;Chaudenay;1119;24;1143
27;Bourgogne-Franche-Comté;71;3;10;120;Chauffailles;3703;69;3772
27;Bourgogne-Franche-Comté;71;4;26;121;La Chaux;316;3;319
27;Bourgogne-Franche-Comté;71;2;04;122;Cheilly-lès-Maranges;557;15;572
27;Bourgogne-Franche-Comté;71;3;25;123;Chenay-le-Châtel;373;4;377
27;Bourgogne-Franche-Comté;71;2;17;124;Chenôves;203;7;210
27;Bourgogne-Franche-Comté;71;5;11;125;Chérizet;20;0;20
27;Bourgogne-Franche-Comté;71;5;19;126;Chevagny-les-Chevrières;584;23;607
27;Bourgogne-Franche-Comté;71;5;11;127;Chevagny-sur-Guye;60;5;65
27;Bourgogne-Franche-Comté;71;5;11;128;Chiddes;88;5;93
27;Bourgogne-Franche-Comté;71;1;01;129;Chissey-en-Morvan;271;7;278
27;Bourgogne-Franche-Comté;71;5;11;130;Chissey-lès-Mâcon;229;6;235
27;Bourgogne-Franche-Comté;71;2;16;131;Ciel;851;13;864
27;Bourgogne-Franche-Comté;71;1;28;132;Ciry-le-Noble;2260;30;2290
27;Bourgogne-Franche-Comté;71;3;10;133;La Clayette;1637;58;1695
27;Bourgogne-Franche-Comté;71;5;08;134;Navour-sur-Grosne;661;21;682
27;Bourgogne-Franche-Comté;71;5;19;135;Clessé;891;20;911
27;Bourgogne-Franche-Comté;71;3;18;136;Clessy;276;8;284
27;Bourgogne-Franche-Comté;71;5;11;137;Cluny;4929;247;5176
27;Bourgogne-Franche-Comté;71;2;03;139;Collonge-en-Charollais;144;0;144
27;Bourgogne-Franche-Comté;71;1;01;140;Collonge-la-Madeleine;50;0;50
27;Bourgogne-Franche-Comté;71;3;09;141;Colombier-en-Brionnais;310;6;316
27;Bourgogne-Franche-Comté;71;1;02;142;La Comelle;240;4;244
27;Bourgogne-Franche-Comté;71;4;14;143;Condal;459;8;467
27;Bourgogne-Franche-Comté;71;1;01;144;Cordesse;191;5;196
27;Bourgogne-Franche-Comté;71;2;11;145;Cormatin;564;5;569
27;Bourgogne-Franche-Comté;71;5;11;146;Cortambert;232;7;239
27;Bourgogne-Franche-Comté;71;5;11;147;Cortevaix;251;6;257
27;Bourgogne-Franche-Comté;71;3;10;148;Coublanc;843;17;860
27;Bourgogne-Franche-Comté;71;1;04;149;Couches;1323;29;1352
27;Bourgogne-Franche-Comté;71;5;08;150;Crêches-sur-Saône;3089;86;3175
27;Bourgogne-Franche-Comté;71;1;01;151;Créot;78;4;82
27;Bourgogne-Franche-Comté;71;3;18;152;Cressy-sur-Somme;180;9;189
27;Bourgogne-Franche-Comté;71;1;98;153;Le Creusot;21269;298;21567
27;Bourgogne-Franche-Comté;71;2;05;154;Crissey;2469;62;2531
27;Bourgogne-Franche-Comté;71;3;15;155;Cronat;519;16;535
27;Bourgogne-Franche-Comté;71;5;19;156;Cruzille;262;65;327
27;Bourgogne-Franche-Comté;71;4;14;157;Cuiseaux;1829;31;1860
27;Bourgogne-Franche-Comté;71;4;14;158;Cuisery;1571;40;1611
27;Bourgogne-Franche-Comté;71;2;17;159;Culles-les-Roches;202;8;210
27;Bourgogne-Franche-Comté;71;3;10;160;Curbigny;310;9;319
27;Bourgogne-Franche-Comté;71;3;18;161;Curdin;319;6;325
27;Bourgogne-Franche-Comté;71;1;01;162;Curgy;1153;44;1197
27;Bourgogne-Franche-Comté;71;5;11;163;Curtil-sous-Buffières;90;1;91
27;Bourgogne-Franche-Comté;71;2;11;164;Curtil-sous-Burnand;129;3;132
27;Bourgogne-Franche-Comté;71;1;01;165;Cussy-en-Morvan;378;8;386
27;Bourgogne-Franche-Comté;71;3;18;166;Cuzy;112;4;116
27;Bourgogne-Franche-Comté;71;2;16;167;Damerey;552;20;572
27;Bourgogne-Franche-Comté;71;4;26;168;Dampierre-en-Bresse;174;1;175
27;Bourgogne-Franche-Comté;71;5;08;169;Davayé;700;107;807
27;Bourgogne-Franche-Comté;71;2;16;170;Demigny;1794;40;1834
27;Bourgogne-Franche-Comté;71;2;04;171;Dennevy;305;9;314
27;Bourgogne-Franche-Comté;71;1;02;172;Dettey;85;1;86
27;Bourgogne-Franche-Comté;71;4;26;173;Devrouze;311;4;315
27;Bourgogne-Franche-Comté;71;2;04;174;Dezize-lès-Maranges;173;4;177
27;Bourgogne-Franche-Comté;71;4;26;175;Diconne;338;4;342
27;Bourgogne-Franche-Comté;71;3;15;176;Digoin;7741;249;7990
27;Bourgogne-Franche-Comté;71;4;14;177;Dommartin-lès-Cuiseaux;802;12;814
27;Bourgogne-Franche-Comté;71;5;08;178;Dompierre-les-Ormes;889;31;920
27;Bourgogne-Franche-Comté;71;3;18;179;Dompierre-sous-Sanvignes;81;1;82
27;Bourgogne-Franche-Comté;71;5;11;181;Donzy-le-Pertuis;168;4;172
27;Bourgogne-Franche-Comté;71;2;17;182;Dracy-le-Fort;1458;52;1510
27;Bourgogne-Franche-Comté;71;1;04;183;Dracy-lès-Couches;153;3;156
27;Bourgogne-Franche-Comté;71;1;01;184;Dracy-Saint-Loup;608;9;617
27;Bourgogne-Franche-Comté;71;3;09;185;Dyo;332;14;346
27;Bourgogne-Franche-Comté;71;2;16;186;Écuelles;262;5;267
27;Bourgogne-Franche-Comté;71;1;03;187;Écuisses;1580;34;1614
27;Bourgogne-Franche-Comté;71;1;01;188;Épertully;60;1;61
27;Bourgogne-Franche-Comté;71;2;27;189;Épervans;1616;52;1668
27;Bourgogne-Franche-Comté;71;1;01;190;Épinac;2164;30;2194
27;Bourgogne-Franche-Comté;71;1;04;191;Essertenne;472;10;482
27;Bourgogne-Franche-Comté;71;1;02;192;Étang-sur-Arroux;1811;148;1959
27;Bourgogne-Franche-Comté;71;2;29;193;Étrigny;473;11;484
27;Bourgogne-Franche-Comté;71;2;05;194;Farges-lès-Chalon;790;15;805
27;Bourgogne-Franche-Comté;71;5;29;195;Farges-lès-Mâcon;220;1;221
27;Bourgogne-Franche-Comté;71;4;20;196;Le Fay;634;8;642
27;Bourgogne-Franche-Comté;71;4;14;198;Flacey-en-Bresse;412;7;419
27;Bourgogne-Franche-Comté;71;5;11;199;Flagy;174;8;182
27;Bourgogne-Franche-Comté;71;3;10;200;Fleury-la-Montagne;704;17;721
27;Bourgogne-Franche-Comté;71;2;17;201;Fley;196;7;203
27;Bourgogne-Franche-Comté;71;2;04;202;Fontaines;1877;364;2241
27;Bourgogne-Franche-Comté;71;3;09;203;Fontenay;52;1;53
27;Bourgogne-Franche-Comté;71;2;05;204;Fragnes-La Loyère;1487;43;1530
27;Bourgogne-Franche-Comté;71;4;26;205;Frangy-en-Bresse;651;9;660
27;Bourgogne-Franche-Comté;71;4;14;206;La Frette;239;4;243
27;Bourgogne-Franche-Comté;71;4;26;207;Fretterans;288;11;299
27;Bourgogne-Franche-Comté;71;4;26;208;Frontenard;210;4;214
27;Bourgogne-Franche-Comté;71;4;14;209;Frontenaud;728;14;742
27;Bourgogne-Franche-Comté;71;5;08;210;Fuissé;373;19;392
27;Bourgogne-Franche-Comté;71;1;28;212;Génelard;1387;33;1420
27;Bourgogne-Franche-Comté;71;4;14;213;La Genête;569;17;586
27;Bourgogne-Franche-Comté;71;2;03;214;Genouilly;420;11;431
27;Bourgogne-Franche-Comté;71;2;16;215;Gergy;2581;72;2653
27;Bourgogne-Franche-Comté;71;2;17;216;Germagny;197;5;202
27;Bourgogne-Franche-Comté;71;5;08;217;Germolles-sur-Grosne;125;5;130
27;Bourgogne-Franche-Comté;71;3;10;218;Gibles;581;21;602
27;Bourgogne-Franche-Comté;71;2;29;219;Gigny-sur-Saône;547;15;562
27;Bourgogne-Franche-Comté;71;3;15;220;Gilly-sur-Loire;473;3;476
27;Bourgogne-Franche-Comté;71;2;17;221;Givry;3684;161;3845
27;Bourgogne-Franche-Comté;71;1;03;222;Gourdon;899;26;925
27;Bourgogne-Franche-Comté;71;1;02;223;La Grande-Verrière;563;8;571
27;Bourgogne-Franche-Comté;71;3;09;224;Grandvaux;82;6;88
27;Bourgogne-Franche-Comté;71;2;17;225;Granges;525;13;538
27;Bourgogne-Franche-Comté;71;5;29;226;Grevilly;30;0;30
27;Bourgogne-Franche-Comté;71;3;18;227;Grury;513;8;521
27;Bourgogne-Franche-Comté;71;2;24;228;Guerfand;210;0;210
27;Bourgogne-Franche-Comté;71;3;15;229;Les Guerreaux;231;1;232
27;Bourgogne-Franche-Comté;71;3;18;230;Gueugnon;6760;194;6954
27;Bourgogne-Franche-Comté;71;5;11;231;La Guiche;630;11;641
27;Bourgogne-Franche-Comté;71;3;25;232;Hautefond;202;14;216
27;Bourgogne-Franche-Comté;71;3;25;233;L'Hôpital-le-Mercier;304;7;311
27;Bourgogne-Franche-Comté;71;4;14;234;Huilly-sur-Seille;341;6;347
27;Bourgogne-Franche-Comté;71;5;19;235;Hurigny;1954;108;2062
27;Bourgogne-Franche-Comté;71;5;19;236;Igé;879;21;900
27;Bourgogne-Franche-Comté;71;1;01;237;Igornay;524;7;531
27;Bourgogne-Franche-Comté;71;3;10;238;Iguerande;986;18;1004
27;Bourgogne-Franche-Comté;71;3;18;239;Issy-l'Évêque;697;11;708
27;Bourgogne-Franche-Comté;71;5;11;240;Jalogny;384;15;399
27;Bourgogne-Franche-Comté;71;2;17;241;Jambles;486;18;504
27;Bourgogne-Franche-Comté;71;5;03;242;Joncy;521;11;532
27;Bourgogne-Franche-Comté;71;4;14;243;Joudes;371;4;375
27;Bourgogne-Franche-Comté;71;4;14;244;Jouvençon;438;2;440
27;Bourgogne-Franche-Comté;71;2;29;245;Jugy;322;6;328
27;Bourgogne-Franche-Comté;71;4;20;246;Juif;250;3;253
27;Bourgogne-Franche-Comté;71;2;17;247;Jully-lès-Buxy;365;10;375
27;Bourgogne-Franche-Comté;71;5;29;248;Lacrost;710;20;730
27;Bourgogne-Franche-Comté;71;2;29;249;Laives;991;37;1028
27;Bourgogne-Franche-Comté;71;5;19;250;Laizé;1087;49;1136
27;Bourgogne-Franche-Comté;71;1;02;251;Laizy;590;13;603
27;Bourgogne-Franche-Comté;71;2;29;252;Lalheue;370;14;384
27;Bourgogne-Franche-Comté;71;2;24;253;Lans;928;26;954
27;Bourgogne-Franche-Comté;71;4;26;254;Lays-sur-le-Doubs;151;1;152
27;Bourgogne-Franche-Comté;71;3;15;255;Lesme;179;2;181
27;Bourgogne-Franche-Comté;71;4;24;256;Lessard-en-Bresse;539;12;551
27;Bourgogne-Franche-Comté;71;2;16;257;Lessard-le-National;653;12;665
27;Bourgogne-Franche-Comté;71;5;08;258;Leynes;509;15;524
27;Bourgogne-Franche-Comté;71;3;10;259;Ligny-en-Brionnais;363;7;370
27;Bourgogne-Franche-Comté;71;4;14;261;Loisy;662;16;678
27;Bourgogne-Franche-Comté;71;2;16;262;Longepierre;161;4;165
27;Bourgogne-Franche-Comté;71;4;20;263;Louhans;6433;225;6658
27;Bourgogne-Franche-Comté;71;5;11;264;Lournand;328;9;337
27;Bourgogne-Franche-Comté;71;1;01;266;Lucenay-l'Évêque;315;3;318
27;Bourgogne-Franche-Comté;71;5;19;267;Lugny;859;84;943
27;Bourgogne-Franche-Comté;71;3;09;268;Lugny-lès-Charolles;350;10;360
27;Bourgogne-Franche-Comté;71;2;27;269;Lux;2067;33;2100
27;Bourgogne-Franche-Comté;71;5;99;270;Mâcon;33908;755;34663
27;Bourgogne-Franche-Comté;71;3;10;271;Mailly;149;5;154
27;Bourgogne-Franche-Comté;71;2;11;272;Malay;199;9;208
27;Bourgogne-Franche-Comté;71;3;15;273;Maltat;283;6;289
27;Bourgogne-Franche-Comté;71;2;29;274;Mancey;388;10;398
27;Bourgogne-Franche-Comté;71;3;25;275;Marcigny;1727;31;1758
27;Bourgogne-Franche-Comté;71;3;09;276;Marcilly-la-Gueurce;128;5;133
27;Bourgogne-Franche-Comté;71;2;17;277;Marcilly-lès-Buxy;665;19;684
27;Bourgogne-Franche-Comté;71;1;03;278;Marigny;155;5;160
27;Bourgogne-Franche-Comté;71;3;09;279;Le Rousset-Marizy;628;19;647
27;Bourgogne-Franche-Comté;71;3;18;280;Marly-sous-Issy;87;2;89
27;Bourgogne-Franche-Comté;71;3;18;281;Marly-sur-Arroux;307;14;321
27;Bourgogne-Franche-Comté;71;1;02;282;Marmagne;1243;34;1277
27;Bourgogne-Franche-Comté;71;2;27;283;Marnay;537;7;544
27;Bourgogne-Franche-Comté;71;5;29;284;Martailly-lès-Brancion;143;7;150
27;Bourgogne-Franche-Comté;71;3;09;285;Martigny-le-Comte;410;6;416
27;Bourgogne-Franche-Comté;71;1;03;286;Mary;263;4;267
27;Bourgogne-Franche-Comté;71;5;11;287;Massilly;328;6;334
27;Bourgogne-Franche-Comté;71;5;08;289;Matour;1145;22;1167
27;Bourgogne-Franche-Comté;71;5;11;290;Mazille;377;68;445
27;Bourgogne-Franche-Comté;71;3;25;291;Melay;968;23;991
27;Bourgogne-Franche-Comté;71;2;17;292;Mellecey;1322;45;1367
27;Bourgogne-Franche-Comté;71;4;14;293;Ménetreuil;409;10;419
27;Bourgogne-Franche-Comté;71;2;17;294;Mercurey;1212;171;1383
27;Bourgogne-Franche-Comté;71;4;26;295;Mervans;1505;25;1530
27;Bourgogne-Franche-Comté;71;2;17;296;Messey-sur-Grosne;749;19;768
27;Bourgogne-Franche-Comté;71;1;02;297;Mesvres;754;22;776
27;Bourgogne-Franche-Comté;71;5;19;299;Milly-Lamartine;316;7;323
27;Bourgogne-Franche-Comté;71;4;14;300;Le Miroir;621;8;629
27;Bourgogne-Franche-Comté;71;3;15;301;Mont;170;2;172
27;Bourgogne-Franche-Comté;71;2;17;302;Montagny-lès-Buxy;215;9;224
27;Bourgogne-Franche-Comté;71;4;20;303;Montagny-près-Louhans;485;6;491
27;Bourgogne-Franche-Comté;71;5;19;305;Montbellet;828;15;843
27;Bourgogne-Franche-Comté;71;1;23;306;Montceau-les-Mines;17678;308;17986
27;Bourgogne-Franche-Comté;71;3;25;307;Montceaux-l'Étoile;290;7;297
27;Bourgogne-Franche-Comté;71;2;29;308;Montceaux-Ragny;31;1;32
27;Bourgogne-Franche-Comté;71;1;12;309;Montcenis;1924;60;1984
27;Bourgogne-Franche-Comté;71;1;03;310;Montchanin;4964;89;5053
27;Bourgogne-Franche-Comté;71;4;20;311;Montcony;256;5;261
27;Bourgogne-Franche-Comté;71;2;24;312;Montcoy;255;1;256
27;Bourgogne-Franche-Comté;71;1;01;313;Monthelon;381;15;396
27;Bourgogne-Franche-Comté;71;4;26;314;Montjay;206;0;206
27;Bourgogne-Franche-Comté;71;2;16;315;Mont-lès-Seurre;183;2;185
27;Bourgogne-Franche-Comté;71;5;08;316;Montmelard;371;7;378
27;Bourgogne-Franche-Comté;71;3;18;317;Montmort;183;3;186
27;Bourgogne-Franche-Comté;71;4;14;318;Montpont-en-Bresse;1100;20;1120
27;Bourgogne-Franche-Comté;71;4;20;319;Montret;779;16;795
27;Bourgogne-Franche-Comté;71;1;03;320;Mont-Saint-Vincent;315;3;318
27;Bourgogne-Franche-Comté;71;1;04;321;Morey;192;4;196
27;Bourgogne-Franche-Comté;71;1;01;322;Morlet;52;1;53
27;Bourgogne-Franche-Comté;71;3;09;323;Mornay;136;0;136
27;Bourgogne-Franche-Comté;71;2;17;324;Moroges;579;23;602
27;Bourgogne-Franche-Comté;71;3;15;325;La Motte-Saint-Jean;1206;34;1240
27;Bourgogne-Franche-Comté;71;4;26;326;Mouthier-en-Bresse;418;7;425
27;Bourgogne-Franche-Comté;71;3;10;327;Mussy-sous-Dun;343;8;351
27;Bourgogne-Franche-Comté;71;2;29;328;Nanton;631;12;643
27;Bourgogne-Franche-Comté;71;2;16;329;Navilly;410;9;419
27;Bourgogne-Franche-Comté;71;3;18;330;Neuvy-Grandchamp;754;15;769
27;Bourgogne-Franche-Comté;71;3;25;331;Nochize;117;1;118
27;Bourgogne-Franche-Comté;71;4;14;332;Ormes;469;5;474
27;Bourgogne-Franche-Comté;71;2;24;333;Oslon;1222;39;1261
27;Bourgogne-Franche-Comté;71;3;09;334;Oudry;383;9;392
27;Bourgogne-Franche-Comté;71;3;09;335;Ouroux-sous-le-Bois-Sainte-Marie;66;0;66
27;Bourgogne-Franche-Comté;71;4;24;336;Ouroux-sur-Saône;3110;80;3190
27;Bourgogne-Franche-Comté;71;3;10;337;Oyé;303;8;311
27;Bourgogne-Franche-Comté;71;5;29;338;Ozenay;216;2;218
27;Bourgogne-Franche-Comté;71;3;09;339;Ozolles;391;8;399
27;Bourgogne-Franche-Comté;71;3;09;340;Palinges;1507;26;1533
27;Bourgogne-Franche-Comté;71;2;16;341;Palleau;254;2;256
27;Bourgogne-Franche-Comté;71;3;25;342;Paray-le-Monial;9214;417;9631
27;Bourgogne-Franche-Comté;71;2;04;343;Paris-l'Hôpital;318;4;322
27;Bourgogne-Franche-Comté;71;5;11;344;Passy;66;2;68
27;Bourgogne-Franche-Comté;71;5;19;345;Péronne;672;11;683
27;Bourgogne-Franche-Comté;71;1;28;346;Perrecy-les-Forges;1568;26;1594
27;Bourgogne-Franche-Comté;71;1;04;347;Perreuil;553;15;568
27;Bourgogne-Franche-Comté;71;3;15;348;Perrigny-sur-Loire;131;3;134
27;Bourgogne-Franche-Comté;71;1;01;349;La Petite-Verrière;51;1;52
27;Bourgogne-Franche-Comté;71;5;08;350;Pierreclos;874;30;904
27;Bourgogne-Franche-Comté;71;4;26;351;Pierre-de-Bresse;1938;31;1969
27;Bourgogne-Franche-Comté;71;4;26;352;Le Planois;88;3;91
27;Bourgogne-Franche-Comté;71;5;29;353;Plottes;525;7;532
27;Bourgogne-Franche-Comté;71;3;25;354;Poisson;570;22;592
27;Bourgogne-Franche-Comté;71;2;16;355;Pontoux;280;7;287
27;Bourgogne-Franche-Comté;71;1;09;356;Pouilloux;974;17;991
27;Bourgogne-Franche-Comté;71;4;26;357;Pourlans;217;0;217
27;Bourgogne-Franche-Comté;71;5;11;358;Pressy-sous-Dondin;102;3;105
27;Bourgogne-Franche-Comté;71;5;29;359;Préty;568;10;578
27;Bourgogne-Franche-Comté;71;5;19;360;Prissé;1910;46;1956
27;Bourgogne-Franche-Comté;71;3;09;361;Prizy;58;5;63
27;Bourgogne-Franche-Comté;71;5;08;362;Pruzilly;344;5;349
27;Bourgogne-Franche-Comté;71;2;03;363;Le Puley;88;5;93
27;Bourgogne-Franche-Comté;71;4;26;364;La Racineuse;176;1;177
27;Bourgogne-Franche-Comté;71;4;14;365;Rancy;591;8;599
27;Bourgogne-Franche-Comté;71;4;14;366;Ratenelle;380;8;388
27;Bourgogne-Franche-Comté;71;4;20;367;Ratte;366;5;371
27;Bourgogne-Franche-Comté;71;1;01;368;Reclesne;303;16;319
27;Bourgogne-Franche-Comté;71;2;04;369;Remigny;430;7;437
27;Bourgogne-Franche-Comté;71;3;18;370;Rigny-sur-Arroux;626;11;637
27;Bourgogne-Franche-Comté;71;5;19;371;La Roche-Vineuse;1577;41;1618
27;Bourgogne-Franche-Comté;71;5;08;372;Romanèche-Thorins;2021;33;2054
27;Bourgogne-Franche-Comté;71;4;14;373;Romenay;1704;21;1725
27;Bourgogne-Franche-Comté;71;2;17;374;Rosey;162;2;164
27;Bourgogne-Franche-Comté;71;1;01;376;Roussillon-en-Morvan;275;8;283
27;Bourgogne-Franche-Comté;71;5;29;377;Royer;128;2;130
27;Bourgogne-Franche-Comté;71;2;04;378;Rully;1557;35;1592
27;Bourgogne-Franche-Comté;71;4;20;379;Sagy;1233;21;1254
27;Bourgogne-Franche-Comté;71;4;26;380;Saillenard;789;17;806
27;Bourgogne-Franche-Comté;71;5;11;381;Sailly;74;0;74
27;Bourgogne-Franche-Comté;71;3;15;382;Saint-Agnan;697;15;712
27;Bourgogne-Franche-Comté;71;5;19;383;Saint-Albain;534;5;539
27;Bourgogne-Franche-Comté;71;2;29;384;Saint-Ambreuil;506;8;514
27;Bourgogne-Franche-Comté;71;5;08;385;Saint-Amour-Bellevue;566;20;586
27;Bourgogne-Franche-Comté;71;4;20;386;Saint-André-en-Bresse;94;0;94
27;Bourgogne-Franche-Comté;71;5;11;387;Saint-André-le-Désert;249;9;258
27;Bourgogne-Franche-Comté;71;3;09;388;Saint-Aubin-en-Charollais;467;20;487
27;Bourgogne-Franche-Comté;71;3;15;389;Saint-Aubin-sur-Loire;281;5;286
27;Bourgogne-Franche-Comté;71;1;23;390;Saint-Berain-sous-Sanvignes;1084;22;1106
27;Bourgogne-Franche-Comté;71;2;04;391;Saint-Bérain-sur-Dheune;555;17;572
27;Bourgogne-Franche-Comté;71;2;17;392;Saint-Boil;491;9;500
27;Bourgogne-Franche-Comté;71;3;10;393;Saint-Bonnet-de-Cray;491;17;508
27;Bourgogne-Franche-Comté;71;3;09;394;Saint-Bonnet-de-Joux;765;22;787
27;Bourgogne-Franche-Comté;71;3;09;395;Saint-Bonnet-de-Vieille-Vigne;209;2;211
27;Bourgogne-Franche-Comté;71;4;26;396;Saint-Bonnet-en-Bresse;488;4;492
27;Bourgogne-Franche-Comté;71;5;11;397;Sainte-Cécile;283;8;291
27;Bourgogne-Franche-Comté;71;4;24;398;Saint-Christophe-en-Bresse;1044;31;1075
27;Bourgogne-Franche-Comté;71;3;10;399;Saint-Christophe-en-Brionnais;532;15;547
27;Bourgogne-Franche-Comté;71;5;11;400;Saint-Clément-sur-Guye;129;4;133
27;Bourgogne-Franche-Comté;71;4;14;401;Sainte-Croix-en-Bresse;629;13;642
27;Bourgogne-Franche-Comté;71;2;29;402;Saint-Cyr;750;25;775
27;Bourgogne-Franche-Comté;71;2;17;403;Saint-Denis-de-Vaux;260;10;270
27;Bourgogne-Franche-Comté;71;2;17;404;Saint-Désert;896;22;918
27;Bourgogne-Franche-Comté;71;2;16;405;Saint-Didier-en-Bresse;198;1;199
27;Bourgogne-Franche-Comté;71;3;10;406;Saint-Didier-en-Brionnais;126;9;135
27;Bourgogne-Franche-Comté;71;1;02;407;Saint-Didier-sur-Arroux;221;4;225
27;Bourgogne-Franche-Comté;71;3;10;408;Saint-Edmond;428;9;437
27;Bourgogne-Franche-Comté;71;1;02;409;Saint-Émiland;310;9;319
27;Bourgogne-Franche-Comté;71;4;20;410;Saint-Étienne-en-Bresse;794;15;809
27;Bourgogne-Franche-Comté;71;1;02;411;Saint-Eugène;154;8;162
27;Bourgogne-Franche-Comté;71;1;03;412;Saint-Eusèbe;1200;24;1224
27;Bourgogne-Franche-Comté;71;1;13;413;Saint-Firmin;833;10;843
27;Bourgogne-Franche-Comté;71;1;01;414;Saint-Forgeot;443;17;460
27;Bourgogne-Franche-Comté;71;3;10;415;Sainte-Foy;138;2;140
27;Bourgogne-Franche-Comté;71;5;19;416;Saint-Gengoux-de-Scissé;592;6;598
27;Bourgogne-Franche-Comté;71;2;11;417;Saint-Gengoux-le-National;1058;7;1065
27;Bourgogne-Franche-Comté;71;4;26;419;Saint-Germain-du-Bois;1895;42;1937
27;Bourgogne-Franche-Comté;71;4;24;420;Saint-Germain-du-Plain;2310;51;2361
27;Bourgogne-Franche-Comté;71;3;09;421;Saint-Germain-en-Brionnais;185;7;192
27;Bourgogne-Franche-Comté;71;2;17;422;Saint-Germain-lès-Buxy;276;9;285
27;Bourgogne-Franche-Comté;71;2;16;423;Saint-Gervais-en-Vallière;433;5;438
27;Bourgogne-Franche-Comté;71;1;01;424;Saint-Gervais-sur-Couches;211;3;214
27;Bourgogne-Franche-Comté;71;2;04;425;Saint-Gilles;279;11;290
27;Bourgogne-Franche-Comté;71;2;17;426;Sainte-Hélène;540;11;551
27;Bourgogne-Franche-Comté;71;5;11;427;Saint-Huruge;51;1;52
27;Bourgogne-Franche-Comté;71;3;10;428;Saint-Igny-de-Roche;763;26;789
27;Bourgogne-Franche-Comté;71;2;17;430;Saint-Jean-de-Vaux;395;16;411
27;Bourgogne-Franche-Comté;71;1;04;431;Saint-Jean-de-Trézy;377;13;390
27;Bourgogne-Franche-Comté;71;3;09;433;Saint-Julien-de-Civry;491;14;505
27;Bourgogne-Franche-Comté;71;3;10;434;Saint-Julien-de-Jonzy;345;7;352
27;Bourgogne-Franche-Comté;71;1;03;435;Saint-Julien-sur-Dheune;243;9;252
27;Bourgogne-Franche-Comté;71;1;03;436;Saint-Laurent-d'Andenay;1004;20;1024
27;Bourgogne-Franche-Comté;71;3;10;437;Saint-Laurent-en-Brionnais;323;11;334
27;Bourgogne-Franche-Comté;71;1;01;438;Saint-Léger-du-Bois;529;19;548
27;Bourgogne-Franche-Comté;71;3;25;439;Saint-Léger-lès-Paray;748;19;767
27;Bourgogne-Franche-Comté;71;1;02;440;Saint-Léger-sous-Beuvray;374;9;383
27;Bourgogne-Franche-Comté;71;5;08;441;Saint-Léger-sous-la-Bussière;279;4;283
27;Bourgogne-Franche-Comté;71;2;04;442;Saint-Léger-sur-Dheune;1567;22;1589
27;Bourgogne-Franche-Comté;71;2;16;443;Saint-Loup-Géanges;1640;57;1697
27;Bourgogne-Franche-Comté;71;2;27;444;Saint-Loup-de-Varennes;1199;30;1229
27;Bourgogne-Franche-Comté;71;2;27;445;Saint-Marcel;6190;180;6370
27;Bourgogne-Franche-Comté;71;5;11;446;Saint-Marcelin-de-Cray;189;6;195
27;Bourgogne-Franche-Comté;71;2;17;447;Saint-Mard-de-Vaux;273;14;287
27;Bourgogne-Franche-Comté;71;5;19;448;Saint-Martin-Belle-Roche;1389;33;1422
27;Bourgogne-Franche-Comté;71;2;17;449;Saint-Martin-d'Auxy;120;6;126
27;Bourgogne-Franche-Comté;71;1;02;450;Saint-Martin-de-Commune;101;6;107
27;Bourgogne-Franche-Comté;71;3;10;451;Saint-Martin-de-Lixy;94;0;94
27;Bourgogne-Franche-Comté;71;5;11;452;Saint-Martin-de-Salencey;96;1;97
27;Bourgogne-Franche-Comté;71;3;25;453;Saint-Martin-du-Lac;242;11;253
27;Bourgogne-Franche-Comté;71;4;20;454;Saint-Martin-du-Mont;187;8;195
27;Bourgogne-Franche-Comté;71;2;17;455;Saint-Martin-du-Tartre;159;4;163
27;Bourgogne-Franche-Comté;71;2;24;456;Saint-Martin-en-Bresse;1911;68;1979
27;Bourgogne-Franche-Comté;71;2;16;457;Saint-Martin-en-Gâtinois;120;2;122
27;Bourgogne-Franche-Comté;71;5;03;458;Saint-Martin-la-Patrouille;61;0;61
27;Bourgogne-Franche-Comté;71;2;17;459;Saint-Martin-sous-Montaigu;340;17;357
27;Bourgogne-Franche-Comté;71;5;19;460;Saint-Maurice-de-Satonnay;468;23;491
27;Bourgogne-Franche-Comté;71;2;17;461;Saint-Maurice-des-Champs;62;1;63
27;Bourgogne-Franche-Comté;71;2;16;462;Saint-Maurice-en-Rivière;528;11;539
27;Bourgogne-Franche-Comté;71;3;10;463;Saint-Maurice-lès-Châteauneuf;571;12;583
27;Bourgogne-Franche-Comté;71;1;04;464;Saint-Maurice-lès-Couches;184;4;188
27;Bourgogne-Franche-Comté;71;1;03;465;Saint-Micaud;274;9;283
27;Bourgogne-Franche-Comté;71;1;02;466;Saint-Nizier-sur-Arroux;122;4;126
27;Bourgogne-Franche-Comté;71;1;13;468;Saint-Pierre-de-Varennes;848;16;864
27;Bourgogne-Franche-Comté;71;5;08;469;Saint-Pierre-le-Vieux;364;10;374
27;Bourgogne-Franche-Comté;71;5;08;470;Saint-Point;347;14;361
27;Bourgogne-Franche-Comté;71;2;17;471;Saint-Privé;92;1;93
27;Bourgogne-Franche-Comté;71;1;02;472;Saint-Prix;209;8;217
27;Bourgogne-Franche-Comté;71;3;10;473;Saint-Racho;150;1;151
27;Bourgogne-Franche-Comté;71;3;18;474;Sainte-Radegonde;147;2;149
27;Bourgogne-Franche-Comté;71;2;27;475;Saint-Rémy;6615;157;6772
27;Bourgogne-Franche-Comté;71;1;09;477;Saint-Romain-sous-Gourdon;484;9;493
27;Bourgogne-Franche-Comté;71;3;18;478;Saint-Romain-sous-Versigny;85;2;87
27;Bourgogne-Franche-Comté;71;1;13;479;Saint-Sernin-du-Bois;1758;36;1794
27;Bourgogne-Franche-Comté;71;2;04;480;Saint-Sernin-du-Plain;596;13;609
27;Bourgogne-Franche-Comté;71;5;08;481;Saint-Symphorien-d'Ancelles;1150;20;1170
27;Bourgogne-Franche-Comté;71;1;02;482;Saint-Symphorien-de-Marmagne;836;11;847
27;Bourgogne-Franche-Comté;71;3;10;483;Saint-Symphorien-des-Bois;425;12;437
27;Bourgogne-Franche-Comté;71;4;20;484;Saint-Usuge;1282;29;1311
27;Bourgogne-Franche-Comté;71;2;17;485;Saint-Vallerin;258;14;272
27;Bourgogne-Franche-Comté;71;1;28;486;Saint-Vallier;8576;172;8748
27;Bourgogne-Franche-Comté;71;5;08;487;Saint-Vérand;162;3;165
27;Bourgogne-Franche-Comté;71;5;11;488;Saint-Vincent-des-Prés;104;3;107
27;Bourgogne-Franche-Comté;71;4;20;489;Saint-Vincent-en-Bresse;570;9;579
27;Bourgogne-Franche-Comté;71;3;09;490;Saint-Vincent-Bragny;1015;17;1032
27;Bourgogne-Franche-Comté;71;3;25;491;Saint-Yan;1156;24;1180
27;Bourgogne-Franche-Comté;71;5;11;492;Saint-Ythaire;126;2;128
27;Bourgogne-Franche-Comté;71;1;01;493;Saisy;343;7;350
27;Bourgogne-Franche-Comté;71;5;19;494;La Salle;526;14;540
27;Bourgogne-Franche-Comté;71;5;11;495;Salornay-sur-Guye;874;12;886
27;Bourgogne-Franche-Comté;71;2;04;496;Sampigny-lès-Maranges;143;10;153
27;Bourgogne-Franche-Comté;71;5;21;497;Sancé;2150;54;2204
27;Bourgogne-Franche-Comté;71;2;17;498;Santilly;132;6;138
27;Bourgogne-Franche-Comté;71;1;28;499;Sanvignes-les-Mines;4316;81;4397
27;Bourgogne-Franche-Comté;71;3;10;500;Sarry;93;3;96
27;Bourgogne-Franche-Comté;71;2;17;501;Sassangy;142;3;145
27;Bourgogne-Franche-Comté;71;2;16;502;Sassenay;1577;45;1622
27;Bourgogne-Franche-Comté;71;2;17;503;Saules;128;3;131
27;Bourgogne-Franche-Comté;71;2;16;504;Saunières;80;2;82
27;Bourgogne-Franche-Comté;71;2;17;505;Savianges;76;1;77
27;Bourgogne-Franche-Comté;71;4;26;506;Savigny-en-Revermont;1137;17;1154
27;Bourgogne-Franche-Comté;71;2;11;507;Savigny-sur-Grosne;169;1;170
27;Bourgogne-Franche-Comté;71;4;14;508;Savigny-sur-Seille;406;9;415
27;Bourgogne-Franche-Comté;71;1;01;509;La Celle-en-Morvan;476;6;482
27;Bourgogne-Franche-Comté;71;3;10;510;Semur-en-Brionnais;610;19;629
27;Bourgogne-Franche-Comté;71;2;29;512;Sennecey-le-Grand;3012;68;3080
27;Bourgogne-Franche-Comté;71;5;19;513;Senozan;1127;36;1163
27;Bourgogne-Franche-Comté;71;4;26;514;Sens-sur-Seille;419;5;424
27;Bourgogne-Franche-Comté;71;2;17;515;Sercy;100;3;103
27;Bourgogne-Franche-Comté;71;4;26;516;Serley;607;7;614
27;Bourgogne-Franche-Comté;71;2;16;517;Sermesse;232;3;235
27;Bourgogne-Franche-Comté;71;5;08;518;Serrières;274;9;283
27;Bourgogne-Franche-Comté;71;4;26;519;Serrigny-en-Bresse;189;4;193
27;Bourgogne-Franche-Comté;71;2;27;520;Sevrey;1290;25;1315
27;Bourgogne-Franche-Comté;71;5;11;521;Sigy-le-Châtel;106;2;108
27;Bourgogne-Franche-Comté;71;4;14;522;Simandre;1737;19;1756
27;Bourgogne-Franche-Comté;71;4;20;523;Simard;1188;12;1200
27;Bourgogne-Franche-Comté;71;5;11;524;Sivignon;173;7;180
27;Bourgogne-Franche-Comté;71;5;19;525;Sologny;576;11;587
27;Bourgogne-Franche-Comté;71;5;08;526;Solutré-Pouilly;361;7;368
27;Bourgogne-Franche-Comté;71;1;01;527;Sommant;210;4;214
27;Bourgogne-Franche-Comté;71;4;20;528;Sornay;2001;45;2046
27;Bourgogne-Franche-Comté;71;3;09;529;Suin;257;7;264
27;Bourgogne-Franche-Comté;71;1;01;530;Sully;488;14;502
27;Bourgogne-Franche-Comté;71;1;02;531;La Tagnière;215;1;216
27;Bourgogne-Franche-Comté;71;5;11;532;Taizé;194;3;197
27;Bourgogne-Franche-Comté;71;3;10;533;Tancon;532;18;550
27;Bourgogne-Franche-Comté;71;4;26;534;Le Tartre;112;5;117
27;Bourgogne-Franche-Comté;71;1;01;535;Tavernay;507;11;518
27;Bourgogne-Franche-Comté;71;1;02;537;Thil-sur-Arroux;131;0;131
27;Bourgogne-Franche-Comté;71;4;26;538;Thurey;439;11;450
27;Bourgogne-Franche-Comté;71;1;01;539;Tintry;79;2;81
27;Bourgogne-Franche-Comté;71;1;12;540;Torcy;2813;39;2852
27;Bourgogne-Franche-Comté;71;4;26;541;Torpes;374;4;378
27;Bourgogne-Franche-Comté;71;3;18;542;Toulon-sur-Arroux;1510;27;1537
27;Bourgogne-Franche-Comté;71;5;29;543;Tournus;5489;338;5827
27;Bourgogne-Franche-Comté;71;2;16;544;Toutenant;194;5;199
27;Bourgogne-Franche-Comté;71;5;08;545;Tramayes;1056;19;1075
27;Bourgogne-Franche-Comté;71;5;08;546;Trambly;404;8;412
27;Bourgogne-Franche-Comté;71;5;08;547;Trivy;259;7;266
27;Bourgogne-Franche-Comté;71;4;24;548;Tronchy;249;2;251
27;Bourgogne-Franche-Comté;71;5;29;549;La Truchère;214;6;220
27;Bourgogne-Franche-Comté;71;5;29;550;Uchizy;825;14;839
27;Bourgogne-Franche-Comté;71;1;02;551;Uchon;91;5;96
27;Bourgogne-Franche-Comté;71;3;18;552;Uxeau;520;13;533
27;Bourgogne-Franche-Comté;71;3;10;553;Vareilles;275;5;280
27;Bourgogne-Franche-Comté;71;3;10;554;Varenne-l'Arconce;113;3;116
27;Bourgogne-Franche-Comté;71;2;27;555;Varennes-le-Grand;2317;48;2365
27;Bourgogne-Franche-Comté;71;5;22;556;Varennes-lès-Mâcon;566;8;574
27;Bourgogne-Franche-Comté;71;3;15;557;Varenne-Saint-Germain;728;17;745
27;Bourgogne-Franche-Comté;71;4;14;558;Varennes-Saint-Sauveur;1132;26;1158
27;Bourgogne-Franche-Comté;71;3;10;559;Varennes-sous-Dun;539;14;553
27;Bourgogne-Franche-Comté;71;3;10;561;Vauban;225;9;234
27;Bourgogne-Franche-Comté;71;3;09;562;Vaudebarrier;212;33;245
27;Bourgogne-Franche-Comté;71;2;11;563;Vaux-en-Pré;74;1;75
27;Bourgogne-Franche-Comté;71;3;09;564;Vendenesse-lès-Charolles;746;20;766
27;Bourgogne-Franche-Comté;71;3;18;565;Vendenesse-sur-Arroux;569;12;581
27;Bourgogne-Franche-Comté;71;2;16;566;Verdun-sur-le-Doubs;1060;8;1068
27;Bourgogne-Franche-Comté;71;5;08;567;Vergisson;257;7;264
27;Bourgogne-Franche-Comté;71;4;20;568;Vérissey;57;0;57
27;Bourgogne-Franche-Comté;71;2;16;570;Verjux;516;14;530
27;Bourgogne-Franche-Comté;71;5;08;571;Verosvres;447;26;473
27;Bourgogne-Franche-Comté;71;2;29;572;Vers;233;0;233
27;Bourgogne-Franche-Comté;71;3;25;573;Versaugues;192;5;197
27;Bourgogne-Franche-Comté;71;5;19;574;Verzé;813;27;840
27;Bourgogne-Franche-Comté;71;5;29;576;Le Villars;279;5;284
27;Bourgogne-Franche-Comté;71;2;24;577;Villegaudin;219;4;223
27;Bourgogne-Franche-Comté;71;2;16;578;Clux-Villeneuve;313;11;324
27;Bourgogne-Franche-Comté;71;2;17;579;Villeneuve-en-Montagne;167;2;169
27;Bourgogne-Franche-Comté;71;4;20;580;Vincelles;418;10;428
27;Bourgogne-Franche-Comté;71;3;25;581;Vindecy;254;5;259
27;Bourgogne-Franche-Comté;71;5;11;582;La Vineuse sur Fregande;650;18;668
27;Bourgogne-Franche-Comté;71;5;08;583;Vinzelles;718;23;741
27;Bourgogne-Franche-Comté;71;5;19;584;Viré;1189;28;1217
27;Bourgogne-Franche-Comté;71;2;05;585;Virey-le-Grand;1366;71;1437
27;Bourgogne-Franche-Comté;71;3;09;586;Viry;258;4;262
27;Bourgogne-Franche-Comté;71;3;25;588;Vitry-en-Charollais;1099;38;1137
27;Bourgogne-Franche-Comté;71;3;15;589;Vitry-sur-Loire;423;8;431
27;Bourgogne-Franche-Comté;71;3;25;590;Volesvres;632;23;655
27;Bourgogne-Franche-Comté;71;5;19;591;Fleurville;521;8;529
52;Pays de la Loire;72;3;11;001;Aigné;1698;37;1735
52;Pays de la Loire;72;2;09;002;Aillières-Beauvoir;205;3;208
52;Pays de la Loire;72;3;16;003;Allonnes;11167;109;11276
52;Pays de la Loire;72;1;07;004;Amné;585;3;588
52;Pays de la Loire;72;2;20;005;Ancinnes;936;22;958
52;Pays de la Loire;72;2;09;006;Arçonnay;1899;232;2131
52;Pays de la Loire;72;2;19;007;Ardenay-sur-Mérize;497;11;508
52;Pays de la Loire;72;3;15;008;Arnage;5503;123;5626
52;Pays de la Loire;72;1;06;009;Arthezé;362;8;370
52;Pays de la Loire;72;1;17;010;Asnières-sur-Vègre;400;11;411
52;Pays de la Loire;72;2;20;011;Assé-le-Boisne;906;17;923
52;Pays de la Loire;72;2;20;012;Assé-le-Riboul;490;10;500
52;Pays de la Loire;72;1;08;013;Aubigné-Racan;2115;27;2142
52;Pays de la Loire;72;2;09;015;Les Aulneaux;114;0;114
52;Pays de la Loire;72;1;17;016;Auvers-le-Hamon;1478;35;1513
52;Pays de la Loire;72;1;07;017;Auvers-sous-Montfaucon;237;3;240
52;Pays de la Loire;72;2;09;018;Avesnes-en-Saosnois;87;1;88
52;Pays de la Loire;72;1;07;019;Avessé;377;9;386
52;Pays de la Loire;72;2;05;020;Avezé;705;17;722
52;Pays de la Loire;72;1;17;021;Avoise;585;7;592
52;Pays de la Loire;72;1;17;022;Le Bailleul;1221;27;1248
52;Pays de la Loire;72;3;01;023;Ballon-Saint Mars;2253;30;2283
52;Pays de la Loire;72;3;01;024;La Bazoge;3646;61;3707
52;Pays de la Loire;72;1;06;025;Bazouges Cré sur Loir;1993;54;2047
52;Pays de la Loire;72;2;01;026;Beaufay;1506;16;1522
52;Pays de la Loire;72;1;03;027;Beaumont-sur-Dême;327;8;335
52;Pays de la Loire;72;1;03;028;Beaumont-Pied-de-Bœuf;484;7;491
52;Pays de la Loire;72;2;20;029;Beaumont-sur-Sarthe;1967;28;1995
52;Pays de la Loire;72;2;05;031;Beillé;529;3;532
52;Pays de la Loire;72;2;18;032;Berfay;333;10;343
52;Pays de la Loire;72;2;20;034;Bérus;442;12;454
52;Pays de la Loire;72;2;18;035;Bessé-sur-Braye;2117;45;2162
52;Pays de la Loire;72;2;20;036;Béthon;309;4;313
52;Pays de la Loire;72;2;09;037;Blèves;120;1;121
52;Pays de la Loire;72;2;05;038;Boëssé-le-Sec;575;1;576
52;Pays de la Loire;72;2;01;039;Bonnétable;3791;57;3848
52;Pays de la Loire;72;2;05;040;La Bosse;142;2;144
52;Pays de la Loire;72;2;05;041;Bouër;344;5;349
52;Pays de la Loire;72;2;18;042;Bouloire;2102;25;2127
52;Pays de la Loire;72;2;20;043;Bourg-le-Roi;327;7;334
52;Pays de la Loire;72;1;06;044;Bousse;436;5;441
52;Pays de la Loire;72;1;07;045;Brains-sur-Gée;829;13;842
52;Pays de la Loire;72;2;19;046;Le Breil-sur-Mérize;1544;27;1571
52;Pays de la Loire;72;3;02;047;Brette-les-Pins;2128;135;2263
52;Pays de la Loire;72;2;01;048;Briosne-lès-Sables;527;4;531
52;Pays de la Loire;72;1;08;049;La Bruère-sur-Loir;247;1;248
52;Pays de la Loire;72;1;07;050;Brûlon;1521;29;1550
52;Pays de la Loire;72;1;08;051;Cérans-Foulletourte;3369;36;3405
52;Pays de la Loire;72;1;03;052;Chahaignes;678;9;687
52;Pays de la Loire;72;3;02;053;Challes;1227;14;1241
52;Pays de la Loire;72;3;02;054;Champagné;3756;68;3824
52;Pays de la Loire;72;2;09;056;Champfleur;1336;24;1360
52;Pays de la Loire;72;2;18;057;Champrond;72;3;75
52;Pays de la Loire;72;3;02;058;Changé;6552;197;6749
52;Pays de la Loire;72;1;07;059;Chantenay-Villedieu;841;19;860
52;Pays de la Loire;72;1;08;060;La Chapelle-aux-Choux;261;3;264
52;Pays de la Loire;72;1;06;061;La Chapelle-d'Aligné;1701;25;1726
52;Pays de la Loire;72;2;05;062;La Chapelle-du-Bois;858;24;882
52;Pays de la Loire;72;2;18;064;La Chapelle-Huon;528;10;538
52;Pays de la Loire;72;3;11;065;La Chapelle-Saint-Aubin;2302;66;2368
52;Pays de la Loire;72;2;07;066;La Chapelle-Saint-Fray;426;7;433
52;Pays de la Loire;72;2;05;067;La Chapelle-Saint-Rémy;990;16;1006
52;Pays de la Loire;72;1;03;068;La Chartre-sur-le-Loir;1384;16;1400
52;Pays de la Loire;72;1;07;070;Chassillé;247;7;254
52;Pays de la Loire;72;1;03;071;Montval-sur-Loir;6038;245;6283
52;Pays de la Loire;72;1;08;072;Château-l'Hermitage;252;2;254
52;Pays de la Loire;72;3;16;073;Chaufour-Notre-Dame;1072;22;1094
52;Pays de la Loire;72;1;07;074;Chemiré-en-Charnie;210;4;214
52;Pays de la Loire;72;1;21;075;Chemiré-le-Gaudin;993;26;1019
52;Pays de la Loire;72;2;09;076;Chenay;241;2;243
52;Pays de la Loire;72;1;08;077;Chenu;426;7;433
52;Pays de la Loire;72;2;20;078;Chérancé;356;3;359
52;Pays de la Loire;72;2;20;079;Chérisay;312;3;315
52;Pays de la Loire;72;2;05;080;Cherré-Au;2731;80;2811
52;Pays de la Loire;72;1;07;083;Chevillé;382;11;393
52;Pays de la Loire;72;1;06;084;Clermont-Créans;1259;35;1294
52;Pays de la Loire;72;2;18;085;Cogners;182;2;184
52;Pays de la Loire;72;2;09;086;Commerveil;138;4;142
52;Pays de la Loire;72;2;18;087;Conflans-sur-Anille;477;14;491
52;Pays de la Loire;72;2;09;088;Congé-sur-Orne;334;11;345
52;Pays de la Loire;72;2;07;089;Conlie;1863;38;1901
52;Pays de la Loire;72;2;19;090;Connerré;2952;59;3011
52;Pays de la Loire;72;2;09;091;Contilly;133;2;135
52;Pays de la Loire;72;2;05;093;Cormes;903;14;917
52;Pays de la Loire;72;2;18;094;Coudrecieux;615;9;624
52;Pays de la Loire;72;3;13;095;Coulaines;7779;116;7895
52;Pays de la Loire;72;1;07;096;Coulans-sur-Gée;1656;82;1738
52;Pays de la Loire;72;1;08;098;Coulongé;505;6;511
52;Pays de la Loire;72;3;01;099;Courcebœufs;638;7;645
52;Pays de la Loire;72;1;06;100;Courcelles-la-Forêt;411;4;415
52;Pays de la Loire;72;2;01;101;Courcemont;676;13;689
52;Pays de la Loire;72;2;01;102;Courcival;98;1;99
52;Pays de la Loire;72;1;03;103;Courdemanche;611;8;619
52;Pays de la Loire;72;2;09;104;Courgains;573;15;588
52;Pays de la Loire;72;2;18;105;Courgenard;490;5;495
52;Pays de la Loire;72;1;17;106;Courtillers;935;28;963
52;Pays de la Loire;72;1;07;107;Crannes-en-Champagne;347;6;353
52;Pays de la Loire;72;2;20;109;Crissé;552;6;558
52;Pays de la Loire;72;1;06;110;Crosmières;1044;20;1064
52;Pays de la Loire;72;2;07;111;Cures;471;15;486
52;Pays de la Loire;72;2;09;112;Dangeul;476;5;481
52;Pays de la Loire;72;2;07;113;Degré;763;12;775
52;Pays de la Loire;72;2;05;114;Dehault;268;6;274
52;Pays de la Loire;72;1;03;115;Dissay-sous-Courcillon;922;22;944
52;Pays de la Loire;72;2;18;118;Dollon;1460;23;1483
52;Pays de la Loire;72;2;07;119;Domfront-en-Champagne;1047;19;1066
52;Pays de la Loire;72;2;20;120;Doucelles;251;3;254
52;Pays de la Loire;72;2;20;121;Douillet;322;10;332
52;Pays de la Loire;72;2;05;122;Duneau;1041;21;1062
52;Pays de la Loire;72;1;17;123;Dureil;72;0;72
52;Pays de la Loire;72;3;04;124;Écommoy;4744;72;4816
52;Pays de la Loire;72;2;18;125;Écorpain;298;9;307
52;Pays de la Loire;72;1;07;126;Épineu-le-Chevreuil;292;9;301
52;Pays de la Loire;72;1;21;127;Étival-lès-le-Mans;1956;37;1993
52;Pays de la Loire;72;2;18;128;Val-d'Étangson;524;5;529
52;Pays de la Loire;72;2;19;129;Fatines;850;16;866
52;Pays de la Loire;72;3;16;130;Fay;705;12;717
52;Pays de la Loire;72;1;21;131;Fercé-sur-Sarthe;593;8;601
52;Pays de la Loire;72;2;05;132;La Ferté-Bernard;8862;337;9199
52;Pays de la Loire;72;1;21;133;Fillé;1489;23;1512
52;Pays de la Loire;72;1;03;134;Flée;532;14;546
52;Pays de la Loire;72;1;08;135;La Fontaine-Saint-Martin;606;6;612
52;Pays de la Loire;72;1;07;136;Fontenay-sur-Vègre;318;8;326
52;Pays de la Loire;72;2;09;137;Villeneuve-en-Perseigne;2191;38;2229
52;Pays de la Loire;72;2;20;138;Fresnay-sur-Sarthe;2889;46;2935
52;Pays de la Loire;72;2;20;139;Fyé;979;41;1020
52;Pays de la Loire;72;2;20;141;Gesnes-le-Gandelin;923;35;958
52;Pays de la Loire;72;2;20;142;Grandchamp;149;5;154
52;Pays de la Loire;72;1;03;143;Le Grand-Lucé;1926;26;1952
52;Pays de la Loire;72;2;18;144;Gréez-sur-Roc;327;4;331
52;Pays de la Loire;72;2;20;145;Le Grez;395;7;402
52;Pays de la Loire;72;1;21;146;Guécélard;3092;54;3146
52;Pays de la Loire;72;3;01;147;La Guierche;1125;24;1149
52;Pays de la Loire;72;2;01;148;Jauzé;82;1;83
52;Pays de la Loire;72;1;07;149;Joué-en-Charnie;629;10;639
52;Pays de la Loire;72;3;01;150;Joué-l'Abbé;1261;23;1284
52;Pays de la Loire;72;1;17;151;Juigné-sur-Sarthe;1136;31;1167
52;Pays de la Loire;72;2;20;152;Juillé;444;11;455
52;Pays de la Loire;72;1;03;153;Jupilles;554;12;566
52;Pays de la Loire;72;1;06;154;La Flèche;14858;1071;15929
52;Pays de la Loire;72;3;04;155;Laigné-en-Belin;2323;30;2353
52;Pays de la Loire;72;2;18;156;Lamnay;932;23;955
52;Pays de la Loire;72;2;07;157;Lavardin;714;13;727
52;Pays de la Loire;72;2;18;158;Lavaré;831;12;843
52;Pays de la Loire;72;1;03;160;Lavernat;586;7;593
52;Pays de la Loire;72;1;03;161;Lhomme;904;13;917
52;Pays de la Loire;72;1;06;163;Ligron;491;9;500
52;Pays de la Loire;72;2;20;164;Livet-en-Saosnois;70;0;70
52;Pays de la Loire;72;2;19;165;Lombron;1911;24;1935
52;Pays de la Loire;72;1;07;166;Longnes;317;10;327
52;Pays de la Loire;72;1;17;167;Louailles;717;12;729
52;Pays de la Loire;72;1;07;168;Loué;2068;41;2109
52;Pays de la Loire;72;1;21;169;Louplande;1460;25;1485
52;Pays de la Loire;72;2;09;170;Louvigny;172;7;179
52;Pays de la Loire;72;2;09;171;Louzes;102;1;103
52;Pays de la Loire;72;2;05;172;Le Luart;1441;13;1454
52;Pays de la Loire;72;1;03;173;Luceau;1231;26;1257
52;Pays de la Loire;72;2;09;174;Lucé-sous-Ballon;102;1;103
52;Pays de la Loire;72;1;08;175;Luché-Pringé;1540;14;1554
52;Pays de la Loire;72;1;08;176;Le Lude;4126;71;4197
52;Pays de la Loire;72;1;07;177;Maigné;354;4;358
52;Pays de la Loire;72;2;18;178;Maisoncelles;191;1;192
52;Pays de la Loire;72;1;21;179;Malicorne-sur-Sarthe;1884;34;1918
52;Pays de la Loire;72;2;09;180;Mamers;5157;171;5328
52;Pays de la Loire;72;3;99;181;Le Mans;143847;2856;146703
52;Pays de la Loire;72;1;08;182;Mansigné;1544;29;1573
52;Pays de la Loire;72;1;03;183;Marçon;1068;16;1084
52;Pays de la Loire;72;1;07;184;Mareil-en-Champagne;384;6;390
52;Pays de la Loire;72;1;06;185;Mareil-sur-Loir;661;9;670
52;Pays de la Loire;72;2;20;186;Maresché;887;11;898
52;Pays de la Loire;72;3;04;187;Marigné-Laillé;1611;17;1628
52;Pays de la Loire;72;2;09;188;Marollette;151;2;153
52;Pays de la Loire;72;2;09;189;Marolles-les-Braults;2109;26;2135
52;Pays de la Loire;72;2;18;190;Marolles-lès-Saint-Calais;277;4;281
52;Pays de la Loire;72;1;08;191;Mayet;3120;39;3159
52;Pays de la Loire;72;2;09;192;Les Mées;95;2;97
52;Pays de la Loire;72;2;18;193;Melleray;430;7;437
52;Pays de la Loire;72;2;09;194;Meurcé;267;2;269
52;Pays de la Loire;72;1;21;195;Mézeray;1874;28;1902
52;Pays de la Loire;72;2;09;196;Mézières-sur-Ponthouin;732;6;738
52;Pays de la Loire;72;2;07;197;Mézières-sous-Lavardin;689;5;694
52;Pays de la Loire;72;3;11;198;La Milesse;2637;36;2673
52;Pays de la Loire;72;2;20;199;Moitron-sur-Sarthe;281;1;282
52;Pays de la Loire;72;3;04;200;Moncé-en-Belin;3703;62;3765
52;Pays de la Loire;72;2;09;201;Moncé-en-Saosnois;259;4;263
52;Pays de la Loire;72;2;09;202;Monhoudou;198;11;209
52;Pays de la Loire;72;2;18;204;Montaillé;521;6;527
52;Pays de la Loire;72;3;01;205;Montbizot;1804;26;1830
52;Pays de la Loire;72;2;18;208;Montmirail;374;9;383
52;Pays de la Loire;72;2;20;209;Montreuil-le-Chétif;304;1;305
52;Pays de la Loire;72;1;03;210;Montreuil-le-Henri;304;5;309
52;Pays de la Loire;72;2;20;211;Mont-Saint-Jean;638;11;649
52;Pays de la Loire;72;2;20;212;Moulins-le-Carbonnel;699;13;712
52;Pays de la Loire;72;3;04;213;Mulsanne;5225;63;5288
52;Pays de la Loire;72;2;09;214;Nauvay;10;2;12
52;Pays de la Loire;72;2;09;215;Neufchâtel-en-Saosnois;1034;12;1046
52;Pays de la Loire;72;2;07;216;Neuvillalais;595;14;609
52;Pays de la Loire;72;3;01;217;Neuville-sur-Sarthe;2448;48;2496
52;Pays de la Loire;72;2;20;218;Neuvillette-en-Charnie;291;4;295
52;Pays de la Loire;72;2;07;219;Bernay-Neuvy-en-Champagne;874;58;932
52;Pays de la Loire;72;2;01;220;Nogent-le-Bernard;902;37;939
52;Pays de la Loire;72;1;03;221;Nogent-sur-Loir;372;4;376
52;Pays de la Loire;72;2;09;222;Nouans;271;0;271
52;Pays de la Loire;72;1;07;223;Noyen-sur-Sarthe;2624;32;2656
52;Pays de la Loire;72;2;19;224;Nuillé-le-Jalais;533;3;536
52;Pays de la Loire;72;2;20;225;Oisseau-le-Petit;667;8;675
52;Pays de la Loire;72;1;08;226;Oizé;1333;17;1350
52;Pays de la Loire;72;2;09;227;Panon;41;0;41
52;Pays de la Loire;72;1;17;228;Parcé-sur-Sarthe;2084;50;2134
52;Pays de la Loire;72;2;20;229;Parennes;472;7;479
52;Pays de la Loire;72;1;21;230;Parigné-le-Pôlin;1073;27;1100
52;Pays de la Loire;72;3;02;231;Parigné-l'Évêque;5286;82;5368
52;Pays de la Loire;72;1;17;232;Notre-Dame-du-Pé;657;10;667
52;Pays de la Loire;72;2;09;233;Peray;60;0;60
52;Pays de la Loire;72;2;20;234;Pezé-le-Robert;365;10;375
52;Pays de la Loire;72;2;20;235;Piacé;376;7;383
52;Pays de la Loire;72;1;17;236;Pincé;191;8;199
52;Pays de la Loire;72;1;07;237;Pirmil;501;6;507
52;Pays de la Loire;72;2;09;238;Pizieux;73;0;73
52;Pays de la Loire;72;1;07;239;Poillé-sur-Vègre;612;21;633
52;Pays de la Loire;72;2;19;241;Montfort-le-Gesnois;2931;48;2979
52;Pays de la Loire;72;1;08;243;Pontvallain;1645;25;1670
52;Pays de la Loire;72;1;17;244;Précigné;2957;64;3021
52;Pays de la Loire;72;2;05;245;Préval;685;15;700
52;Pays de la Loire;72;2;05;246;Prévelles;208;6;214
52;Pays de la Loire;72;3;16;247;Pruillé-le-Chétif;1338;31;1369
52;Pays de la Loire;72;1;03;248;Pruillé-l'Éguillé;821;24;845
52;Pays de la Loire;72;2;07;249;La Quinte;763;13;776
52;Pays de la Loire;72;2;18;250;Rahay;151;9;160
52;Pays de la Loire;72;2;09;251;René;386;5;391
52;Pays de la Loire;72;1;08;252;Requeil;1142;10;1152
52;Pays de la Loire;72;1;21;253;Roézé-sur-Sarthe;2615;69;2684
52;Pays de la Loire;72;2;20;254;Rouessé-Fontaine;268;6;274
52;Pays de la Loire;72;2;20;255;Rouessé-Vassé;800;16;816
52;Pays de la Loire;72;2;20;256;Rouez;791;7;798
52;Pays de la Loire;72;3;10;257;Rouillon;2316;319;2635
52;Pays de la Loire;72;2;01;259;Rouperroux-le-Coquet;282;7;289
52;Pays de la Loire;72;3;04;260;Ruaudin;3503;69;3572
52;Pays de la Loire;72;2;07;261;Ruillé-en-Champagne;302;12;314
52;Pays de la Loire;72;1;03;262;Loir en Vallée;2163;174;2337
52;Pays de la Loire;72;1;17;264;Sablé-sur-Sarthe;12125;456;12581
52;Pays de la Loire;72;2;09;265;Saint-Aignan;236;2;238
52;Pays de la Loire;72;2;20;266;Saint-Aubin-de-Locquenay;733;17;750
52;Pays de la Loire;72;2;05;267;Saint-Aubin-des-Coudrais;912;21;933
52;Pays de la Loire;72;3;04;268;Saint-Biez-en-Belin;706;11;717
52;Pays de la Loire;72;2;18;269;Saint-Calais;3244;195;3439
52;Pays de la Loire;72;2;09;270;Saint-Calez-en-Saosnois;193;1;194
52;Pays de la Loire;72;2;19;271;Saint-Célerin;927;15;942
52;Pays de la Loire;72;2;18;272;Sainte-Cérotte;315;6;321
52;Pays de la Loire;72;2;20;273;Saint-Christophe-du-Jambet;232;3;235
52;Pays de la Loire;72;1;07;274;Saint-Christophe-en-Champagne;207;7;214
52;Pays de la Loire;72;2;19;275;Saint-Corneille;1521;15;1536
52;Pays de la Loire;72;2;09;276;Saint-Cosme-en-Vairais;1917;46;1963
52;Pays de la Loire;72;2;05;277;Saint-Denis-des-Coudrais;114;1;115
52;Pays de la Loire;72;1;07;278;Saint-Denis-d'Orques;773;11;784
52;Pays de la Loire;72;1;03;279;Saint-Georges-de-la-Couée;153;3;156
52;Pays de la Loire;72;3;16;280;Saint-Georges-du-Bois;2155;36;2191
52;Pays de la Loire;72;2;01;281;Saint-Georges-du-Rosay;443;5;448
52;Pays de la Loire;72;2;20;282;Saint-Georges-le-Gaultier;536;5;541
52;Pays de la Loire;72;1;08;283;Saint-Germain-d'Arcé;334;5;339
52;Pays de la Loire;72;2;18;286;Saint-Gervais-de-Vic;387;7;394
52;Pays de la Loire;72;3;04;287;Saint-Gervais-en-Belin;2021;44;2065
52;Pays de la Loire;72;3;01;289;Sainte-Jamme-sur-Sarthe;2035;33;2068
52;Pays de la Loire;72;3;01;290;Saint-Jean-d'Assé;1811;15;1826
52;Pays de la Loire;72;1;08;291;Saint-Jean-de-la-Motte;982;20;1002
52;Pays de la Loire;72;2;18;292;Saint-Jean-des-Échelles;238;5;243
52;Pays de la Loire;72;1;21;293;Saint-Jean-du-Bois;617;7;624
52;Pays de la Loire;72;2;20;294;Saint-Léonard-des-Bois;471;15;486
52;Pays de la Loire;72;2;09;295;Saint-Longis;499;7;506
52;Pays de la Loire;72;2;18;296;Saint-Maixent;746;21;767
52;Pays de la Loire;72;2;20;297;Saint-Marceau;547;12;559
52;Pays de la Loire;72;2;18;298;Saint-Mars-de-Locquenay;576;10;586
52;Pays de la Loire;72;3;02;299;Saint-Mars-d'Outillé;2439;34;2473
52;Pays de la Loire;72;2;19;300;Saint-Mars-la-Brière;2698;29;2727
52;Pays de la Loire;72;2;05;302;Saint-Martin-des-Monts;173;4;177
52;Pays de la Loire;72;2;18;303;Saint-Michel-de-Chavaignes;731;10;741
52;Pays de la Loire;72;2;20;305;Saint-Ouen-de-Mimbré;968;25;993
52;Pays de la Loire;72;3;04;306;Saint-Ouen-en-Belin;1322;24;1346
52;Pays de la Loire;72;1;07;307;Saint-Ouen-en-Champagne;239;6;245
52;Pays de la Loire;72;2;09;308;Saint-Paterne - Le Chevain;2106;248;2354
52;Pays de la Loire;72;2;20;309;Saint-Paul-le-Gaultier;285;7;292
52;Pays de la Loire;72;3;01;310;Saint-Pavace;1916;58;1974
52;Pays de la Loire;72;1;03;311;Saint-Pierre-de-Chevillé;351;6;357
52;Pays de la Loire;72;1;07;312;Saint-Pierre-des-Bois;234;3;237
52;Pays de la Loire;72;2;09;313;Saint-Pierre-des-Ormes;224;5;229
52;Pays de la Loire;72;1;03;314;Saint-Pierre-du-Lorouër;375;8;383
52;Pays de la Loire;72;2;20;315;Saint-Rémy-de-Sillé;829;14;843
52;Pays de la Loire;72;2;09;316;Saint-Rémy-des-Monts;686;21;707
52;Pays de la Loire;72;2;09;317;Saint-Rémy-du-Val;501;18;519
52;Pays de la Loire;72;2;07;319;Sainte-Sabine-sur-Longève;742;19;761
52;Pays de la Loire;72;3;11;320;Saint-Saturnin;2590;81;2671
52;Pays de la Loire;72;2;07;321;Saint-Symphorien;516;10;526
52;Pays de la Loire;72;2;18;322;Saint-Ulphace;224;2;226
52;Pays de la Loire;72;2;20;323;Saint-Victeur;459;2;461
52;Pays de la Loire;72;2;09;324;Saint-Vincent-des-Prés;506;14;520
52;Pays de la Loire;72;1;03;325;Saint-Vincent-du-Lorouër;840;17;857
52;Pays de la Loire;72;2;09;326;Saosnes;208;5;213
52;Pays de la Loire;72;1;08;327;Sarcé;300;4;304
52;Pays de la Loire;72;3;02;328;Sargé-lès-le-Mans;3709;140;3849
52;Pays de la Loire;72;2;19;329;Savigné-l'Évêque;4064;83;4147
52;Pays de la Loire;72;1;08;330;Savigné-sous-le-Lude;432;13;445
52;Pays de la Loire;72;2;05;331;Sceaux-sur-Huisne;579;11;590
52;Pays de la Loire;72;2;20;332;Ségrie;605;8;613
52;Pays de la Loire;72;2;18;333;Semur-en-Vallon;441;11;452
52;Pays de la Loire;72;2;20;334;Sillé-le-Guillaume;2231;86;2317
52;Pays de la Loire;72;2;19;335;Sillé-le-Philippe;1075;15;1090
52;Pays de la Loire;72;1;17;336;Solesmes;1214;40;1254
52;Pays de la Loire;72;2;20;337;Sougé-le-Ganelon;865;20;885
52;Pays de la Loire;72;3;01;338;Souillé;743;10;753
52;Pays de la Loire;72;1;21;339;Souligné-Flacé;672;10;682
52;Pays de la Loire;72;3;01;340;Souligné-sous-Ballon;1239;23;1262
52;Pays de la Loire;72;2;19;341;Soulitré;624;12;636
52;Pays de la Loire;72;2;05;342;Souvigné-sur-Même;165;7;172
52;Pays de la Loire;72;1;17;343;Souvigné-sur-Sarthe;626;11;637
52;Pays de la Loire;72;1;21;344;Spay;2881;48;2929
52;Pays de la Loire;72;2;19;345;Surfonds;339;5;344
52;Pays de la Loire;72;1;21;346;La Suze-sur-Sarthe;4473;56;4529
52;Pays de la Loire;72;1;07;347;Tassé;300;5;305
52;Pays de la Loire;72;1;07;348;Tassillé;129;1;130
52;Pays de la Loire;72;3;01;349;Teillé;476;2;478
52;Pays de la Loire;72;3;04;350;Teloché;3056;61;3117
52;Pays de la Loire;72;2;07;351;Tennie;1051;20;1071
52;Pays de la Loire;72;2;01;352;Terrehault;139;0;139
52;Pays de la Loire;72;2;05;353;Théligny;215;5;220
52;Pays de la Loire;72;2;09;354;Thoigné;161;4;165
52;Pays de la Loire;72;2;20;355;Thoiré-sous-Contensor;106;1;107
52;Pays de la Loire;72;1;03;356;Thoiré-sur-Dinan;414;5;419
52;Pays de la Loire;72;1;06;357;Thorée-les-Pins;729;12;741
52;Pays de la Loire;72;2;18;358;Thorigné-sur-Dué;1615;37;1652
52;Pays de la Loire;72;2;19;359;Torcé-en-Vallée;1429;9;1438
52;Pays de la Loire;72;3;16;360;Trangé;1509;34;1543
52;Pays de la Loire;72;2;18;361;Tresson;484;8;492
52;Pays de la Loire;72;2;20;362;Le Tronchet;165;1;166
52;Pays de la Loire;72;2;05;363;Tuffé Val de la Chéronne;1663;16;1679
52;Pays de la Loire;72;1;08;364;Vaas;1432;25;1457
52;Pays de la Loire;72;2;18;366;Valennes;315;4;319
52;Pays de la Loire;72;1;07;367;Vallon-sur-Gée;793;12;805
52;Pays de la Loire;72;2;18;368;Vancé;322;6;328
52;Pays de la Loire;72;1;08;369;Verneil-le-Chétif;594;64;658
52;Pays de la Loire;72;2;20;370;Vernie;328;6;334
52;Pays de la Loire;72;2;09;372;Vezot;77;1;78
52;Pays de la Loire;72;2;18;373;Vibraye;2510;55;2565
52;Pays de la Loire;72;2;09;374;Villaines-la-Carelle;148;5;153
52;Pays de la Loire;72;2;05;375;Villaines-la-Gonais;539;14;553
52;Pays de la Loire;72;1;03;376;Villaines-sous-Lucé;707;21;728
52;Pays de la Loire;72;1;06;377;Villaines-sous-Malicorne;1033;11;1044
52;Pays de la Loire;72;1;17;378;Vion;1445;33;1478
52;Pays de la Loire;72;1;07;379;Viré-en-Champagne;195;6;201
52;Pays de la Loire;72;2;20;380;Vivoin;947;22;969
52;Pays de la Loire;72;1;21;381;Voivres-lès-le-Mans;1370;11;1381
52;Pays de la Loire;72;2;18;382;Volnay;943;18;961
52;Pays de la Loire;72;2;05;383;Vouvray-sur-Huisne;132;4;136
52;Pays de la Loire;72;1;08;385;Yvré-le-Pôlin;1766;24;1790
52;Pays de la Loire;72;3;02;386;Yvré-l'Évêque;4261;133;4394
84;Auvergne-Rhône-Alpes;73;2;14;001;Aiguebelette-le-Lac;232;9;241
84;Auvergne-Rhône-Alpes;73;1;13;003;Grand-Aigueblanche;3838;113;3951
84;Auvergne-Rhône-Alpes;73;2;16;004;Aillon-le-Jeune;433;16;449
84;Auvergne-Rhône-Alpes;73;2;16;005;Aillon-le-Vieux;182;4;186
84;Auvergne-Rhône-Alpes;73;1;05;006;Aime-la-Plagne;4444;109;4553
84;Auvergne-Rhône-Alpes;73;3;18;007;Aiton;1679;22;1701
84;Auvergne-Rhône-Alpes;73;2;97;008;Aix-les-Bains;30463;577;31040
84;Auvergne-Rhône-Alpes;73;2;01;010;Entrelacs;6315;141;6456
84;Auvergne-Rhône-Alpes;73;1;98;011;Albertville;19502;564;20066
84;Auvergne-Rhône-Alpes;73;3;17;012;Albiez-le-Jeune;147;2;149
84;Auvergne-Rhône-Alpes;73;3;17;013;Albiez-Montrond;365;10;375
84;Auvergne-Rhône-Alpes;73;1;03;014;Allondaz;288;2;290
84;Auvergne-Rhône-Alpes;73;1;13;015;Les Allues;1860;43;1903
84;Auvergne-Rhône-Alpes;73;2;11;017;Apremont;987;21;1008
84;Auvergne-Rhône-Alpes;73;2;11;018;Arbin;769;21;790
84;Auvergne-Rhône-Alpes;73;3;18;019;Argentine;955;20;975
84;Auvergne-Rhône-Alpes;73;2;16;020;Arith;443;11;454
84;Auvergne-Rhône-Alpes;73;2;11;021;Arvillard;850;17;867
84;Auvergne-Rhône-Alpes;73;2;14;022;Attignat-Oncin;563;15;578
84;Auvergne-Rhône-Alpes;73;3;10;023;Aussois;698;23;721
84;Auvergne-Rhône-Alpes;73;1;13;024;Les Avanchers-Valmorel;778;22;800
84;Auvergne-Rhône-Alpes;73;2;06;025;Avressieux;526;11;537
84;Auvergne-Rhône-Alpes;73;3;10;026;Avrieux;389;14;403
84;Auvergne-Rhône-Alpes;73;2;14;027;Ayn;387;6;393
84;Auvergne-Rhône-Alpes;73;2;06;028;La Balme;337;3;340
84;Auvergne-Rhône-Alpes;73;2;15;029;Barberaz;5022;118;5140
84;Auvergne-Rhône-Alpes;73;2;16;030;Barby;3429;41;3470
84;Auvergne-Rhône-Alpes;73;2;16;031;Bassens;4785;121;4906
84;Auvergne-Rhône-Alpes;73;1;03;032;La Bâthie;2152;37;2189
84;Auvergne-Rhône-Alpes;73;2;14;033;La Bauche;494;5;499
84;Auvergne-Rhône-Alpes;73;1;19;034;Beaufort;2034;89;2123
84;Auvergne-Rhône-Alpes;73;2;16;036;Bellecombe-en-Bauges;683;18;701
84;Auvergne-Rhône-Alpes;73;2;14;039;Belmont-Tramonet;536;12;548
84;Auvergne-Rhône-Alpes;73;3;10;040;Bessans;359;8;367
84;Auvergne-Rhône-Alpes;73;2;18;041;Betton-Bettonet;306;6;312
84;Auvergne-Rhône-Alpes;73;2;06;042;Billième;263;7;270
84;Auvergne-Rhône-Alpes;73;2;01;043;La Biolle;2781;35;2816
84;Auvergne-Rhône-Alpes;73;3;10;047;Bonneval-sur-Arc;259;9;268
84;Auvergne-Rhône-Alpes;73;1;04;048;Bonvillard;355;14;369
84;Auvergne-Rhône-Alpes;73;3;18;049;Bonvillaret;148;0;148
84;Auvergne-Rhône-Alpes;73;2;12;050;Bourdeau;574;21;595
84;Auvergne-Rhône-Alpes;73;2;12;051;Le Bourget-du-Lac;4966;99;5065
84;Auvergne-Rhône-Alpes;73;2;11;052;Bourget-en-Huile;147;4;151
84;Auvergne-Rhône-Alpes;73;2;18;053;Bourgneuf;690;11;701
84;Auvergne-Rhône-Alpes;73;1;05;054;Bourg-Saint-Maurice;7195;401;7596
84;Auvergne-Rhône-Alpes;73;1;13;055;Bozel;1876;58;1934
84;Auvergne-Rhône-Alpes;73;1;13;057;Brides-les-Bains;500;12;512
84;Auvergne-Rhône-Alpes;73;2;14;058;La Bridoire;1272;19;1291
84;Auvergne-Rhône-Alpes;73;2;01;059;Brison-Saint-Innocent;2262;69;2331
84;Auvergne-Rhône-Alpes;73;1;19;061;Césarches;423;15;438
84;Auvergne-Rhône-Alpes;73;1;03;063;Cevins;718;10;728
84;Auvergne-Rhône-Alpes;73;2;15;064;Challes-les-Eaux;5609;273;5882
84;Auvergne-Rhône-Alpes;73;2;99;065;Chambéry;58917;1561;60478
84;Auvergne-Rhône-Alpes;73;3;17;067;La Chambre;1151;22;1173
84;Auvergne-Rhône-Alpes;73;2;18;068;Chamousset;587;20;607
84;Auvergne-Rhône-Alpes;73;2;18;069;Chamoux-sur-Gelon;952;17;969
84;Auvergne-Rhône-Alpes;73;2;06;070;Champagneux;702;8;710
84;Auvergne-Rhône-Alpes;73;1;13;071;Champagny-en-Vanoise;565;22;587
84;Auvergne-Rhône-Alpes;73;2;18;072;Champ-Laurent;33;1;34
84;Auvergne-Rhône-Alpes;73;2;06;073;Chanaz;535;7;542
84;Auvergne-Rhône-Alpes;73;3;17;074;La Chapelle;330;11;341
84;Auvergne-Rhône-Alpes;73;2;11;075;La Chapelle-Blanche;572;21;593
84;Auvergne-Rhône-Alpes;73;2;12;076;La Chapelle-du-Mont-du-Chat;261;4;265
84;Auvergne-Rhône-Alpes;73;1;05;077;Les Chapelles;563;10;573
84;Auvergne-Rhône-Alpes;73;2;06;078;La Chapelle-Saint-Martin;144;6;150
84;Auvergne-Rhône-Alpes;73;2;18;079;Châteauneuf;924;15;939
84;Auvergne-Rhône-Alpes;73;2;16;081;Le Châtelard;668;44;712
84;Auvergne-Rhône-Alpes;73;2;11;082;La Chavanne;747;38;785
84;Auvergne-Rhône-Alpes;73;3;17;083;Les Chavannes-en-Maurienne;222;3;225
84;Auvergne-Rhône-Alpes;73;2;11;084;Chignin;952;27;979
84;Auvergne-Rhône-Alpes;73;2;06;085;Chindrieux;1394;21;1415
84;Auvergne-Rhône-Alpes;73;1;04;086;Cléry;393;12;405
84;Auvergne-Rhône-Alpes;73;2;09;087;Cognin;6359;184;6543
84;Auvergne-Rhône-Alpes;73;1;19;088;Cohennoz;159;8;167
84;Auvergne-Rhône-Alpes;73;2;18;089;Coise-Saint-Jean-Pied-Gauthier;1269;22;1291
84;Auvergne-Rhône-Alpes;73;2;16;090;La Compôte;264;7;271
84;Auvergne-Rhône-Alpes;73;2;06;091;Conjux;207;3;210
84;Auvergne-Rhône-Alpes;73;2;14;092;Corbel;153;4;157
84;Auvergne-Rhône-Alpes;73;1;19;094;Crest-Voland;336;14;350
84;Auvergne-Rhône-Alpes;73;2;11;095;La Croix-de-la-Rochette;382;8;390
84;Auvergne-Rhône-Alpes;73;2;18;096;Cruet;1041;19;1060
84;Auvergne-Rhône-Alpes;73;2;16;097;Curienne;678;21;699
84;Auvergne-Rhône-Alpes;73;2;16;098;Les Déserts;811;22;833
84;Auvergne-Rhône-Alpes;73;2;11;099;Détrier;433;4;437
84;Auvergne-Rhône-Alpes;73;2;14;100;Domessin;1904;46;1950
84;Auvergne-Rhône-Alpes;73;2;16;101;Doucy-en-Bauges;96;3;99
84;Auvergne-Rhône-Alpes;73;2;12;103;Drumettaz-Clarafond;2934;67;3001
84;Auvergne-Rhône-Alpes;73;2;14;104;Dullin;479;5;484
84;Auvergne-Rhône-Alpes;73;2;14;105;Les Échelles;1239;17;1256
84;Auvergne-Rhône-Alpes;73;2;16;106;École;303;6;309
84;Auvergne-Rhône-Alpes;73;2;14;107;Entremont-le-Vieux;644;8;652
84;Auvergne-Rhône-Alpes;73;3;18;109;Épierre;777;9;786
84;Auvergne-Rhône-Alpes;73;1;03;110;Esserts-Blay;782;7;789
84;Auvergne-Rhône-Alpes;73;1;13;113;Feissons-sur-Salins;177;3;180
84;Auvergne-Rhône-Alpes;73;1;19;114;Flumet;802;29;831
84;Auvergne-Rhône-Alpes;73;3;17;116;Fontcouverte-la-Toussuire;481;12;493
84;Auvergne-Rhône-Alpes;73;3;10;117;Fourneaux;691;9;700
84;Auvergne-Rhône-Alpes;73;3;10;119;Freney;99;4;103
84;Auvergne-Rhône-Alpes;73;2;18;120;Fréterive;609;14;623
84;Auvergne-Rhône-Alpes;73;1;04;121;Frontenex;1928;49;1977
84;Auvergne-Rhône-Alpes;73;2;06;122;Gerbaix;424;19;443
84;Auvergne-Rhône-Alpes;73;1;19;123;La Giettaz;387;15;402
84;Auvergne-Rhône-Alpes;73;1;04;124;Gilly-sur-Isère;3042;78;3120
84;Auvergne-Rhône-Alpes;73;2;01;128;Grésy-sur-Aix;4595;101;4696
84;Auvergne-Rhône-Alpes;73;1;04;129;Grésy-sur-Isère;1215;39;1254
84;Auvergne-Rhône-Alpes;73;1;04;130;Grignon;2107;38;2145
84;Auvergne-Rhône-Alpes;73;1;13;131;Hautecour;303;8;311
84;Auvergne-Rhône-Alpes;73;1;19;132;Hauteluce;758;23;781
84;Auvergne-Rhône-Alpes;73;2;18;133;Hauteville;351;7;358
84;Auvergne-Rhône-Alpes;73;3;17;135;La Tour-en-Maurienne;1079;26;1105
84;Auvergne-Rhône-Alpes;73;2;08;137;Jacob-Bellecombette;4047;78;4125
84;Auvergne-Rhône-Alpes;73;3;17;138;Jarrier;491;11;502
84;Auvergne-Rhône-Alpes;73;2;16;139;Jarsy;271;12;283
84;Auvergne-Rhône-Alpes;73;2;06;140;Jongieux;283;7;290
84;Auvergne-Rhône-Alpes;73;2;11;141;Laissaud;687;14;701
84;Auvergne-Rhône-Alpes;73;1;05;142;Landry;817;20;837
84;Auvergne-Rhône-Alpes;73;2;14;145;Lépin-le-Lac;464;14;478
84;Auvergne-Rhône-Alpes;73;2;16;146;Lescheraines;781;17;798
84;Auvergne-Rhône-Alpes;73;2;06;147;Loisieux;202;0;202
84;Auvergne-Rhône-Alpes;73;2;06;149;Lucey;305;6;311
84;Auvergne-Rhône-Alpes;73;1;05;150;La Plagne Tarentaise;3766;128;3894
84;Auvergne-Rhône-Alpes;73;2;11;151;Porte-de-Savoie;3796;88;3884
84;Auvergne-Rhône-Alpes;73;2;06;152;Marcieux;213;5;218
84;Auvergne-Rhône-Alpes;73;1;19;153;Marthod;1352;31;1383
84;Auvergne-Rhône-Alpes;73;1;03;154;Mercury;3299;94;3393
84;Auvergne-Rhône-Alpes;73;2;12;155;Méry;2013;42;2055
84;Auvergne-Rhône-Alpes;73;2;06;156;Meyrieux-Trouet;313;6;319
84;Auvergne-Rhône-Alpes;73;3;10;157;Modane;3075;136;3211
84;Auvergne-Rhône-Alpes;73;2;11;159;Les Mollettes;845;8;853
84;Auvergne-Rhône-Alpes;73;2;14;160;Montagnole;978;26;1004
84;Auvergne-Rhône-Alpes;73;1;13;161;Montagny;654;14;668
84;Auvergne-Rhône-Alpes;73;1;04;162;Montailleur;678;24;702
84;Auvergne-Rhône-Alpes;73;2;01;164;Montcel;1011;61;1072
84;Auvergne-Rhône-Alpes;73;2;18;166;Montendry;54;2;56
84;Auvergne-Rhône-Alpes;73;3;18;168;Montgilbert;119;1;120
84;Auvergne-Rhône-Alpes;73;1;04;170;Monthion;526;11;537
84;Auvergne-Rhône-Alpes;73;2;11;171;Montmélian;4102;71;4173
84;Auvergne-Rhône-Alpes;73;3;17;173;Montricher-Albanne;475;11;486
84;Auvergne-Rhône-Alpes;73;3;18;175;Montsapey;73;0;73
84;Auvergne-Rhône-Alpes;73;1;05;176;Montvalezan;709;10;719
84;Auvergne-Rhône-Alpes;73;3;17;177;Montvernier;238;7;245
84;Auvergne-Rhône-Alpes;73;2;16;178;La Motte-en-Bauges;505;11;516
84;Auvergne-Rhône-Alpes;73;2;12;179;La Motte-Servolex;12120;611;12731
84;Auvergne-Rhône-Alpes;73;2;06;180;Motz;435;7;442
84;Auvergne-Rhône-Alpes;73;1;13;181;Moûtiers;3496;458;3954
84;Auvergne-Rhône-Alpes;73;2;02;182;Mouxy;2241;54;2295
84;Auvergne-Rhône-Alpes;73;2;11;183;Myans;1289;34;1323
84;Auvergne-Rhône-Alpes;73;2;14;184;Nances;509;11;520
84;Auvergne-Rhône-Alpes;73;1;19;186;Notre-Dame-de-Bellecombe;477;14;491
84;Auvergne-Rhône-Alpes;73;1;13;187;La Léchère;2635;56;2691
84;Auvergne-Rhône-Alpes;73;1;04;188;Notre-Dame-des-Millières;1029;25;1054
84;Auvergne-Rhône-Alpes;73;3;17;189;Notre-Dame-du-Cruet;227;2;229
84;Auvergne-Rhône-Alpes;73;1;13;190;Notre-Dame-du-Pré;247;6;253
84;Auvergne-Rhône-Alpes;73;2;06;191;Novalaise;2147;69;2216
84;Auvergne-Rhône-Alpes;73;2;16;192;Le Noyer;213;5;218
84;Auvergne-Rhône-Alpes;73;2;06;193;Ontex;106;3;109
84;Auvergne-Rhône-Alpes;73;3;10;194;Orelle;328;9;337
84;Auvergne-Rhône-Alpes;73;1;19;196;Pallud;789;19;808
84;Auvergne-Rhône-Alpes;73;1;05;197;Peisey-Nancroix;641;25;666
84;Auvergne-Rhône-Alpes;73;2;11;200;Planaise;553;7;560
84;Auvergne-Rhône-Alpes;73;1;13;201;Planay;441;14;455
84;Auvergne-Rhône-Alpes;73;1;04;202;Plancherine;454;10;464
84;Auvergne-Rhône-Alpes;73;2;14;204;Le Pont-de-Beauvoisin;2075;32;2107
84;Auvergne-Rhône-Alpes;73;2;11;205;Le Pontet;117;4;121
84;Auvergne-Rhône-Alpes;73;1;13;206;Pralognan-la-Vanoise;715;23;738
84;Auvergne-Rhône-Alpes;73;2;11;207;Presle;432;12;444
84;Auvergne-Rhône-Alpes;73;2;01;208;Pugny-Chatenod;950;40;990
84;Auvergne-Rhône-Alpes;73;2;16;210;Puygros;379;5;384
84;Auvergne-Rhône-Alpes;73;1;19;211;Queige;782;24;806
84;Auvergne-Rhône-Alpes;73;3;18;212;Val-d'Arc;2018;29;2047
84;Auvergne-Rhône-Alpes;73;2;15;213;La Ravoire;8530;546;9076
84;Auvergne-Rhône-Alpes;73;2;06;214;Rochefort;235;10;245
84;Auvergne-Rhône-Alpes;73;2;11;215;Valgelon-La Rochette;4160;100;4260
84;Auvergne-Rhône-Alpes;73;1;03;216;Rognaix;487;6;493
84;Auvergne-Rhône-Alpes;73;2;11;217;Rotherens;368;12;380
84;Auvergne-Rhône-Alpes;73;2;06;218;Ruffieux;816;16;832
84;Auvergne-Rhône-Alpes;73;2;14;219;Saint-Alban-de-Montbel;663;16;679
84;Auvergne-Rhône-Alpes;73;3;18;220;Saint-Alban-d'Hurtières;366;11;377
84;Auvergne-Rhône-Alpes;73;3;17;221;Saint-Alban-des-Villards;88;3;91
84;Auvergne-Rhône-Alpes;73;2;16;222;Saint-Alban-Leysse;6285;209;6494
84;Auvergne-Rhône-Alpes;73;3;10;223;Saint-André;446;6;452
84;Auvergne-Rhône-Alpes;73;3;17;224;Saint-Avre;889;21;910
84;Auvergne-Rhône-Alpes;73;2;15;225;Saint-Baldoph;2759;91;2850
84;Auvergne-Rhône-Alpes;73;2;14;226;Saint-Béron;1706;22;1728
84;Auvergne-Rhône-Alpes;73;1;13;227;Courchevel;2360;73;2433
84;Auvergne-Rhône-Alpes;73;2;14;228;Saint-Cassin;905;24;929
84;Auvergne-Rhône-Alpes;73;2;14;229;Saint-Christophe;533;13;546
84;Auvergne-Rhône-Alpes;73;3;17;230;Saint-Colomban-des-Villards;132;0;132
84;Auvergne-Rhône-Alpes;73;3;17;231;Saint-Étienne-de-Cuines;1205;23;1228
84;Auvergne-Rhône-Alpes;73;1;05;232;Sainte-Foy-Tarentaise;729;24;753
84;Auvergne-Rhône-Alpes;73;2;14;233;Saint-Franc;162;8;170
84;Auvergne-Rhône-Alpes;73;2;16;234;Saint-François-de-Sales;149;4;153
84;Auvergne-Rhône-Alpes;73;3;17;235;Saint François Longchamp;545;6;551
84;Auvergne-Rhône-Alpes;73;2;06;236;Saint-Genix-les-Villages;2905;67;2972
84;Auvergne-Rhône-Alpes;73;3;18;237;Saint-Georges-d'Hurtières;350;3;353
84;Auvergne-Rhône-Alpes;73;2;11;240;Sainte-Hélène-du-Lac;793;20;813
84;Auvergne-Rhône-Alpes;73;1;04;241;Sainte-Hélène-sur-Isère;1196;21;1217
84;Auvergne-Rhône-Alpes;73;3;17;242;Saint-Jean-d'Arves;272;10;282
84;Auvergne-Rhône-Alpes;73;2;16;243;Saint-Jean-d'Arvey;1726;57;1783
84;Auvergne-Rhône-Alpes;73;2;06;245;Saint-Jean-de-Chevelu;823;16;839
84;Auvergne-Rhône-Alpes;73;2;14;246;Saint-Jean-de-Couz;299;5;304
84;Auvergne-Rhône-Alpes;73;2;18;247;Saint-Jean-de-la-Porte;956;71;1027
84;Auvergne-Rhône-Alpes;73;3;17;248;Saint-Jean-de-Maurienne;7621;345;7966
84;Auvergne-Rhône-Alpes;73;2;15;249;Saint-Jeoire-Prieuré;1866;46;1912
84;Auvergne-Rhône-Alpes;73;3;17;250;Saint-Julien-Mont-Denis;1627;44;1671
84;Auvergne-Rhône-Alpes;73;3;18;252;Saint-Léger;239;3;242
84;Auvergne-Rhône-Alpes;73;1;13;253;Saint-Marcel;601;8;609
84;Auvergne-Rhône-Alpes;73;2;06;254;Sainte-Marie-d'Alvey;120;2;122
84;Auvergne-Rhône-Alpes;73;3;17;255;Sainte-Marie-de-Cuines;818;21;839
84;Auvergne-Rhône-Alpes;73;3;10;256;Saint-Martin-d'Arc;327;8;335
84;Auvergne-Rhône-Alpes;73;1;13;257;Les Belleville;3494;117;3611
84;Auvergne-Rhône-Alpes;73;3;10;258;Saint-Martin-de-la-Porte;679;20;699
84;Auvergne-Rhône-Alpes;73;3;17;259;Saint-Martin-sur-la-Chambre;544;14;558
84;Auvergne-Rhône-Alpes;73;3;10;261;Saint-Michel-de-Maurienne;2467;280;2747
84;Auvergne-Rhône-Alpes;73;1;19;262;Saint-Nicolas-la-Chapelle;472;35;507
84;Auvergne-Rhône-Alpes;73;2;01;263;Saint-Offenge;1145;22;1167
84;Auvergne-Rhône-Alpes;73;2;01;265;Saint-Ours;723;19;742
84;Auvergne-Rhône-Alpes;73;3;17;267;Saint-Pancrace;297;10;307
84;Auvergne-Rhône-Alpes;73;1;03;268;Saint-Paul-sur-Isère;529;59;588
84;Auvergne-Rhône-Alpes;73;2;06;269;Saint-Paul;724;13;737
84;Auvergne-Rhône-Alpes;73;2;18;270;Saint-Pierre-d'Albigny;4097;103;4200
84;Auvergne-Rhône-Alpes;73;2;06;271;Saint-Pierre-d'Alvey;307;10;317
84;Auvergne-Rhône-Alpes;73;3;18;272;Saint-Pierre-de-Belleville;178;4;182
84;Auvergne-Rhône-Alpes;73;2;06;273;Saint-Pierre-de-Curtille;487;6;493
84;Auvergne-Rhône-Alpes;73;2;14;274;Saint-Pierre-d'Entremont;451;15;466
84;Auvergne-Rhône-Alpes;73;2;14;275;Saint-Pierre-de-Genebroz;321;8;329
84;Auvergne-Rhône-Alpes;73;2;11;276;Saint-Pierre-de-Soucy;415;18;433
84;Auvergne-Rhône-Alpes;73;2;16;277;Sainte-Reine;172;7;179
84;Auvergne-Rhône-Alpes;73;3;17;278;Saint-Rémy-de-Maurienne;1238;21;1259
84;Auvergne-Rhône-Alpes;73;3;17;280;Saint-Sorlin-d'Arves;344;8;352
84;Auvergne-Rhône-Alpes;73;2;14;281;Saint-Sulpice;747;20;767
84;Auvergne-Rhône-Alpes;73;2;14;282;Saint-Thibaud-de-Couz;1062;19;1081
84;Auvergne-Rhône-Alpes;73;1;04;283;Saint-Vital;709;14;723
84;Auvergne-Rhône-Alpes;73;1;13;284;Salins-Fontaine;997;19;1016
84;Auvergne-Rhône-Alpes;73;1;05;285;Séez;2322;70;2392
84;Auvergne-Rhône-Alpes;73;2;06;286;Serrières-en-Chautagne;1168;21;1189
84;Auvergne-Rhône-Alpes;73;2;07;288;Sonnaz;2002;46;2048
84;Auvergne-Rhône-Alpes;73;2;11;289;La Table;427;9;436
84;Auvergne-Rhône-Alpes;73;3;10;290;Val-Cenis;2062;38;2100
84;Auvergne-Rhône-Alpes;73;1;19;292;Thénésol;318;7;325
84;Auvergne-Rhône-Alpes;73;2;16;293;Thoiry;455;7;462
84;Auvergne-Rhône-Alpes;73;2;16;294;La Thuile;338;7;345
84;Auvergne-Rhône-Alpes;73;1;05;296;Tignes;2020;42;2062
84;Auvergne-Rhône-Alpes;73;1;04;297;Tournon;592;22;614
84;Auvergne-Rhône-Alpes;73;1;03;298;Tours-en-Savoie;910;11;921
84;Auvergne-Rhône-Alpes;73;2;06;299;Traize;325;6;331
84;Auvergne-Rhône-Alpes;73;2;02;300;Tresserve;2988;106;3094
84;Auvergne-Rhône-Alpes;73;2;01;301;Trévignin;814;16;830
84;Auvergne-Rhône-Alpes;73;2;11;302;La Trinité;338;3;341
84;Auvergne-Rhône-Alpes;73;1;19;303;Ugine;7096;289;7385
84;Auvergne-Rhône-Alpes;73;1;05;304;Val-d'Isère;1583;46;1629
84;Auvergne-Rhône-Alpes;73;3;10;306;Valloire;1066;25;1091
84;Auvergne-Rhône-Alpes;73;3;10;307;Valmeinier;566;3;569
84;Auvergne-Rhône-Alpes;73;1;19;308;Venthon;593;18;611
84;Auvergne-Rhône-Alpes;73;2;14;309;Verel-de-Montbel;300;5;305
84;Auvergne-Rhône-Alpes;73;2;16;310;Verel-Pragondran;479;12;491
84;Auvergne-Rhône-Alpes;73;2;11;311;Le Verneil;105;1;106
84;Auvergne-Rhône-Alpes;73;1;04;312;Verrens-Arvey;918;31;949
84;Auvergne-Rhône-Alpes;73;2;06;313;Verthemex;230;1;231
84;Auvergne-Rhône-Alpes;73;2;11;314;Villard-d'Héry;261;5;266
84;Auvergne-Rhône-Alpes;73;2;18;315;Villard-Léger;457;8;465
84;Auvergne-Rhône-Alpes;73;2;11;316;Villard-Sallet;290;4;294
84;Auvergne-Rhône-Alpes;73;1;19;317;Villard-sur-Doron;705;27;732
84;Auvergne-Rhône-Alpes;73;3;17;318;Villarembert;252;9;261
84;Auvergne-Rhône-Alpes;73;3;17;320;Villargondran;853;25;878
84;Auvergne-Rhône-Alpes;73;3;10;322;Villarodin-Bourget;536;14;550
84;Auvergne-Rhône-Alpes;73;1;05;323;Villaroger;360;15;375
84;Auvergne-Rhône-Alpes;73;2;11;324;Villaroux;193;8;201
84;Auvergne-Rhône-Alpes;73;2;14;326;Vimines;2114;40;2154
84;Auvergne-Rhône-Alpes;73;2;06;327;Vions;395;6;401
84;Auvergne-Rhône-Alpes;73;2;12;328;Viviers-du-Lac;2269;57;2326
84;Auvergne-Rhône-Alpes;73;2;12;329;Voglans;1911;37;1948
84;Auvergne-Rhône-Alpes;73;2;06;330;Yenne;3002;34;3036
84;Auvergne-Rhône-Alpes;74;4;07;001;Abondance;1447;117;1564
84;Auvergne-Rhône-Alpes;74;1;12;002;Alby-sur-Chéran;2576;55;2631
84;Auvergne-Rhône-Alpes;74;1;08;003;Alex;1102;35;1137
84;Auvergne-Rhône-Alpes;74;1;12;004;Allèves;415;8;423
84;Auvergne-Rhône-Alpes;74;4;17;005;Allinges;4681;125;4806
84;Auvergne-Rhône-Alpes;74;3;11;006;Allonzier-la-Caille;2191;30;2221
84;Auvergne-Rhône-Alpes;74;2;11;007;Amancy;2739;54;2793
84;Auvergne-Rhône-Alpes;74;3;04;008;Ambilly;6138;67;6205
84;Auvergne-Rhône-Alpes;74;3;11;009;Andilly;953;18;971
84;Auvergne-Rhône-Alpes;74;1;99;010;Annecy;130721;3380;134101
84;Auvergne-Rhône-Alpes;74;3;04;012;Annemasse;36582;396;36978
84;Auvergne-Rhône-Alpes;74;4;15;013;Anthy-sur-Léman;2198;91;2289
84;Auvergne-Rhône-Alpes;74;2;14;014;Arâches-la-Frasse;1847;54;1901
84;Auvergne-Rhône-Alpes;74;3;11;015;Arbusigny;1140;24;1164
84;Auvergne-Rhône-Alpes;74;3;13;016;Archamps;2609;35;2644
84;Auvergne-Rhône-Alpes;74;2;05;018;Arenthon;1866;48;1914
84;Auvergne-Rhône-Alpes;74;1;03;019;Argonay;3370;270;3640
84;Auvergne-Rhône-Alpes;74;4;17;020;Armoy;1359;57;1416
84;Auvergne-Rhône-Alpes;74;3;09;021;Arthaz-Pont-Notre-Dame;1623;30;1653
84;Auvergne-Rhône-Alpes;74;2;05;024;Ayse;2219;60;2279
84;Auvergne-Rhône-Alpes;74;4;15;025;Ballaison;1492;21;1513
84;Auvergne-Rhône-Alpes;74;1;01;026;La Balme-de-Sillingy;5078;163;5241
84;Auvergne-Rhône-Alpes;74;1;08;027;La Balme-de-Thuy;455;9;464
84;Auvergne-Rhône-Alpes;74;3;13;029;Bassy;419;14;433
84;Auvergne-Rhône-Alpes;74;4;07;030;La Baume;321;6;327
84;Auvergne-Rhône-Alpes;74;3;13;031;Beaumont;3027;67;3094
84;Auvergne-Rhône-Alpes;74;4;17;032;Bellevaux;1273;40;1313
84;Auvergne-Rhône-Alpes;74;4;07;033;Bernex;1384;28;1412
84;Auvergne-Rhône-Alpes;74;4;07;034;Le Biot;615;7;622
84;Auvergne-Rhône-Alpes;74;1;12;035;Bloye;592;24;616
84;Auvergne-Rhône-Alpes;74;1;08;036;Bluffy;376;12;388
84;Auvergne-Rhône-Alpes;74;4;15;037;Boëge;1861;61;1922
84;Auvergne-Rhône-Alpes;74;4;15;038;Bogève;1133;29;1162
84;Auvergne-Rhône-Alpes;74;3;09;040;Bonne;3181;143;3324
84;Auvergne-Rhône-Alpes;74;4;07;041;Bonnevaux;281;5;286
84;Auvergne-Rhône-Alpes;74;2;05;042;Bonneville;12509;406;12915
84;Auvergne-Rhône-Alpes;74;4;15;043;Bons-en-Chablais;5739;109;5848
84;Auvergne-Rhône-Alpes;74;3;13;044;Bossey;1042;12;1054
84;Auvergne-Rhône-Alpes;74;1;08;045;Le Bouchet-Mont-Charvin;249;6;255
84;Auvergne-Rhône-Alpes;74;1;12;046;Boussy;506;12;518
84;Auvergne-Rhône-Alpes;74;4;15;048;Brenthonne;1096;22;1118
84;Auvergne-Rhône-Alpes;74;2;05;049;Brizon;482;2;484
84;Auvergne-Rhône-Alpes;74;4;15;050;Burdignin;673;16;689
84;Auvergne-Rhône-Alpes;74;3;11;051;Cercier;696;11;707
84;Auvergne-Rhône-Alpes;74;3;11;052;Cernex;1055;17;1072
84;Auvergne-Rhône-Alpes;74;4;17;053;Cervens;1233;22;1255
84;Auvergne-Rhône-Alpes;74;1;12;054;Chainaz-les-Frasses;759;28;787
84;Auvergne-Rhône-Alpes;74;3;13;055;Challonges;544;13;557
84;Auvergne-Rhône-Alpes;74;2;10;056;Chamonix-Mont-Blanc;8640;386;9026
84;Auvergne-Rhône-Alpes;74;4;07;057;Champanges;1111;31;1142
84;Auvergne-Rhône-Alpes;74;4;07;058;La Chapelle-d'Abondance;932;17;949
84;Auvergne-Rhône-Alpes;74;2;11;059;La Chapelle-Rambaud;261;6;267
84;Auvergne-Rhône-Alpes;74;1;16;060;La Chapelle-Saint-Maurice;115;0;115
84;Auvergne-Rhône-Alpes;74;1;12;061;Chapeiry;931;35;966
84;Auvergne-Rhône-Alpes;74;1;03;062;Charvonnex;1428;26;1454
84;Auvergne-Rhône-Alpes;74;4;07;063;Châtel;1246;42;1288
84;Auvergne-Rhône-Alpes;74;2;06;064;Châtillon-sur-Cluses;1194;44;1238
84;Auvergne-Rhône-Alpes;74;3;13;065;Chaumont;499;15;514
84;Auvergne-Rhône-Alpes;74;3;13;066;Chavannaz;253;2;255
84;Auvergne-Rhône-Alpes;74;1;16;067;Chavanod;2683;168;2851
84;Auvergne-Rhône-Alpes;74;3;13;068;Chêne-en-Semine;519;8;527
84;Auvergne-Rhône-Alpes;74;3;13;069;Chênex;810;14;824
84;Auvergne-Rhône-Alpes;74;4;15;070;Chens-sur-Léman;2792;35;2827
84;Auvergne-Rhône-Alpes;74;3;13;071;Chessenaz;221;6;227
84;Auvergne-Rhône-Alpes;74;1;08;072;Chevaline;202;6;208
84;Auvergne-Rhône-Alpes;74;4;07;073;Chevenoz;662;12;674
84;Auvergne-Rhône-Alpes;74;3;13;074;Chevrier;626;7;633
84;Auvergne-Rhône-Alpes;74;3;13;075;Chilly;1441;22;1463
84;Auvergne-Rhône-Alpes;74;1;01;076;Choisy;1660;43;1703
84;Auvergne-Rhône-Alpes;74;3;13;077;Clarafond-Arcine;1034;26;1060
84;Auvergne-Rhône-Alpes;74;3;13;078;Clermont;405;6;411
84;Auvergne-Rhône-Alpes;74;1;08;079;Les Clefs;675;6;681
84;Auvergne-Rhône-Alpes;74;1;08;080;La Clusaz;1709;53;1762
84;Auvergne-Rhône-Alpes;74;2;06;081;Cluses;16918;405;17323
84;Auvergne-Rhône-Alpes;74;3;13;082;Collonges-sous-Salève;3948;117;4065
84;Auvergne-Rhône-Alpes;74;2;14;083;Combloux;2104;115;2219
84;Auvergne-Rhône-Alpes;74;2;10;085;Les Contamines-Montjoie;1118;47;1165
84;Auvergne-Rhône-Alpes;74;3;13;086;Contamine-Sarzin;722;12;734
84;Auvergne-Rhône-Alpes;74;2;05;087;Contamine-sur-Arve;2204;152;2356
84;Auvergne-Rhône-Alpes;74;3;11;088;Copponex;1195;22;1217
84;Auvergne-Rhône-Alpes;74;2;14;089;Cordon;984;26;1010
84;Auvergne-Rhône-Alpes;74;2;11;090;Cornier;1385;20;1405
84;Auvergne-Rhône-Alpes;74;2;07;091;La Côte-d'Arbroz;362;2;364
84;Auvergne-Rhône-Alpes;74;3;09;094;Cranves-Sales;6975;167;7142
84;Auvergne-Rhône-Alpes;74;1;12;095;Crempigny-Bonneguête;319;10;329
84;Auvergne-Rhône-Alpes;74;3;11;096;Cruseilles;4502;315;4817
84;Auvergne-Rhône-Alpes;74;1;12;097;Cusy;1836;55;1891
84;Auvergne-Rhône-Alpes;74;1;11;098;Cuvat;1541;54;1595
84;Auvergne-Rhône-Alpes;74;2;14;099;Demi-Quartier;844;37;881
84;Auvergne-Rhône-Alpes;74;3;13;100;Desingy;785;25;810
84;Auvergne-Rhône-Alpes;74;3;13;101;Dingy-en-Vuache;709;17;726
84;Auvergne-Rhône-Alpes;74;1;08;102;Dingy-Saint-Clair;1441;47;1488
84;Auvergne-Rhône-Alpes;74;2;14;103;Domancy;2195;76;2271
84;Auvergne-Rhône-Alpes;74;1;08;104;Doussard;3542;85;3627
84;Auvergne-Rhône-Alpes;74;4;15;105;Douvaine;6483;80;6563
84;Auvergne-Rhône-Alpes;74;4;17;106;Draillant;902;31;933
84;Auvergne-Rhône-Alpes;74;3;13;107;Droisy;154;5;159
84;Auvergne-Rhône-Alpes;74;1;16;108;Duingt;994;21;1015
84;Auvergne-Rhône-Alpes;74;3;13;109;Éloise;927;19;946
84;Auvergne-Rhône-Alpes;74;1;16;111;Entrevernes;212;3;215
84;Auvergne-Rhône-Alpes;74;1;03;112;Epagny Metz-Tessy;8196;198;8394
84;Auvergne-Rhône-Alpes;74;4;07;114;Essert-Romand;512;6;518
84;Auvergne-Rhône-Alpes;74;2;11;116;Etaux;2021;70;2091
84;Auvergne-Rhône-Alpes;74;1;12;117;Étercy;838;21;859
84;Auvergne-Rhône-Alpes;74;3;09;118;Étrembières;2556;29;2585
84;Auvergne-Rhône-Alpes;74;4;07;119;Évian-les-Bains;9108;251;9359
84;Auvergne-Rhône-Alpes;74;4;15;121;Excenevex;1168;17;1185
84;Auvergne-Rhône-Alpes;74;2;05;122;Faucigny;640;21;661
84;Auvergne-Rhône-Alpes;74;1;08;123;Faverges-Seythenex;7609;227;7836
84;Auvergne-Rhône-Alpes;74;3;13;124;Feigères;1757;32;1789
84;Auvergne-Rhône-Alpes;74;4;15;126;Fessy;990;31;1021
84;Auvergne-Rhône-Alpes;74;4;07;127;Féternes;1433;43;1476
84;Auvergne-Rhône-Alpes;74;3;05;128;Fillinges;3516;88;3604
84;Auvergne-Rhône-Alpes;74;4;07;129;La Forclaz;227;4;231
84;Auvergne-Rhône-Alpes;74;3;13;130;Franclens;540;31;571
84;Auvergne-Rhône-Alpes;74;3;13;131;Frangy;2052;39;2091
84;Auvergne-Rhône-Alpes;74;3;09;133;Gaillard;10071;108;10179
84;Auvergne-Rhône-Alpes;74;2;07;134;Les Gets;1215;27;1242
84;Auvergne-Rhône-Alpes;74;1;08;135;Giez;525;8;533
84;Auvergne-Rhône-Alpes;74;1;08;136;Le Grand-Bornand;2096;48;2144
84;Auvergne-Rhône-Alpes;74;1;03;137;Groisy;3900;147;4047
84;Auvergne-Rhône-Alpes;74;1;12;138;Gruffy;1522;62;1584
84;Auvergne-Rhône-Alpes;74;4;15;139;Habère-Lullin;1051;31;1082
84;Auvergne-Rhône-Alpes;74;4;15;140;Habère-Poche;1475;27;1502
84;Auvergne-Rhône-Alpes;74;1;12;141;Hauteville-sur-Fier;1029;26;1055
84;Auvergne-Rhône-Alpes;74;1;12;142;Héry-sur-Alby;983;31;1014
84;Auvergne-Rhône-Alpes;74;2;10;143;Les Houches;3007;80;3087
84;Auvergne-Rhône-Alpes;74;3;13;144;Jonzier-Épagny;827;20;847
84;Auvergne-Rhône-Alpes;74;3;09;145;Juvigny;630;12;642
84;Auvergne-Rhône-Alpes;74;4;07;146;Larringes;1506;46;1552
84;Auvergne-Rhône-Alpes;74;1;08;147;Lathuile;1008;26;1034
84;Auvergne-Rhône-Alpes;74;1;16;148;Leschaux;273;7;280
84;Auvergne-Rhône-Alpes;74;4;15;150;Loisin;1633;29;1662
84;Auvergne-Rhône-Alpes;74;1;12;151;Lornay;572;9;581
84;Auvergne-Rhône-Alpes;74;1;01;152;Lovagny;1257;41;1298
84;Auvergne-Rhône-Alpes;74;3;09;153;Lucinges;1607;65;1672
84;Auvergne-Rhône-Alpes;74;4;07;154;Lugrin;2504;52;2556
84;Auvergne-Rhône-Alpes;74;4;17;155;Lullin;802;28;830
84;Auvergne-Rhône-Alpes;74;4;15;156;Lully;690;13;703
84;Auvergne-Rhône-Alpes;74;4;17;157;Lyaud;1741;63;1804
84;Auvergne-Rhône-Alpes;74;3;09;158;Machilly;1098;17;1115
84;Auvergne-Rhône-Alpes;74;2;14;159;Magland;3240;68;3308
84;Auvergne-Rhône-Alpes;74;1;08;160;Manigod;996;23;1019
84;Auvergne-Rhône-Alpes;74;1;12;161;Marcellaz-Albanais;1953;57;2010
84;Auvergne-Rhône-Alpes;74;2;05;162;Marcellaz;1052;18;1070
84;Auvergne-Rhône-Alpes;74;4;15;163;Margencel;2197;78;2275
84;Auvergne-Rhône-Alpes;74;2;05;164;Marignier;6372;185;6557
84;Auvergne-Rhône-Alpes;74;1;12;165;Marigny-Saint-Marcel;693;9;702
84;Auvergne-Rhône-Alpes;74;4;07;166;Marin;1842;52;1894
84;Auvergne-Rhône-Alpes;74;1;08;167;Val de Chaise;1383;24;1407
84;Auvergne-Rhône-Alpes;74;3;13;168;Marlioz;1053;11;1064
84;Auvergne-Rhône-Alpes;74;2;06;169;Marnaz;5642;116;5758
84;Auvergne-Rhône-Alpes;74;1;12;170;Massingy;874;19;893
84;Auvergne-Rhône-Alpes;74;4;15;171;Massongy;1534;34;1568
84;Auvergne-Rhône-Alpes;74;4;07;172;Maxilly-sur-Léman;1453;34;1487
84;Auvergne-Rhône-Alpes;74;2;14;173;Megève;3025;128;3153
84;Auvergne-Rhône-Alpes;74;2;05;174;Mégevette;590;25;615
84;Auvergne-Rhône-Alpes;74;4;07;175;Meillerie;314;6;320
84;Auvergne-Rhône-Alpes;74;1;08;176;Menthon-Saint-Bernard;1884;70;1954
84;Auvergne-Rhône-Alpes;74;3;11;177;Menthonnex-en-Bornes;1082;20;1102
84;Auvergne-Rhône-Alpes;74;3;13;178;Menthonnex-sous-Clermont;729;13;742
84;Auvergne-Rhône-Alpes;74;1;01;179;Mésigny;780;27;807
84;Auvergne-Rhône-Alpes;74;4;15;180;Messery;2150;50;2200
84;Auvergne-Rhône-Alpes;74;2;06;183;Mieussy;2421;64;2485
84;Auvergne-Rhône-Alpes;74;3;13;184;Minzier;1045;20;1065
84;Auvergne-Rhône-Alpes;74;3;11;185;Monnetier-Mornex;2318;45;2363
84;Auvergne-Rhône-Alpes;74;1;16;186;Montagny-les-Lanches;760;22;782
84;Auvergne-Rhône-Alpes;74;4;07;188;Montriond;939;24;963
84;Auvergne-Rhône-Alpes;74;2;06;189;Mont-Saxonnex;1667;54;1721
84;Auvergne-Rhône-Alpes;74;2;06;190;Morillon;676;13;689
84;Auvergne-Rhône-Alpes;74;4;07;191;Morzine;2717;74;2791
84;Auvergne-Rhône-Alpes;74;1;12;192;Moye;983;37;1020
84;Auvergne-Rhône-Alpes;74;3;11;193;La Muraz;1061;11;1072
84;Auvergne-Rhône-Alpes;74;1;12;194;Mûres;881;24;905
84;Auvergne-Rhône-Alpes;74;3;13;195;Musièges;420;8;428
84;Auvergne-Rhône-Alpes;74;2;06;196;Nancy-sur-Cluses;465;15;480
84;Auvergne-Rhône-Alpes;74;3;11;197;Nangy;1604;34;1638
84;Auvergne-Rhône-Alpes;74;1;03;198;Nâves-Parmelan;1006;40;1046
84;Auvergne-Rhône-Alpes;74;4;15;199;Nernier;378;7;385
84;Auvergne-Rhône-Alpes;74;4;07;200;Neuvecelle;3122;95;3217
84;Auvergne-Rhône-Alpes;74;3;13;201;Neydens;2152;23;2175
84;Auvergne-Rhône-Alpes;74;1;01;202;Nonglard;719;8;727
84;Auvergne-Rhône-Alpes;74;4;07;203;Novel;49;2;51
84;Auvergne-Rhône-Alpes;74;2;05;205;Onnion;1288;29;1317
84;Auvergne-Rhône-Alpes;74;4;17;206;Orcier;1030;18;1048
84;Auvergne-Rhône-Alpes;74;2;10;208;Passy;11233;423;11656
84;Auvergne-Rhône-Alpes;74;2;05;209;Peillonnex;1381;40;1421
84;Auvergne-Rhône-Alpes;74;4;17;210;Perrignier;1885;40;1925
84;Auvergne-Rhône-Alpes;74;3;11;211;Pers-Jussy;3108;90;3198
84;Auvergne-Rhône-Alpes;74;2;05;212;Glières-Val-de-Borne;1814;30;1844
84;Auvergne-Rhône-Alpes;74;1;01;213;Poisy;8233;359;8592
84;Auvergne-Rhône-Alpes;74;2;14;215;Praz-sur-Arly;1241;36;1277
84;Auvergne-Rhône-Alpes;74;3;13;216;Présilly;1054;17;1071
84;Auvergne-Rhône-Alpes;74;4;07;218;Publier;7341;213;7554
84;Auvergne-Rhône-Alpes;74;1;16;219;Quintal;1252;50;1302
84;Auvergne-Rhône-Alpes;74;3;11;220;Reignier-Ésery;8072;196;8268
84;Auvergne-Rhône-Alpes;74;2;06;221;Le Reposoir;536;21;557
84;Auvergne-Rhône-Alpes;74;4;17;222;Reyvroz;504;9;513
84;Auvergne-Rhône-Alpes;74;2;06;223;La Rivière-Enverse;470;5;475
84;Auvergne-Rhône-Alpes;74;2;11;224;La Roche-sur-Foron;11149;342;11491
84;Auvergne-Rhône-Alpes;74;1;12;225;Rumilly;15768;377;16145
84;Auvergne-Rhône-Alpes;74;4;15;226;Saint-André-de-Boëge;575;12;587
84;Auvergne-Rhône-Alpes;74;3;11;228;Saint-Blaise;351;12;363
84;Auvergne-Rhône-Alpes;74;3;09;229;Saint-Cergues;3671;74;3745
84;Auvergne-Rhône-Alpes;74;1;12;231;Saint-Eusèbe;594;14;608
84;Auvergne-Rhône-Alpes;74;1;16;232;Saint-Eustache;498;21;519
84;Auvergne-Rhône-Alpes;74;1;12;233;Saint-Félix;2418;30;2448
84;Auvergne-Rhône-Alpes;74;1;08;234;Saint-Ferréol;876;22;898
84;Auvergne-Rhône-Alpes;74;3;13;235;Saint-Germain-sur-Rhône;587;12;599
84;Auvergne-Rhône-Alpes;74;2;10;236;Saint-Gervais-les-Bains;5604;130;5734
84;Auvergne-Rhône-Alpes;74;4;07;237;Saint-Gingolph;886;4;890
84;Auvergne-Rhône-Alpes;74;4;07;238;Saint-Jean-d'Aulps;1558;26;1584
84;Auvergne-Rhône-Alpes;74;1;08;239;Saint-Jean-de-Sixt;1461;38;1499
84;Auvergne-Rhône-Alpes;74;2;05;240;Saint-Jean-de-Tholome;1007;28;1035
84;Auvergne-Rhône-Alpes;74;2;05;241;Saint-Jeoire;3370;101;3471
84;Auvergne-Rhône-Alpes;74;1;16;242;Saint-Jorioz;6008;200;6208
84;Auvergne-Rhône-Alpes;74;3;13;243;Saint-Julien-en-Genevois;15873;252;16125
84;Auvergne-Rhône-Alpes;74;2;11;244;Saint-Laurent;839;34;873
84;Auvergne-Rhône-Alpes;74;4;07;249;Saint-Paul-en-Chablais;2487;83;2570
84;Auvergne-Rhône-Alpes;74;2;05;250;Saint-Pierre-en-Faucigny;7091;139;7230
84;Auvergne-Rhône-Alpes;74;2;06;252;Saint-Sigismond;585;33;618
84;Auvergne-Rhône-Alpes;74;2;11;253;Saint-Sixt;1018;38;1056
84;Auvergne-Rhône-Alpes;74;1;12;254;Saint-Sylvestre;605;16;621
84;Auvergne-Rhône-Alpes;74;1;12;255;Sales;2060;51;2111
84;Auvergne-Rhône-Alpes;74;2;14;256;Sallanches;16831;491;17322
84;Auvergne-Rhône-Alpes;74;1;01;257;Sallenôves;765;21;786
84;Auvergne-Rhône-Alpes;74;2;06;258;Samoëns;2473;63;2536
84;Auvergne-Rhône-Alpes;74;3;11;259;Le Sappey;434;8;442
84;Auvergne-Rhône-Alpes;74;3;13;260;Savigny;980;21;1001
84;Auvergne-Rhône-Alpes;74;4;15;261;Saxel;484;8;492
84;Auvergne-Rhône-Alpes;74;3;11;262;Scientrier;1148;21;1169
84;Auvergne-Rhône-Alpes;74;4;15;263;Sciez;6348;144;6492
84;Auvergne-Rhône-Alpes;74;2;06;264;Scionzier;8932;138;9070
84;Auvergne-Rhône-Alpes;74;1;08;265;Serraval;702;72;774
84;Auvergne-Rhône-Alpes;74;2;10;266;Servoz;1057;35;1092
84;Auvergne-Rhône-Alpes;74;1;02;267;Sevrier;4139;182;4321
84;Auvergne-Rhône-Alpes;74;3;13;269;Seyssel;2351;79;2430
84;Auvergne-Rhône-Alpes;74;4;07;271;Seytroux;519;13;532
84;Auvergne-Rhône-Alpes;74;1;01;272;Sillingy;5365;130;5495
84;Auvergne-Rhône-Alpes;74;2;06;273;Sixt-Fer-à-Cheval;759;18;777
84;Auvergne-Rhône-Alpes;74;1;08;275;Talloires-Montmin;1948;67;2015
84;Auvergne-Rhône-Alpes;74;2;06;276;Taninges;3394;71;3465
84;Auvergne-Rhône-Alpes;74;2;06;278;Thyez;6330;150;6480
84;Auvergne-Rhône-Alpes;74;4;07;279;Thollon-les-Mémises;831;25;856
84;Auvergne-Rhône-Alpes;74;1;08;280;Thônes;6598;284;6882
84;Auvergne-Rhône-Alpes;74;4;17;281;Thonon-les-Bains;35826;1147;36973
84;Auvergne-Rhône-Alpes;74;1;03;282;Fillière;9449;236;9685
84;Auvergne-Rhône-Alpes;74;1;12;283;Thusy;1131;19;1150
84;Auvergne-Rhône-Alpes;74;2;05;284;La Tour;1301;25;1326
84;Auvergne-Rhône-Alpes;74;3;13;285;Usinens;415;9;424
84;Auvergne-Rhône-Alpes;74;4;07;286;Vacheresse;859;17;876
84;Auvergne-Rhône-Alpes;74;4;17;287;Vailly;914;20;934
84;Auvergne-Rhône-Alpes;74;3;13;288;Valleiry;4935;60;4995
84;Auvergne-Rhône-Alpes;74;1;12;289;Vallières-sur-Fier;2562;59;2621
84;Auvergne-Rhône-Alpes;74;2;10;290;Vallorcine;406;12;418
84;Auvergne-Rhône-Alpes;74;3;13;291;Vanzy;336;4;340
84;Auvergne-Rhône-Alpes;74;1;12;292;Vaulx;1022;30;1052
84;Auvergne-Rhône-Alpes;74;4;15;293;Veigy-Foncenex;3919;44;3963
84;Auvergne-Rhône-Alpes;74;2;06;294;Verchaix;755;20;775
84;Auvergne-Rhône-Alpes;74;4;07;295;La Vernaz;343;5;348
84;Auvergne-Rhône-Alpes;74;3;13;296;Vers;918;18;936
84;Auvergne-Rhône-Alpes;74;1;12;297;Versonnex;610;25;635
84;Auvergne-Rhône-Alpes;74;3;09;298;Vétraz-Monthoux;9003;264;9267
84;Auvergne-Rhône-Alpes;74;1;08;299;Veyrier-du-Lac;2276;82;2358
84;Auvergne-Rhône-Alpes;74;4;15;301;Villard;905;19;924
84;Auvergne-Rhône-Alpes;74;1;08;302;Les Villards-sur-Thônes;1071;37;1108
84;Auvergne-Rhône-Alpes;74;1;03;303;Villaz;3347;126;3473
84;Auvergne-Rhône-Alpes;74;2;05;304;Ville-en-Sallaz;933;10;943
84;Auvergne-Rhône-Alpes;74;3;04;305;Ville-la-Grand;9050;119;9169
84;Auvergne-Rhône-Alpes;74;3;11;306;Villy-le-Bouveret;594;17;611
84;Auvergne-Rhône-Alpes;74;1;11;307;Villy-le-Pelloux;989;16;1005
84;Auvergne-Rhône-Alpes;74;4;07;308;Vinzier;844;23;867
84;Auvergne-Rhône-Alpes;74;3;13;309;Viry;5415;82;5497
84;Auvergne-Rhône-Alpes;74;1;12;310;Viuz-la-Chiésaz;1307;33;1340
84;Auvergne-Rhône-Alpes;74;2;05;311;Viuz-en-Sallaz;4454;78;4532
84;Auvergne-Rhône-Alpes;74;2;05;312;Vougy;1581;28;1609
84;Auvergne-Rhône-Alpes;74;3;11;313;Vovray-en-Bornes;555;11;566
84;Auvergne-Rhône-Alpes;74;3;13;314;Vulbens;1630;55;1685
84;Auvergne-Rhône-Alpes;74;4;15;315;Yvoire;1067;19;1086
11;Île-de-France;75;1;  ;101;Paris 1er Arrondissement;15917;138;16055
11;Île-de-France;75;1;  ;102;Paris 2e Arrondissement;21595;140;21735
11;Île-de-France;75;1;  ;103;Paris 3e Arrondissement;34025;281;34306
11;Île-de-France;75;1;  ;104;Paris 4e Arrondissement;29131;259;29390
11;Île-de-France;75;1;  ;105;Paris 5e Arrondissement;58227;670;58897
11;Île-de-France;75;1;  ;106;Paris 6e Arrondissement;40303;868;41171
11;Île-de-France;75;1;  ;107;Paris 7e Arrondissement;48888;793;49681
11;Île-de-France;75;1;  ;108;Paris 8e Arrondissement;35655;595;36250
11;Île-de-France;75;1;  ;109;Paris 9e Arrondissement;60026;537;60563
11;Île-de-France;75;1;  ;110;Paris 10e Arrondissement;86472;391;86863
11;Île-de-France;75;1;  ;111;Paris 11e Arrondissement;145208;820;146028
11;Île-de-France;75;1;  ;112;Paris 12e Arrondissement;139297;940;140237
11;Île-de-France;75;1;  ;113;Paris 13e Arrondissement;180005;1228;181233
11;Île-de-France;75;1;  ;114;Paris 14e Arrondissement;135592;976;136568
11;Île-de-France;75;1;  ;115;Paris 15e Arrondissement;230981;1687;232668
11;Île-de-France;75;1;  ;116;Paris 16e Arrondissement;165523;2254;167777
11;Île-de-France;75;1;  ;117;Paris 17e Arrondissement;166543;1432;167975
11;Île-de-France;75;1;  ;118;Paris 18e Arrondissement;192468;820;193288
11;Île-de-France;75;1;  ;119;Paris 19e Arrondissement;184573;998;185571
11;Île-de-France;75;1;  ;120;Paris 20e Arrondissement;194994;924;195918
28;Normandie;76;3;35;001;Allouville-Bellefosse;1158;19;1177
28;Normandie;76;2;33;002;Alvimare;622;9;631
28;Normandie;76;1;07;004;Ambrumesnil;468;14;482
28;Normandie;76;3;06;005;Amfreville-la-Mi-Voie;3306;31;3337
28;Normandie;76;3;35;006;Amfreville-les-Champs;173;4;177
28;Normandie;76;3;02;007;Anceaumeville;675;10;685
28;Normandie;76;1;08;008;Ancourt;630;10;640
28;Normandie;76;1;33;009;Ancourteville-sur-Héricourt;344;4;348
28;Normandie;76;3;35;010;Ancretiéville-Saint-Victor;373;6;379
28;Normandie;76;2;11;011;Ancretteville-sur-Mer;152;4;156
28;Normandie;76;2;32;012;Angerville-Bailleul;185;3;188
28;Normandie;76;2;11;013;Angerville-la-Martel;1078;30;1108
28;Normandie;76;2;26;014;Angerville-l'Orcher;1405;15;1420
28;Normandie;76;1;33;015;Angiens;512;11;523
28;Normandie;76;1;33;016;Anglesqueville-la-Bras-Long;121;2;123
28;Normandie;76;2;26;017;Anglesqueville-l'Esneval;648;6;654
28;Normandie;76;1;20;018;Val-de-Saâne;1491;33;1524
28;Normandie;76;1;20;019;Anneville-sur-Scie;424;10;434
28;Normandie;76;3;01;020;Anneville-Ambourville;1189;23;1212
28;Normandie;76;2;32;021;Annouville-Vilmesnil;467;7;474
28;Normandie;76;3;25;022;Anquetierville;338;13;351
28;Normandie;76;3;35;023;Anvéville;300;5;305
28;Normandie;76;1;23;024;Ardouval;157;4;161
28;Normandie;76;1;12;025;Argueil;344;8;352
28;Normandie;76;1;08;026;Arques-la-Bataille;2573;52;2625
28;Normandie;76;1;12;028;Aubéguimont;187;1;188
28;Normandie;76;1;10;029;Aubermesnil-aux-Érables;199;3;202
28;Normandie;76;1;07;030;Aubermesnil-Beaumais;503;3;506
28;Normandie;76;1;33;032;Auberville-la-Manuel;138;1;139
28;Normandie;76;2;32;033;Auberville-la-Renault;458;6;464
28;Normandie;76;1;20;034;Val-de-Scie;2535;22;2557
28;Normandie;76;1;12;035;Aumale;1986;53;2039
28;Normandie;76;1;20;036;Auppegard;692;19;711
28;Normandie;76;3;02;038;Authieux-Ratiéville;399;3;402
28;Normandie;76;3;06;039;Les Authieux-sur-le-Port-Saint-Ouen;1261;26;1287
28;Normandie;76;1;33;040;Autigny;308;0;308
28;Normandie;76;3;35;041;Les Hauts-de-Caux;1349;36;1385
28;Normandie;76;1;23;042;Auvilliers;102;0;102
28;Normandie;76;3;35;043;Auzebosc;1130;361;1491
28;Normandie;76;3;35;045;Auzouville-l'Esneval;358;9;367
28;Normandie;76;3;21;046;Auzouville-sur-Ry;702;12;714
28;Normandie;76;1;20;047;Auzouville-sur-Saâne;150;1;151
28;Normandie;76;1;12;048;Avesnes-en-Bray;297;6;303
28;Normandie;76;1;23;049;Avesnes-en-Val;280;6;286
28;Normandie;76;1;20;050;Avremesnil;1011;27;1038
28;Normandie;76;1;20;051;Bacqueville-en-Caux;1910;39;1949
28;Normandie;76;1;23;052;Bailleul-Neuville;221;1;222
28;Normandie;76;1;23;053;Baillolet;108;1;109
28;Normandie;76;1;08;054;Bailly-en-Rivière;522;4;526
28;Normandie;76;3;35;055;Baons-le-Comte;337;17;354
28;Normandie;76;3;01;056;Bardouville;632;6;638
28;Normandie;76;3;01;057;Barentin;12398;229;12627
28;Normandie;76;1;10;058;Baromesnil;218;5;223
28;Normandie;76;1;10;059;Bazinval;417;11;428
28;Normandie;76;1;12;060;Beaubec-la-Rosière;497;13;510
28;Normandie;76;3;23;062;Beaumont-le-Hareng;261;3;264
28;Normandie;76;1;20;063;Beauval-en-Caux;472;10;482
28;Normandie;76;2;26;064;Beaurepaire;492;13;505
28;Normandie;76;1;12;065;Beaussault;411;4;415
28;Normandie;76;1;20;066;Beautot;149;4;153
28;Normandie;76;1;12;067;Beauvoir-en-Lyons;604;14;618
28;Normandie;76;2;32;068;Bec-de-Mortagne;643;17;660
28;Normandie;76;3;06;069;Belbeuf;2235;52;2287
28;Normandie;76;1;23;070;Bellencombre;624;10;634
28;Normandie;76;1;08;071;Bellengreville;474;8;482
28;Normandie;76;1;20;072;Belleville-en-Caux;738;12;750
28;Normandie;76;1;12;074;La Bellière;54;0;54
28;Normandie;76;1;20;075;Belmesnil;452;2;454
28;Normandie;76;2;32;076;Bénarville;267;5;272
28;Normandie;76;3;35;077;Bénesville;178;5;183
28;Normandie;76;2;26;079;Bénouville;189;1;190
28;Normandie;76;2;03;082;Bernières;637;6;643
28;Normandie;76;1;33;083;Bertheauville;99;1;100
28;Normandie;76;1;33;084;Bertreville;122;1;123
28;Normandie;76;1;20;085;Bertreville-Saint-Ouen;339;10;349
28;Normandie;76;1;20;086;Bertrimont;216;5;221
28;Normandie;76;3;35;087;Berville-en-Caux;680;10;690
28;Normandie;76;3;01;088;Berville-sur-Seine;545;9;554
28;Normandie;76;2;03;090;Beuzeville-la-Grenier;1244;17;1261
28;Normandie;76;1;33;091;Beuzeville-la-Guérard;228;2;230
28;Normandie;76;2;03;092;Beuzevillette;634;10;644
28;Normandie;76;1;12;093;Bézancourt;357;13;370
28;Normandie;76;3;21;094;Bierville;325;3;328
28;Normandie;76;3;02;095;Bihorel;8264;166;8430
28;Normandie;76;1;20;096;Biville-la-Baignarde;662;12;674
28;Normandie;76;1;20;097;Biville-la-Rivière;106;0;106
28;Normandie;76;3;01;099;Blacqueville;723;9;732
28;Normandie;76;3;21;100;Blainville-Crevon;1222;17;1239
28;Normandie;76;1;10;101;Blangy-sur-Bresle;2907;34;2941
28;Normandie;76;3;06;103;Bonsecours;6479;106;6585
28;Normandie;76;1;33;104;Blosseville;252;14;266
28;Normandie;76;3;02;105;Le Bocasse;659;7;666
28;Normandie;76;3;21;106;Bois-d'Ennebourg;556;7;563
28;Normandie;76;3;21;107;Bois-Guilbert;299;4;303
28;Normandie;76;3;02;108;Bois-Guillaume;14592;404;14996
28;Normandie;76;3;21;109;Bois-Héroult;182;4;186
28;Normandie;76;3;35;110;Bois-Himont;472;5;477
28;Normandie;76;3;21;111;Bois-l'Évêque;601;10;611
28;Normandie;76;1;20;112;Le Bois-Robert;353;8;361
28;Normandie;76;3;21;113;Boissay;406;6;412
28;Normandie;76;2;03;114;Bolbec;11610;136;11746
28;Normandie;76;2;25;115;Bolleville;581;3;584
28;Normandie;76;3;21;116;Boos;3923;46;3969
28;Normandie;76;2;26;117;Bordeaux-Saint-Clair;651;20;671
28;Normandie;76;2;32;118;Bornambusc;251;8;259
28;Normandie;76;1;23;119;Bosc-Bérenger;200;2;202
28;Normandie;76;3;21;120;Bosc-Bordel;452;10;462
28;Normandie;76;3;21;121;Bosc-Édeline;364;3;367
28;Normandie;76;1;23;122;Callengeville;509;8;517
28;Normandie;76;3;02;123;Bosc-Guérard-Saint-Adrien;1028;28;1056
28;Normandie;76;1;12;124;Bosc-Hyons;434;8;442
28;Normandie;76;3;23;125;Bosc-le-Hard;1532;19;1551
28;Normandie;76;1;23;126;Bosc-Mesnil;317;6;323
28;Normandie;76;1;33;128;Bosville;585;15;600
28;Normandie;76;3;35;129;Boudeville;206;6;212
28;Normandie;76;1;23;130;Bouelles;289;3;292
28;Normandie;76;3;09;131;La Bouille;722;10;732
28;Normandie;76;3;35;132;Bourdainville;465;2;467
28;Normandie;76;1;33;133;Le Bourg-Dun;431;9;440
28;Normandie;76;1;33;134;Bourville;300;4;304
28;Normandie;76;3;01;135;Bouville;987;13;1000
28;Normandie;76;1;20;136;Brachy;723;11;734
28;Normandie;76;1;23;138;Bracquetuit;329;5;334
28;Normandie;76;1;23;139;Bradiancourt;220;3;223
28;Normandie;76;1;33;140;Brametot;199;2;201
28;Normandie;76;2;32;141;Bréauté;1359;13;1372
28;Normandie;76;1;12;142;Brémontier-Merval;454;126;580
28;Normandie;76;2;32;143;Bretteville-du-Grand-Caux;1360;22;1382
28;Normandie;76;3;35;144;Bretteville-Saint-Laurent;154;2;156
28;Normandie;76;3;21;146;Buchy;2840;102;2942
28;Normandie;76;1;23;147;Bully;913;23;936
28;Normandie;76;1;23;148;Bures-en-Bray;326;4;330
28;Normandie;76;3;35;149;Butot;284;5;289
28;Normandie;76;1;33;151;Cailleville;262;10;272
28;Normandie;76;3;21;152;Cailly;763;4;767
28;Normandie;76;1;20;153;Calleville-les-Deux-Églises;324;3;327
28;Normandie;76;1;10;154;Campneuseville;475;12;487
28;Normandie;76;1;10;155;Canehan;377;3;380
28;Normandie;76;1;33;156;Canouville;342;9;351
28;Normandie;76;3;04;157;Canteleu;13846;373;14219
28;Normandie;76;3;35;158;Canville-les-Deux-Églises;326;2;328
28;Normandie;76;1;33;159;Cany-Barville;3046;56;3102
28;Normandie;76;3;24;160;Carville-la-Folletière;417;10;427
28;Normandie;76;3;35;161;Carville-Pot-de-Fer;100;3;103
28;Normandie;76;1;20;162;Le Catelier;270;5;275
28;Normandie;76;3;21;163;Catenay;672;10;682
28;Normandie;76;3;25;164;Rives-en-Seine;4148;66;4214
28;Normandie;76;3;05;165;Caudebec-lès-Elbeuf;9949;67;10016
28;Normandie;76;1;12;166;Le Caule-Sainte-Beuve;482;4;486
28;Normandie;76;2;26;167;Cauville-sur-Mer;1594;27;1621
28;Normandie;76;1;20;168;Les Cent-Acres;65;1;66
28;Normandie;76;2;32;169;La Cerlangue;1276;114;1390
28;Normandie;76;1;20;170;La Chapelle-du-Bourgay;118;1;119
28;Normandie;76;1;12;171;La Chapelle-Saint-Ouen;135;1;136
28;Normandie;76;1;33;172;La Chapelle-sur-Dun;158;3;161
28;Normandie;76;1;20;173;La Chaussée;542;6;548
28;Normandie;76;3;35;174;Cideville;404;5;409
28;Normandie;76;1;23;175;Clais;260;7;267
28;Normandie;76;1;33;176;Clasville;343;7;350
28;Normandie;76;3;02;177;Claville-Motteville;284;6;290
28;Normandie;76;3;05;178;Cléon;4924;25;4949
28;Normandie;76;3;02;179;Clères;1377;16;1393
28;Normandie;76;1;33;180;Cleuville;190;8;198
28;Normandie;76;2;33;181;Cléville;154;2;156
28;Normandie;76;2;33;182;Cliponville;262;2;264
28;Normandie;76;2;11;183;Colleville;763;19;782
28;Normandie;76;1;07;184;Colmesnil-Manneville;109;3;112
28;Normandie;76;1;12;185;Compainville;166;4;170
28;Normandie;76;1;12;186;Conteville;496;3;499
28;Normandie;76;2;11;187;Contremoulins;162;3;165
28;Normandie;76;3;23;188;Cottévrard;476;4;480
28;Normandie;76;1;33;189;Crasville-la-Mallet;153;6;159
28;Normandie;76;1;33;190;Crasville-la-Rocquefort;208;3;211
28;Normandie;76;1;10;192;Criel-sur-Mer;2630;54;2684
28;Normandie;76;1;23;193;La Crique;341;5;346
28;Normandie;76;2;11;194;Criquebeuf-en-Caux;402;3;405
28;Normandie;76;2;11;195;Criquetot-le-Mauconduit;177;1;178
28;Normandie;76;2;26;196;Criquetot-l'Esneval;2562;90;2652
28;Normandie;76;1;20;197;Criquetot-sur-Longueville;221;2;223
28;Normandie;76;3;35;198;Criquetot-sur-Ouville;802;19;821
28;Normandie;76;1;12;199;Criquiers;691;10;701
28;Normandie;76;1;23;200;Critot;458;12;470
28;Normandie;76;1;12;201;Croisy-sur-Andelle;534;4;538
28;Normandie;76;1;23;202;Croixdalle;318;4;322
28;Normandie;76;3;24;203;Croix-Mare;757;7;764
28;Normandie;76;1;23;204;Cropus;254;1;255
28;Normandie;76;1;20;205;Crosville-sur-Scie;248;2;250
28;Normandie;76;2;26;206;Cuverville;345;5;350
28;Normandie;76;1;10;207;Cuverville-sur-Yères;196;6;202
28;Normandie;76;1;12;208;Cuy-Saint-Fiacre;665;17;682
28;Normandie;76;1;12;209;Dampierre-en-Bray;442;8;450
28;Normandie;76;1;08;210;Dampierre-Saint-Nicolas;460;2;462
28;Normandie;76;1;10;211;Dancourt;231;2;233
28;Normandie;76;3;06;212;Darnétal;9788;84;9872
28;Normandie;76;2;32;213;Daubeuf-Serville;401;9;410
28;Normandie;76;1;20;214;Dénestanville;265;1;266
28;Normandie;76;3;22;216;Déville-lès-Rouen;10654;75;10729
28;Normandie;76;1;95;217;Dieppe;28241;468;28709
28;Normandie;76;1;12;218;Doudeauville;98;2;100
28;Normandie;76;3;35;219;Doudeville;2477;45;2522
28;Normandie;76;1;08;220;Douvrend;523;12;535
28;Normandie;76;1;33;221;Drosay;194;5;199
28;Normandie;76;3;01;222;Duclair;4073;53;4126
28;Normandie;76;3;24;223;Écalles-Alix;514;6;520
28;Normandie;76;2;32;224;Écrainville;977;19;996
28;Normandie;76;3;35;225;Écretteville-lès-Baons;377;12;389
28;Normandie;76;2;11;226;Écretteville-sur-Mer;163;2;165
28;Normandie;76;3;35;227;Ectot-l'Auber;698;11;709
28;Normandie;76;3;35;228;Ectot-lès-Baons;392;7;399
28;Normandie;76;1;12;229;Elbeuf-en-Bray;406;14;420
28;Normandie;76;3;21;230;Elbeuf-sur-Andelle;475;6;481
28;Normandie;76;3;09;231;Elbeuf;16224;126;16350
28;Normandie;76;2;11;232;Életot;643;9;652
28;Normandie;76;1;12;233;Ellecourt;151;4;155
28;Normandie;76;3;24;234;Émanville;712;11;723
28;Normandie;76;1;08;235;Envermeu;2022;155;2177
28;Normandie;76;2;33;236;Envronville;349;1;350
28;Normandie;76;3;01;237;Épinay-sur-Duclair;509;8;517
28;Normandie;76;2;26;238;Épouville;2654;39;2693
28;Normandie;76;2;32;239;Épretot;776;14;790
28;Normandie;76;2;11;240;Épreville;1013;13;1026
28;Normandie;76;1;33;241;Ermenouville;139;6;145
28;Normandie;76;1;12;242;Ernemont-la-Villette;195;4;199
28;Normandie;76;3;21;243;Ernemont-sur-Buchy;294;2;296
28;Normandie;76;1;23;244;Esclavelles;385;6;391
28;Normandie;76;3;24;245;Eslettes;1619;16;1635
28;Normandie;76;3;02;247;Esteville;495;4;499
28;Normandie;76;1;20;249;Étaimpuis;827;11;838
28;Normandie;76;2;32;250;Étainhus;1205;27;1232
28;Normandie;76;3;35;251;Étalleville;442;3;445
28;Normandie;76;1;10;252;Étalondes;1036;28;1064
28;Normandie;76;3;35;253;Étoutteville;826;14;840
28;Normandie;76;2;26;254;Étretat;1237;6;1243
28;Normandie;76;1;10;255;Eu;6716;200;6916
28;Normandie;76;1;10;257;Fallencourt;183;2;185
28;Normandie;76;2;33;258;Terres-de-Caux;4193;112;4305
28;Normandie;76;2;11;259;Fécamp;18041;288;18329
28;Normandie;76;1;12;260;Ferrières-en-Bray;1675;19;1694
28;Normandie;76;1;12;261;La Ferté-Saint-Samson;458;11;469
28;Normandie;76;1;23;262;Fesques;134;2;136
28;Normandie;76;1;12;263;La Feuillie;1289;22;1311
28;Normandie;76;3;35;264;Flamanville;484;11;495
28;Normandie;76;1;23;265;Flamets-Frétils;163;8;171
28;Normandie;76;1;10;266;Flocques;705;15;720
28;Normandie;76;2;26;268;Fongueusemare;185;5;190
28;Normandie;76;1;23;269;Fontaine-en-Bray;173;3;176
28;Normandie;76;2;26;270;Fontaine-la-Mallet;2633;53;2686
28;Normandie;76;3;02;271;Fontaine-le-Bourg;1809;18;1827
28;Normandie;76;1;33;272;Fontaine-le-Dun;899;17;916
28;Normandie;76;3;06;273;Fontaine-sous-Préaux;541;15;556
28;Normandie;76;1;20;274;La Fontelaye;28;0;28
28;Normandie;76;2;26;275;Fontenay;1521;24;1545
28;Normandie;76;1;12;276;Forges-les-Eaux;3812;198;4010
28;Normandie;76;1;10;278;Foucarmont;797;13;810
28;Normandie;76;2;33;279;Foucart;359;10;369
28;Normandie;76;1;23;280;Fréauville;132;1;133
28;Normandie;76;2;25;281;La Frénaye;2093;45;2138
28;Normandie;76;3;05;282;Freneuse;953;9;962
28;Normandie;76;1;23;283;Fresles;238;4;242
28;Normandie;76;1;20;284;Fresnay-le-Long;331;5;336
28;Normandie;76;3;21;285;Fresne-le-Plan;574;8;582
28;Normandie;76;1;23;286;Fresnoy-Folny;672;7;679
28;Normandie;76;3;24;287;Fresquiennes;1017;13;1030
28;Normandie;76;1;08;288;Freulleville;364;4;368
28;Normandie;76;3;24;289;Saint Martin de l'If;1726;24;1750
28;Normandie;76;3;02;290;Frichemesnil;398;11;409
28;Normandie;76;2;11;291;Froberville;1194;26;1220
28;Normandie;76;1;12;292;Fry;144;3;147
28;Normandie;76;3;35;293;Fultot;236;0;236
28;Normandie;76;1;33;294;La Gaillarde;384;8;392
28;Normandie;76;1;12;295;Gaillefontaine;1224;9;1233
28;Normandie;76;2;16;296;Gainneville;2526;31;2557
28;Normandie;76;1;12;297;Gancourt-Saint-Étienne;230;7;237
28;Normandie;76;2;11;298;Ganzeville;468;5;473
28;Normandie;76;2;11;299;Gerponville;391;4;395
28;Normandie;76;2;11;300;Gerville;431;4;435
28;Normandie;76;2;32;302;Goderville;2864;41;2905
28;Normandie;76;2;32;303;Gommerville;729;9;738
28;Normandie;76;2;32;304;Gonfreville-Caillot;369;1;370
28;Normandie;76;2;16;305;Gonfreville-l'Orcher;9124;59;9183
28;Normandie;76;1;20;306;Gonnetot;178;2;180
28;Normandie;76;2;26;307;Gonneville-la-Mallet;1371;20;1391
28;Normandie;76;1;20;308;Gonneville-sur-Scie;503;8;511
28;Normandie;76;3;35;309;Gonzeville;123;2;125
28;Normandie;76;3;24;311;Goupillières;425;5;430
28;Normandie;76;1;12;312;Gournay-en-Bray;6041;97;6138
28;Normandie;76;3;06;313;Gouy;888;14;902
28;Normandie;76;2;32;314;Graimbouville;615;9;624
28;Normandie;76;1;33;315;Grainville-la-Teinturière;1077;18;1095
28;Normandie;76;3;21;316;Grainville-sur-Ry;442;4;446
28;Normandie;76;2;32;317;Grainville-Ymauville;433;12;445
28;Normandie;76;2;25;318;Grand-Camp;737;27;764
28;Normandie;76;3;09;319;Grand-Couronne;9739;191;9930
28;Normandie;76;1;23;320;Grandcourt;328;4;332
28;Normandie;76;1;23;321;Les Grandes-Ventes;1783;27;1810
28;Normandie;76;3;13;322;Le Grand-Quevilly;25963;250;26213
28;Normandie;76;1;23;323;Graval;155;2;157
28;Normandie;76;1;08;324;Grèges;848;15;863
28;Normandie;76;3;35;325;Grémonville;438;5;443
28;Normandie;76;1;20;327;Greuville;374;5;379
28;Normandie;76;3;23;328;Grigneuseville;375;5;380
28;Normandie;76;2;03;329;Gruchet-le-Valasse;3175;37;3212
28;Normandie;76;1;20;330;Gruchet-Saint-Siméon;686;20;706
28;Normandie;76;3;02;331;Grugny;1008;5;1013
28;Normandie;76;1;12;332;Grumesnil;423;2;425
28;Normandie;76;1;10;333;Guerville;464;5;469
28;Normandie;76;1;20;334;Gueures;528;19;547
28;Normandie;76;1;20;335;Gueutteville;88;0;88
28;Normandie;76;1;33;336;Gueutteville-les-Grès;377;11;388
28;Normandie;76;1;12;338;La Hallotière;224;1;225
28;Normandie;76;1;33;339;Le Hanouard;257;3;260
28;Normandie;76;3;35;340;Harcanville;523;7;530
28;Normandie;76;2;15;341;Harfleur;8349;65;8414
28;Normandie;76;2;33;342;Hattenville;715;17;732
28;Normandie;76;1;12;343;Haucourt;193;4;197
28;Normandie;76;1;12;344;Haudricourt;407;10;417
28;Normandie;76;1;12;345;Haussez;281;2;283
28;Normandie;76;1;33;346;Hautot-l'Auvray;316;8;324
28;Normandie;76;3;35;347;Hautot-le-Vatois;356;6;362
28;Normandie;76;3;35;348;Hautot-Saint-Sulpice;687;8;695
28;Normandie;76;1;07;349;Hautot-sur-Mer;1891;71;1962
28;Normandie;76;3;04;350;Hautot-sur-Seine;399;7;406
28;Normandie;76;2;96;351;Le Havre;168290;1830;170120
28;Normandie;76;1;12;352;La Haye;372;3;375
28;Normandie;76;1;33;353;Héberville;107;6;113
28;Normandie;76;3;01;354;Hénouville;1323;14;1337
28;Normandie;76;3;35;355;Héricourt-en-Caux;950;13;963
28;Normandie;76;1;20;356;Hermanville;115;2;117
28;Normandie;76;2;26;357;Hermeville;355;16;371
28;Normandie;76;1;12;358;Le Héron;247;1;248
28;Normandie;76;3;21;359;Héronchelles;143;2;145
28;Normandie;76;1;20;360;Heugleville-sur-Scie;634;8;642
28;Normandie;76;2;26;361;Heuqueville;715;10;725
28;Normandie;76;3;25;362;Heurteauville;299;7;306
28;Normandie;76;1;10;363;Hodeng-au-Bosc;575;8;583
28;Normandie;76;1;12;364;Hodeng-Hodenger;272;5;277
28;Normandie;76;1;33;365;Houdetot;187;0;187
28;Normandie;76;3;24;366;Le Houlme;4107;29;4136
28;Normandie;76;3;24;367;Houppeville;2907;47;2954
28;Normandie;76;2;32;368;Houquetot;338;6;344
28;Normandie;76;3;02;369;La Houssaye-Béranger;534;7;541
28;Normandie;76;3;35;370;Hugleville-en-Caux;427;3;430
28;Normandie;76;1;08;371;Les Ifs;71;0;71
28;Normandie;76;1;12;372;Illois;410;3;413
28;Normandie;76;1;20;373;Imbleville;305;6;311
28;Normandie;76;1;10;374;Incheville;1234;15;1249
28;Normandie;76;1;33;375;Ingouville;274;14;288
28;Normandie;76;3;02;377;Isneauville;3546;72;3618
28;Normandie;76;3;01;378;Jumièges;1704;34;1738
28;Normandie;76;1;20;379;Lamberville;192;2;194
28;Normandie;76;1;20;380;Lammerville;316;8;324
28;Normandie;76;1;12;381;Landes-Vieilles-et-Neuves;131;1;132
28;Normandie;76;2;03;382;Lanquetot;1161;13;1174
28;Normandie;76;1;20;383;Lestanville;96;0;96
28;Normandie;76;2;03;384;Lillebonne;8797;145;8942
28;Normandie;76;3;24;385;Limésy;1496;53;1549
28;Normandie;76;2;11;386;Limpiville;380;6;386
28;Normandie;76;3;35;387;Lindebeuf;389;7;396
28;Normandie;76;2;25;388;Lintot;472;3;475
28;Normandie;76;1;20;389;Lintot-les-Bois;187;7;194
28;Normandie;76;2;11;390;Les Loges;1106;21;1127
28;Normandie;76;3;09;391;La Londe;2338;66;2404
28;Normandie;76;1;23;392;Londinières;1264;14;1278
28;Normandie;76;1;12;393;Longmesnil;49;0;49
28;Normandie;76;1;10;394;Longroy;630;5;635
28;Normandie;76;1;07;395;Longueil;561;11;572
28;Normandie;76;3;21;396;Longuerue;334;2;336
28;Normandie;76;1;20;397;Longueville-sur-Scie;992;25;1017
28;Normandie;76;3;25;398;Louvetot;747;6;753
28;Normandie;76;1;23;399;Lucy;196;1;197
28;Normandie;76;1;20;400;Luneray;2169;36;2205
28;Normandie;76;3;25;401;Arelaune-en-Seine;2522;44;2566
28;Normandie;76;3;24;402;Malaunay;6143;48;6191
28;Normandie;76;1;33;403;Malleville-les-Grès;204;3;207
28;Normandie;76;2;26;404;Manéglise;1228;22;1250
28;Normandie;76;1;20;405;Manéhouville;224;1;225
28;Normandie;76;2;11;406;Maniquerville;421;6;427
28;Normandie;76;1;33;407;Manneville-ès-Plains;304;8;312
28;Normandie;76;2;32;408;Manneville-la-Goupil;1035;14;1049
28;Normandie;76;2;26;409;Mannevillette;892;13;905
28;Normandie;76;3;04;410;Maromme;10663;135;10798
28;Normandie;76;1;12;411;Marques;233;1;234
28;Normandie;76;3;21;412;Martainville-Épreville;714;11;725
28;Normandie;76;1;07;413;Martigny;426;6;432
28;Normandie;76;1;08;414;Martin-Église;1603;51;1654
28;Normandie;76;1;23;415;Massy;334;5;339
28;Normandie;76;1;23;416;Mathonville;327;5;332
28;Normandie;76;1;23;417;Maucomble;415;3;418
28;Normandie;76;3;25;418;Maulévrier-Sainte-Gertrude;1000;20;1020
28;Normandie;76;3;01;419;Mauny;164;6;170
28;Normandie;76;1;12;420;Mauquenchy;358;6;364
28;Normandie;76;2;03;421;Mélamare;922;14;936
28;Normandie;76;1;10;422;Melleville;266;8;274
28;Normandie;76;1;12;423;Ménerval;168;2;170
28;Normandie;76;1;23;424;Ménonval;228;1;229
28;Normandie;76;2;32;425;Mentheville;293;5;298
28;Normandie;76;1;12;426;Mésangueville;161;1;162
28;Normandie;76;1;23;427;Mesnières-en-Bray;937;249;1186
28;Normandie;76;1;33;428;Le Mesnil-Durdent;17;3;20
28;Normandie;76;3;21;429;Le Mesnil-Esnard;7886;341;8227
28;Normandie;76;1;23;430;Mesnil-Follemprise;120;3;123
28;Normandie;76;1;12;431;Le Mesnil-Lieubray;97;3;100
28;Normandie;76;1;12;432;Mesnil-Mauger;245;4;249
28;Normandie;76;3;24;433;Mesnil-Panneville;729;7;736
28;Normandie;76;3;21;434;Mesnil-Raoul;1090;7;1097
28;Normandie;76;1;10;435;Le Mesnil-Réaume;793;16;809
28;Normandie;76;3;01;436;Le Mesnil-sous-Jumièges;619;4;623
28;Normandie;76;1;08;437;Meulers;553;5;558
28;Normandie;76;1;10;438;Millebosc;244;5;249
28;Normandie;76;2;03;439;Mirville;342;9;351
28;Normandie;76;1;12;440;Molagnies;197;4;201
28;Normandie;76;1;10;441;Monchaux-Soreng;633;11;644
28;Normandie;76;1;10;442;Monchy-sur-Eu;591;9;600
28;Normandie;76;3;02;443;Mont-Cauvaire;840;16;856
28;Normandie;76;1;23;445;Montérolier;600;7;607
28;Normandie;76;3;24;446;Montigny;1271;17;1288
28;Normandie;76;2;15;447;Montivilliers;15470;235;15705
28;Normandie;76;3;21;448;Montmain;1346;29;1375
28;Normandie;76;1;20;449;Montreuil-en-Caux;500;8;508
28;Normandie;76;1;12;450;Montroty;271;26;297
28;Normandie;76;3;22;451;Mont-Saint-Aignan;19357;375;19732
28;Normandie;76;3;02;452;Montville;4563;51;4614
28;Normandie;76;3;21;453;Morgny-la-Pommeraye;1076;20;1096
28;Normandie;76;1;23;454;Mortemer;83;0;83
28;Normandie;76;1;12;455;Morville-sur-Andelle;316;5;321
28;Normandie;76;3;35;456;Motteville;765;11;776
28;Normandie;76;3;09;457;Moulineaux;928;17;945
28;Normandie;76;1;20;458;Muchedent;127;3;130
28;Normandie;76;1;23;459;Nesle-Hodeng;349;5;354
28;Normandie;76;1;10;460;Nesle-Normandeuse;513;8;521
28;Normandie;76;1;23;461;Neufbosc;400;5;405
28;Normandie;76;1;23;462;Neufchâtel-en-Bray;4678;209;4887
28;Normandie;76;1;12;463;Neuf-Marché;667;22;689
28;Normandie;76;3;21;464;La Neuville-Chant-d'Oisel;2378;37;2415
28;Normandie;76;1;23;465;Neuville-Ferrières;571;6;577
28;Normandie;76;1;33;467;Néville;1329;19;1348
28;Normandie;76;2;03;468;Nointot;1360;33;1393
28;Normandie;76;1;12;469;Nolléval;432;5;437
28;Normandie;76;1;33;470;Normanville;659;24;683
28;Normandie;76;2;25;471;Norville;1001;27;1028
28;Normandie;76;1;08;472;Notre-Dame-d'Aliermont;774;2;776
28;Normandie;76;3;25;473;Notre-Dame-de-Bliquetuit;790;10;800
28;Normandie;76;3;24;474;Notre-Dame-de-Bondeville;6978;83;7061
28;Normandie;76;3;21;475;Franqueville-Saint-Pierre;6105;194;6299
28;Normandie;76;2;25;476;Port-Jérôme-sur-Seine;10248;185;10433
28;Normandie;76;2;26;477;Notre-Dame-du-Bec;453;7;460
28;Normandie;76;1;20;478;Notre-Dame-du-Parc;186;1;187
28;Normandie;76;1;12;479;Nullemont;132;1;133
28;Normandie;76;1;33;480;Ocqueville;451;11;462
28;Normandie;76;2;26;481;Octeville-sur-Mer;6018;122;6140
28;Normandie;76;1;07;482;Offranville;3143;228;3371
28;Normandie;76;1;33;483;Oherville;227;2;229
28;Normandie;76;3;31;484;Oissel;12241;58;12299
28;Normandie;76;1;20;485;Omonville;270;46;316
28;Normandie;76;3;09;486;Orival;897;4;901
28;Normandie;76;1;23;487;Osmoy-Saint-Valery;314;6;320
28;Normandie;76;1;33;488;Ouainville;507;16;523
28;Normandie;76;2;32;489;Oudalle;417;10;427
28;Normandie;76;1;33;490;Ourville-en-Caux;1130;13;1143
28;Normandie;76;3;35;491;Ouville-l'Abbaye;662;6;668
28;Normandie;76;1;07;492;Ouville-la-Rivière;465;16;481
28;Normandie;76;1;33;493;Paluel;407;12;419
28;Normandie;76;2;03;494;Parc-d'Anxtot;585;7;592
28;Normandie;76;3;24;495;Pavilly;6212;51;6263
28;Normandie;76;3;13;497;Petit-Couronne;8693;175;8868
28;Normandie;76;3;27;498;Le Petit-Quevilly;22000;275;22275
28;Normandie;76;2;25;499;Petiville;1126;29;1155
28;Normandie;76;1;10;500;Pierrecourt;478;4;482
28;Normandie;76;2;26;501;Pierrefiques;135;7;142
28;Normandie;76;3;21;502;Pierreval;551;9;560
28;Normandie;76;3;24;503;Pissy-Pôville;1276;20;1296
28;Normandie;76;1;33;504;Pleine-Sève;128;2;130
28;Normandie;76;1;12;505;Pommereux;95;1;96
28;Normandie;76;1;23;506;Pommeréval;488;4;492
28;Normandie;76;1;10;507;Ponts-et-Marais;816;15;831
28;Normandie;76;2;26;508;La Poterie-Cap-d'Antifer;453;15;468
28;Normandie;76;3;21;509;Préaux;1836;31;1867
28;Normandie;76;3;35;510;Prétot-Vicquemare;237;3;240
28;Normandie;76;1;23;511;Preuseville;154;1;155
28;Normandie;76;1;23;512;Puisenval;24;0;24
28;Normandie;76;3;01;513;Quevillon;589;15;604
28;Normandie;76;3;06;514;Quévreville-la-Poterie;1025;13;1038
28;Normandie;76;1;07;515;Quiberville;541;14;555
28;Normandie;76;1;23;516;Quièvrecourt;423;19;442
28;Normandie;76;3;02;517;Quincampoix;3097;88;3185
28;Normandie;76;2;03;518;Raffetot;504;9;513
28;Normandie;76;1;20;519;Rainfreville;73;4;77
28;Normandie;76;1;10;520;Réalcamp;606;13;619
28;Normandie;76;3;21;521;Rebets;147;1;148
28;Normandie;76;2;32;522;La Remuée;1277;24;1301
28;Normandie;76;1;10;523;Rétonval;184;3;187
28;Normandie;76;3;35;524;Reuville;134;2;136
28;Normandie;76;1;08;526;Ricarville-du-Val;180;7;187
28;Normandie;76;1;12;527;Richemont;441;3;444
28;Normandie;76;1;10;528;Rieux;609;11;620
28;Normandie;76;2;11;529;Riville;294;12;306
28;Normandie;76;3;35;530;Robertot;222;5;227
28;Normandie;76;3;33;531;Rocquefort;319;8;327
28;Normandie;76;1;23;532;Rocquemont;793;18;811
28;Normandie;76;2;16;533;Rogerville;1574;17;1591
28;Normandie;76;2;26;534;Rolleville;1186;18;1204
28;Normandie;76;1;12;535;Roncherolles-en-Bray;461;8;469
28;Normandie;76;3;06;536;Roncherolles-sur-le-Vivier;1209;22;1231
28;Normandie;76;1;12;537;Ronchois;184;6;190
28;Normandie;76;1;23;538;Rosay;266;5;271
28;Normandie;76;3;97;540;Rouen;112321;1613;113934
28;Normandie;76;3;24;541;Roumare;1524;27;1551
28;Normandie;76;3;35;542;Routes;278;4;282
28;Normandie;76;2;03;543;Rouville;605;11;616
28;Normandie;76;1;12;544;Rouvray-Catillon;225;8;233
28;Normandie;76;1;07;545;Rouxmesnil-Bouteilles;1809;42;1851
28;Normandie;76;1;20;546;Royville;298;7;305
28;Normandie;76;3;21;547;La Rue-Saint-Pierre;780;9;789
28;Normandie;76;3;21;548;Ry;744;15;759
28;Normandie;76;1;20;549;Saâne-Saint-Just;146;6;152
28;Normandie;76;3;04;550;Sahurs;1205;24;1229
28;Normandie;76;2;32;551;Sainneville;850;11;861
28;Normandie;76;2;19;552;Sainte-Adresse;7317;259;7576
28;Normandie;76;1;23;553;Sainte-Agathe-d'Aliermont;302;5;307
28;Normandie;76;3;21;554;Saint-Aignan-sur-Ry;355;2;357
28;Normandie;76;3;21;555;Saint-André-sur-Cailly;833;20;853
28;Normandie;76;2;03;556;Saint-Antoine-la-Forêt;1091;21;1112
28;Normandie;76;3;25;557;Saint-Arnoult;1444;21;1465
28;Normandie;76;3;06;558;Saint-Aubin-Celloville;1176;6;1182
28;Normandie;76;3;25;559;Saint-Aubin-de-Crétot;512;8;520
28;Normandie;76;3;06;560;Saint-Aubin-Épinay;1024;16;1040
28;Normandie;76;3;05;561;Saint-Aubin-lès-Elbeuf;8429;76;8505
28;Normandie;76;1;08;562;Saint-Aubin-le-Cauf;841;18;859
28;Normandie;76;2;32;563;Saint-Aubin-Routot;1917;14;1931
28;Normandie;76;1;33;564;Saint-Aubin-sur-Mer;165;3;168
28;Normandie;76;1;07;565;Saint-Aubin-sur-Scie;1160;99;1259
28;Normandie;76;3;24;566;Sainte-Austreberthe;624;5;629
28;Normandie;76;1;23;567;Sainte-Beuve-en-Rivière;178;5;183
28;Normandie;76;3;35;568;Saint-Clair-sur-les-Monts;606;12;618
28;Normandie;76;1;33;569;Sainte-Colombe;222;4;226
28;Normandie;76;1;20;570;Saint-Crespin;308;4;312
28;Normandie;76;3;21;571;Sainte-Croix-sur-Buchy;692;4;696
28;Normandie;76;1;07;572;Saint-Denis-d'Aclon;126;5;131
28;Normandie;76;3;21;573;Saint-Denis-le-Thiboult;502;14;516
28;Normandie;76;1;20;574;Saint-Denis-sur-Scie;693;4;697
28;Normandie;76;3;98;575;Saint-Étienne-du-Rouvray;28352;221;28573
28;Normandie;76;2;03;576;Saint-Eustache-la-Forêt;1208;17;1225
28;Normandie;76;1;20;577;Sainte-Foy;620;13;633
28;Normandie;76;1;23;578;Sainte-Geneviève;269;4;273
28;Normandie;76;3;02;580;Saint-Georges-sur-Fontaine;904;19;923
28;Normandie;76;3;21;581;Saint-Germain-des-Essourts;391;9;400
28;Normandie;76;1;20;582;Saint-Germain-d'Étables;247;5;252
28;Normandie;76;3;21;583;Saint-Germain-sous-Cailly;342;5;347
28;Normandie;76;1;23;584;Saint-Germain-sur-Eaulne;218;5;223
28;Normandie;76;3;25;585;Saint-Gilles-de-Crétot;411;15;426
28;Normandie;76;2;32;586;Saint-Gilles-de-la-Neuville;652;5;657
28;Normandie;76;2;11;587;Sainte-Hélène-Bondeville;720;9;729
28;Normandie;76;1;23;588;Saint-Hellier;489;12;501
28;Normandie;76;1;20;589;Saint-Honoré;199;5;204
28;Normandie;76;1;08;590;Saint-Jacques-d'Aliermont;344;2;346
28;Normandie;76;3;06;591;Saint-Jacques-sur-Darnétal;3045;44;3089
28;Normandie;76;2;03;592;Saint-Jean-de-Folleville;816;27;843
28;Normandie;76;2;03;593;Saint-Jean-de-la-Neuville;610;11;621
28;Normandie;76;3;24;594;Saint-Jean-du-Cardonnay;1351;26;1377
28;Normandie;76;2;26;595;Saint-Jouin-Bruneval;1844;38;1882
28;Normandie;76;2;32;596;Saint-Laurent-de-Brèvedent;1491;38;1529
28;Normandie;76;3;35;597;Saint-Laurent-en-Caux;763;9;772
28;Normandie;76;1;10;598;Saint-Léger-aux-Bois;489;9;498
28;Normandie;76;3;06;599;Saint-Léger-du-Bourg-Denis;3599;49;3648
28;Normandie;76;2;11;600;Saint-Léonard;1709;34;1743
28;Normandie;76;1;12;601;Saint-Lucien;233;3;236
28;Normandie;76;1;20;602;Saint-Maclou-de-Folleville;620;12;632
28;Normandie;76;2;32;603;Saint-Maclou-la-Brière;462;6;468
28;Normandie;76;1;20;604;Saint-Mards;179;6;185
28;Normandie;76;1;07;605;Sainte-Marguerite-sur-Mer;468;13;481
28;Normandie;76;1;12;606;Morienne;188;25;213
28;Normandie;76;3;01;608;Sainte-Marguerite-sur-Duclair;2027;33;2060
28;Normandie;76;2;26;609;Sainte-Marie-au-Bosc;364;11;375
28;Normandie;76;3;35;610;Sainte-Marie-des-Champs;1580;13;1593
28;Normandie;76;3;35;611;Saint-Martin-aux-Arbres;317;9;326
28;Normandie;76;1;10;612;Saint-Martin-au-Bosc;261;5;266
28;Normandie;76;1;33;613;Saint-Martin-aux-Buneaux;651;12;663
28;Normandie;76;3;01;614;Saint-Martin-de-Boscherville;1535;31;1566
28;Normandie;76;2;26;615;Saint-Martin-du-Bec;629;24;653
28;Normandie;76;2;26;616;Saint-Martin-du-Manoir;1469;34;1503
28;Normandie;76;3;06;617;Saint-Martin-du-Vivier;1660;62;1722
28;Normandie;76;1;08;618;Petit-Caux;9628;203;9831
28;Normandie;76;1;10;619;Saint-Martin-le-Gaillard;289;5;294
28;Normandie;76;1;23;620;Saint-Martin-l'Hortier;273;7;280
28;Normandie;76;1;23;621;Saint-Martin-Osmonville;1186;22;1208
28;Normandie;76;2;25;622;Saint-Maurice-d'Ételan;301;10;311
28;Normandie;76;1;12;623;Saint-Michel-d'Halescourt;118;4;122
28;Normandie;76;1;08;624;Saint-Nicolas-d'Aliermont;3719;60;3779
28;Normandie;76;3;25;626;Saint-Nicolas-de-la-Haie;417;6;423
28;Normandie;76;2;03;627;Saint-Nicolas-de-la-Taille;1645;19;1664
28;Normandie;76;1;20;628;Saint-Ouen-du-Breuil;783;13;796
28;Normandie;76;1;20;629;Saint-Ouen-le-Mauger;278;6;284
28;Normandie;76;1;08;630;Saint-Ouen-sous-Bailly;225;7;232
28;Normandie;76;3;01;631;Saint-Paër;1311;15;1326
28;Normandie;76;1;20;632;Saint-Pierre-Bénouville;391;3;394
28;Normandie;76;3;04;634;Saint-Pierre-de-Manneville;897;15;912
28;Normandie;76;1;23;635;Saint-Pierre-des-Jonquières;72;0;72
28;Normandie;76;3;01;636;Saint-Pierre-de-Varengeville;2306;33;2339
28;Normandie;76;2;11;637;Saint-Pierre-en-Port;823;12;835
28;Normandie;76;1;10;638;Saint-Pierre-en-Val;1091;16;1107
28;Normandie;76;3;05;640;Saint-Pierre-lès-Elbeuf;8283;71;8354
28;Normandie;76;1;33;641;Saint-Pierre-le-Vieux;195;5;200
28;Normandie;76;1;33;642;Saint-Pierre-le-Viger;265;3;268
28;Normandie;76;1;10;644;Saint-Rémy-Boscrocourt;799;16;815
28;Normandie;76;1;10;645;Saint-Riquier-en-Rivière;145;5;150
28;Normandie;76;1;33;646;Saint-Riquier-ès-Plains;604;14;618
28;Normandie;76;2;32;647;Saint-Romain-de-Colbosc;4259;40;4299
28;Normandie;76;1;23;648;Saint-Saëns;2351;23;2374
28;Normandie;76;1;23;649;Saint-Saire;585;11;596
28;Normandie;76;2;32;650;Saint-Sauveur-d'Émalleville;1229;26;1255
28;Normandie;76;1;33;651;Saint-Sylvain;153;3;156
28;Normandie;76;1;08;652;Saint-Vaast-d'Équiqueville;763;5;768
28;Normandie;76;1;33;653;Saint-Vaast-Dieppedalle;372;3;375
28;Normandie;76;1;20;654;Saint-Vaast-du-Val;468;10;478
28;Normandie;76;1;33;655;Saint-Valery-en-Caux;3928;163;4091
28;Normandie;76;1;20;656;Saint-Victor-l'Abbaye;767;7;774
28;Normandie;76;2;32;657;Saint-Vigor-d'Ymonville;1137;23;1160
28;Normandie;76;2;32;658;Saint-Vincent-Cramesnil;691;21;712
28;Normandie;76;2;32;660;Sandouville;797;11;808
28;Normandie;76;1;20;662;Sassetot-le-Malgardé;111;1;112
28;Normandie;76;2;11;663;Sassetot-le-Mauconduit;1035;18;1053
28;Normandie;76;1;33;664;Sasseville;281;5;286
28;Normandie;76;1;08;665;Sauchay;431;5;436
28;Normandie;76;1;12;666;Saumont-la-Poterie;411;16;427
28;Normandie;76;1;07;667;Sauqueville;349;6;355
28;Normandie;76;3;35;668;Saussay;365;7;372
28;Normandie;76;2;32;669;Sausseuzemare-en-Caux;430;7;437
28;Normandie;76;2;11;670;Senneville-sur-Fécamp;884;11;895
28;Normandie;76;1;10;671;Sept-Meules;178;1;179
28;Normandie;76;1;12;672;Serqueux;979;20;999
28;Normandie;76;3;21;673;Servaville-Salmonville;1132;16;1148
28;Normandie;76;3;02;675;Sierville;1094;11;1105
28;Normandie;76;1;12;676;Sigy-en-Bray;496;11;507
28;Normandie;76;1;23;677;Smermesnil;383;8;391
28;Normandie;76;1;23;678;Sommery;828;13;841
28;Normandie;76;1;33;679;Sommesnil;111;1;112
28;Normandie;76;2;11;680;Sorquainville;185;4;189
28;Normandie;76;3;99;681;Sotteville-lès-Rouen;29068;445;29513
28;Normandie;76;3;05;682;Sotteville-sous-le-Val;758;4;762
28;Normandie;76;1;33;683;Sotteville-sur-Mer;397;10;407
28;Normandie;76;2;03;684;Tancarville;1250;22;1272
28;Normandie;76;2;11;685;Thérouldeville;669;3;672
28;Normandie;76;2;11;686;Theuville-aux-Maillots;541;8;549
28;Normandie;76;2;11;688;Thiergeville;400;14;414
28;Normandie;76;2;11;689;Thiétreville;367;38;405
28;Normandie;76;1;20;690;Thil-Manneville;639;19;658
28;Normandie;76;1;12;691;Le Thil-Riberpré;230;1;231
28;Normandie;76;1;33;692;Thiouville;293;5;298
28;Normandie;76;2;26;693;Le Tilleul;687;7;694
28;Normandie;76;1;20;694;Tocqueville-en-Caux;138;3;141
28;Normandie;76;2;32;695;Tocqueville-les-Murs;279;5;284
28;Normandie;76;1;20;697;Torcy-le-Grand;796;25;821
28;Normandie;76;1;20;698;Torcy-le-Petit;491;7;498
28;Normandie;76;3;35;699;Le Torp-Mesnil;451;4;455
28;Normandie;76;1;20;700;Tôtes;1576;31;1607
28;Normandie;76;3;35;702;Touffreville-la-Corbeline;838;15;853
28;Normandie;76;1;10;703;Touffreville-sur-Eu;212;8;220
28;Normandie;76;3;05;705;Tourville-la-Rivière;2493;21;2514
28;Normandie;76;2;11;706;Tourville-les-Ifs;691;7;698
28;Normandie;76;1;07;707;Tourville-sur-Arques;1211;39;1250
28;Normandie;76;2;11;708;Toussaint;702;12;714
28;Normandie;76;3;01;709;Le Trait;4876;46;4922
28;Normandie;76;2;33;710;Trémauville;103;2;105
28;Normandie;76;1;10;711;Le Tréport;4582;98;4680
28;Normandie;76;2;03;712;La Trinité-du-Mont;832;26;858
28;Normandie;76;2;32;714;Les Trois-Pierres;769;14;783
28;Normandie;76;2;25;715;Trouville;624;8;632
28;Normandie;76;2;26;716;Turretot;1462;25;1487
28;Normandie;76;3;04;717;Val-de-la-Haye;718;3;721
28;Normandie;76;3;35;718;Valliquerville;1421;37;1458
28;Normandie;76;2;11;719;Valmont;858;15;873
28;Normandie;76;1;07;720;Varengeville-sur-Mer;945;33;978
28;Normandie;76;1;20;721;Varneville-Bretteville;328;9;337
28;Normandie;76;1;20;723;Vassonville;438;7;445
28;Normandie;76;1;23;724;Vatierville;132;2;134
28;Normandie;76;2;32;725;Vattetot-sous-Beaumont;576;5;581
28;Normandie;76;2;11;726;Vattetot-sur-Mer;322;6;328
28;Normandie;76;3;25;727;Vatteville-la-Rue;1141;26;1167
28;Normandie;76;3;24;728;La Vaupalière;1124;20;1144
28;Normandie;76;1;33;730;Veauville-lès-Quelles;133;2;135
28;Normandie;76;1;20;731;Vénestanville;209;2;211
28;Normandie;76;1;33;732;Butot-Vénesville;242;4;246
28;Normandie;76;1;23;733;Ventes-Saint-Rémy;228;4;232
28;Normandie;76;2;26;734;Vergetot;447;12;459
28;Normandie;76;1;33;735;Veules-les-Roses;550;14;564
28;Normandie;76;1;33;736;Veulettes-sur-Mer;271;6;277
28;Normandie;76;3;35;737;Vibeuf;600;19;619
28;Normandie;76;3;21;738;Vieux-Manoir;757;11;768
28;Normandie;76;1;12;739;Vieux-Rouen-sur-Bresle;553;6;559
28;Normandie;76;3;21;740;La Vieux-Rue;574;10;584
28;Normandie;76;2;26;741;Villainville;286;12;298
28;Normandie;76;3;01;743;Villers-Écalles;1765;19;1784
28;Normandie;76;1;10;744;Villers-sous-Foucarmont;188;2;190
28;Normandie;76;1;10;745;Villy-sur-Yères;201;2;203
28;Normandie;76;2;11;746;Vinnemerville;222;2;224
28;Normandie;76;2;32;747;Virville;351;3;354
28;Normandie;76;1;33;748;Vittefleur;653;7;660
28;Normandie;76;1;23;749;Wanchy-Capval;342;8;350
28;Normandie;76;3;01;750;Yainville;1041;13;1054
28;Normandie;76;2;33;751;Yébleron;1269;18;1287
28;Normandie;76;3;35;752;Yerville;2514;21;2535
28;Normandie;76;3;06;753;Ymare;1151;22;1173
28;Normandie;76;2;11;754;Yport;726;15;741
28;Normandie;76;2;11;755;Ypreville-Biville;576;9;585
28;Normandie;76;3;21;756;Yquebeuf;240;8;248
28;Normandie;76;3;35;757;Yvecrique;640;7;647
28;Normandie;76;3;35;758;Yvetot;11448;222;11670
28;Normandie;76;3;01;759;Yville-sur-Seine;444;6;450
11;Île-de-France;77;4;07;001;Achères-la-Forêt;1142;29;1171
11;Île-de-France;77;1;05;002;Amillis;826;5;831
11;Île-de-France;77;4;07;003;Amponville;337;17;354
11;Île-de-France;77;2;14;004;Andrezel;286;5;291
11;Île-de-France;77;1;03;005;Annet-sur-Marne;3281;45;3326
11;Île-de-France;77;4;07;006;Arbonne-la-Forêt;979;20;999
11;Île-de-France;77;2;14;007;Argentières;355;7;362
11;Île-de-France;77;1;06;008;Armentières-en-Brie;1225;24;1249
11;Île-de-France;77;4;15;009;Arville;124;0;124
11;Île-de-France;77;3;14;010;Aubepierre-Ozouer-le-Repos;935;10;945
11;Île-de-France;77;4;15;011;Aufferville;499;6;505
11;Île-de-France;77;3;18;012;Augers-en-Brie;294;7;301
11;Île-de-France;77;1;05;013;Aulnoy;359;9;368
11;Île-de-France;77;4;07;014;Avon;13419;224;13643
11;Île-de-France;77;3;18;015;Baby;94;2;96
11;Île-de-France;77;4;15;016;Bagneaux-sur-Loing;1623;15;1638
11;Île-de-France;77;5;21;018;Bailly-Romainvilliers;7416;61;7477
11;Île-de-France;77;3;18;019;Balloy;333;3;336
11;Île-de-France;77;3;18;020;Bannost-Villegagnon;645;12;657
11;Île-de-France;77;3;13;021;Barbey;152;2;154
11;Île-de-France;77;4;07;022;Barbizon;1207;39;1246
11;Île-de-France;77;1;03;023;Barcy;310;7;317
11;Île-de-France;77;1;06;024;Bassevelle;382;2;384
11;Île-de-France;77;3;18;025;Bazoches-lès-Bray;862;8;870
11;Île-de-France;77;3;18;026;Beauchery-Saint-Martin;358;15;373
11;Île-de-France;77;4;15;027;Beaumont-du-Gâtinais;1194;15;1209
11;Île-de-France;77;2;14;029;Beauvoir;192;3;195
11;Île-de-France;77;3;05;030;Bellot;773;5;778
11;Île-de-France;77;3;08;031;Bernay-Vilbert;905;11;916
11;Île-de-France;77;3;18;032;Beton-Bazoches;921;17;938
11;Île-de-France;77;3;18;033;Bezalles;233;8;241
11;Île-de-France;77;2;14;034;Blandy;749;7;756
11;Île-de-France;77;3;15;035;Blennes;548;7;555
11;Île-de-France;77;3;18;036;Boisdon;133;3;136
11;Île-de-France;77;4;14;037;Bois-le-Roi;5913;148;6061
11;Île-de-France;77;2;20;038;Boissettes;409;7;416
11;Île-de-France;77;2;20;039;Boissise-la-Bertrand;1146;11;1157
11;Île-de-France;77;2;19;040;Boissise-le-Roi;3739;41;3780
11;Île-de-France;77;4;07;041;Boissy-aux-Cailles;280;5;285
11;Île-de-France;77;1;05;042;Boissy-le-Châtel;3216;43;3259
11;Île-de-France;77;3;05;043;Boitron;348;7;355
11;Île-de-France;77;2;14;044;Bombon;960;8;968
11;Île-de-France;77;4;15;045;Bougligny;722;11;733
11;Île-de-France;77;4;07;046;Boulancourt;335;10;345
11;Île-de-France;77;1;21;047;Bouleurs;1680;14;1694
11;Île-de-France;77;4;07;048;Bourron-Marlotte;2763;85;2848
11;Île-de-France;77;1;21;049;Boutigny;844;14;858
11;Île-de-France;77;4;15;050;Bransles;541;10;551
11;Île-de-France;77;3;18;051;Bray-sur-Seine;2307;18;2325
11;Île-de-France;77;3;14;052;Bréau;345;5;350
11;Île-de-France;77;5;04;053;Brie-Comte-Robert;18812;317;19129
11;Île-de-France;77;3;13;054;La Brosse-Montceaux;730;14;744
11;Île-de-France;77;5;23;055;Brou-sur-Chantereine;4809;10;4819
11;Île-de-France;77;4;07;056;Burcy;148;6;154
11;Île-de-France;77;1;06;057;Bussières;519;3;522
11;Île-de-France;77;5;22;058;Bussy-Saint-Georges;26597;347;26944
11;Île-de-France;77;5;22;059;Bussy-Saint-Martin;647;14;661
11;Île-de-France;77;4;07;060;Buthiers;732;16;748
11;Île-de-France;77;3;13;061;Cannes-Écluse;2482;35;2517
11;Île-de-France;77;5;09;062;Carnetin;455;10;465
11;Île-de-France;77;1;05;063;La Celle-sur-Morin;1267;15;1282
11;Île-de-France;77;4;07;065;Cély;1238;24;1262
11;Île-de-France;77;3;18;066;Cerneux;327;8;335
11;Île-de-France;77;2;20;067;Cesson;10833;145;10978
11;Île-de-France;77;3;18;068;Cessoy-en-Montois;214;4;218
11;Île-de-France;77;4;07;069;Chailly-en-Bière;2074;32;2106
11;Île-de-France;77;1;05;070;Chailly-en-Brie;1479;118;1597
11;Île-de-France;77;4;15;071;Chaintreaux;864;12;876
11;Île-de-France;77;3;18;072;Chalautre-la-Grande;685;10;695
11;Île-de-France;77;3;18;073;Chalautre-la-Petite;560;17;577
11;Île-de-France;77;5;09;075;Chalifert;1288;15;1303
11;Île-de-France;77;3;18;076;Chalmaison;755;54;809
11;Île-de-France;77;1;03;077;Chambry;993;12;1005
11;Île-de-France;77;1;06;078;Chamigny;1335;51;1386
11;Île-de-France;77;4;13;079;Champagne-sur-Seine;6353;149;6502
11;Île-de-France;77;3;18;080;Champcenest;196;1;197
11;Île-de-France;77;2;14;081;Champdeuil;727;8;735
11;Île-de-France;77;2;14;082;Champeaux;815;13;828
11;Île-de-France;77;5;01;083;Champs-sur-Marne;25654;154;25808
11;Île-de-France;77;1;06;084;Changis-sur-Marne;1349;11;1360
11;Île-de-France;77;5;09;085;Chanteloup-en-Brie;3991;51;4042
11;Île-de-France;77;3;14;086;La Chapelle-Gauthier;1441;5;1446
11;Île-de-France;77;3;08;087;La Chapelle-Iger;170;0;170
11;Île-de-France;77;4;07;088;La Chapelle-la-Reine;2384;30;2414
11;Île-de-France;77;3;14;089;La Chapelle-Rablais;916;6;922
11;Île-de-France;77;3;18;090;La Chapelle-Saint-Sulpice;241;4;245
11;Île-de-France;77;3;08;091;Les Chapelles-Bourbon;486;3;489
11;Île-de-France;77;3;05;093;La Chapelle-Moutils;449;3;452
11;Île-de-France;77;1;03;094;Charmentray;299;1;300
11;Île-de-France;77;1;03;095;Charny;1354;16;1370
11;Île-de-France;77;4;14;096;Chartrettes;2543;56;2599
11;Île-de-France;77;3;05;097;Chartronges;299;2;301
11;Île-de-France;77;3;14;098;Châteaubleau;358;2;360
11;Île-de-France;77;4;15;099;Château-Landon;2947;56;3003
11;Île-de-France;77;2;14;100;Le Châtelet-en-Brie;4339;67;4406
11;Île-de-France;77;3;18;101;Châtenay-sur-Seine;1063;11;1074
11;Île-de-France;77;4;15;102;Châtenoy;163;1;164
11;Île-de-France;77;2;14;103;Châtillon-la-Borde;217;2;219
11;Île-de-France;77;3;08;104;Châtres;693;7;700
11;Île-de-France;77;1;05;106;Chauffry;1023;17;1040
11;Île-de-France;77;2;08;107;Chaumes-en-Brie;3339;26;3365
11;Île-de-France;77;5;02;108;Chelles;55154;294;55448
11;Île-de-France;77;3;18;109;Chenoise-Cucharmoy;1640;26;1666
11;Île-de-France;77;4;15;110;Chenou;312;8;320
11;Île-de-France;77;5;21;111;Chessy;6304;54;6358
11;Île-de-France;77;4;15;112;Chevrainvilliers;251;4;255
11;Île-de-France;77;1;05;113;Chevru;1088;14;1102
11;Île-de-France;77;5;16;114;Chevry-Cossigny;3927;40;3967
11;Île-de-France;77;3;15;115;Chevry-en-Sereine;515;17;532
11;Île-de-France;77;3;05;116;Choisy-en-Brie;1308;18;1326
11;Île-de-France;77;1;06;117;Citry;953;9;962
11;Île-de-France;77;1;03;118;Claye-Souilly;12172;133;12305
11;Île-de-France;77;3;14;119;Clos-Fontaine;248;3;251
11;Île-de-France;77;1;06;120;Cocherel;626;4;630
11;Île-de-France;77;5;22;121;Collégien;3359;43;3402
11;Île-de-France;77;2;04;122;Combs-la-Ville;21627;150;21777
11;Île-de-France;77;1;12;123;Compans;815;2;817
11;Île-de-France;77;5;09;124;Conches-sur-Gondoire;1754;28;1782
11;Île-de-France;77;1;21;125;Condé-Sainte-Libiaire;1426;17;1443
11;Île-de-France;77;1;06;126;Congis-sur-Thérouanne;1762;193;1955
11;Île-de-France;77;2;08;127;Coubert;1885;13;1898
11;Île-de-France;77;1;21;128;Couilly-Pont-aux-Dames;2097;29;2126
11;Île-de-France;77;1;06;129;Coulombs-en-Valois;559;9;568
11;Île-de-France;77;1;21;130;Coulommes;488;4;492
11;Île-de-France;77;1;05;131;Coulommiers;14779;239;15018
11;Île-de-France;77;5;21;132;Coupvray;2871;28;2899
11;Île-de-France;77;3;13;133;Courcelles-en-Bassée;199;3;202
11;Île-de-France;77;3;18;134;Courchamp;148;3;151
11;Île-de-France;77;3;08;135;Courpalay;1294;14;1308
11;Île-de-France;77;2;08;136;Courquetaine;189;7;196
11;Île-de-France;77;3;18;137;Courtacon;239;10;249
11;Île-de-France;77;3;14;138;Courtomer;548;5;553
11;Île-de-France;77;5;23;139;Courtry;6698;52;6750
11;Île-de-France;77;3;18;140;Coutençon;281;3;284
11;Île-de-France;77;1;21;141;Coutevroult;1167;11;1178
11;Île-de-France;77;1;21;142;Crécy-la-Chapelle;4713;67;4780
11;Île-de-France;77;1;03;143;Crégy-lès-Meaux;5223;51;5274
11;Île-de-France;77;3;08;144;Crèvecœur-en-Brie;429;1;430
11;Île-de-France;77;2;14;145;Crisenoy;620;12;632
11;Île-de-France;77;5;01;146;Croissy-Beaubourg;2026;21;2047
11;Île-de-France;77;3;14;147;La Croix-en-Brie;666;8;674
11;Île-de-France;77;1;06;148;Crouy-sur-Ourcq;1825;24;1849
11;Île-de-France;77;1;03;150;Cuisy;455;2;457
11;Île-de-France;77;1;05;151;Dagny;278;4;282
11;Île-de-France;77;2;19;152;Dammarie-les-Lys;22128;146;22274
11;Île-de-France;77;1;12;153;Dammartin-en-Goële;10355;88;10443
11;Île-de-France;77;1;08;154;Dammartin-sur-Tigeaux;1135;16;1151
11;Île-de-France;77;5;09;155;Dampmart;3417;36;3453
11;Île-de-France;77;4;15;156;Darvault;896;14;910
11;Île-de-France;77;1;06;157;Dhuisy;311;6;317
11;Île-de-France;77;3;15;158;Diant;199;2;201
11;Île-de-France;77;3;18;159;Donnemarie-Dontilly;2775;48;2823
11;Île-de-France;77;4;15;161;Dormelles;802;18;820
11;Île-de-France;77;3;05;162;Doue;1070;8;1078
11;Île-de-France;77;1;06;163;Douy-la-Ramée;367;5;372
11;Île-de-France;77;2;14;164;Échouboulains;557;6;563
11;Île-de-France;77;2;14;165;Les Écrennes;599;5;604
11;Île-de-France;77;3;18;167;Égligny;323;6;329
11;Île-de-France;77;4;15;168;Égreville;2152;38;2190
11;Île-de-France;77;5;17;169;Émerainville;7659;32;7691
11;Île-de-France;77;5;21;171;Esbly;6404;47;6451
11;Île-de-France;77;3;13;172;Esmans;887;9;896
11;Île-de-France;77;1;06;173;Étrépilly;844;7;851
11;Île-de-France;77;3;18;174;Everly;582;11;593
11;Île-de-France;77;2;08;175;Évry-Grégy-sur-Yerre;3025;30;3055
11;Île-de-France;77;1;08;176;Faremoutiers;2944;28;2972
11;Île-de-France;77;3;16;177;Favières;1132;13;1145
11;Île-de-France;77;4;15;178;Faÿ-lès-Nemours;495;11;506
11;Île-de-France;77;2;14;179;Féricy;594;15;609
11;Île-de-France;77;5;16;180;Férolles-Attilly;1257;27;1284
11;Île-de-France;77;5;16;181;Ferrières-en-Brie;3768;35;3803
11;Île-de-France;77;3;05;182;La Ferté-Gaucher;4933;48;4981
11;Île-de-France;77;1;06;183;La Ferté-sous-Jouarre;9637;85;9722
11;Île-de-France;77;4;15;184;Flagy;622;10;632
11;Île-de-France;77;4;07;185;Fleury-en-Bière;647;17;664
11;Île-de-France;77;4;07;186;Fontainebleau;15696;463;16159
11;Île-de-France;77;3;18;187;Fontaine-Fourches;588;3;591
11;Île-de-France;77;2;14;188;Fontaine-le-Port;998;18;1016
11;Île-de-France;77;3;14;190;Fontains;258;5;263
11;Île-de-France;77;3;14;191;Fontenailles;1052;13;1065
11;Île-de-France;77;3;08;192;Fontenay-Trésigny;5710;57;5767
11;Île-de-France;77;1;03;193;Forfry;233;1;234
11;Île-de-France;77;3;13;194;Forges;415;17;432
11;Île-de-France;77;2;14;195;Fouju;575;10;585
11;Île-de-France;77;1;03;196;Fresnes-sur-Marne;971;3;974
11;Île-de-France;77;3;18;197;Frétoy;166;3;169
11;Île-de-France;77;4;07;198;Fromont;247;4;251
11;Île-de-France;77;1;06;199;Fublaines;1389;11;1400
11;Île-de-France;77;4;15;200;Garentreville;117;2;119
11;Île-de-France;77;3;14;201;Gastins;678;4;682
11;Île-de-France;77;4;15;202;La Genevraye;802;6;808
11;Île-de-France;77;1;06;203;Germigny-l'Évêque;1326;21;1347
11;Île-de-France;77;1;06;204;Germigny-sous-Coulombs;211;3;214
11;Île-de-France;77;1;03;205;Gesvres-le-Chapitre;148;1;149
11;Île-de-France;77;1;05;206;Giremoutiers;181;4;185
11;Île-de-France;77;4;15;207;Gironville;153;5;158
11;Île-de-France;77;3;18;208;Gouaix;1400;29;1429
11;Île-de-France;77;5;09;209;Gouvernes;1186;22;1208
11;Île-de-France;77;3;13;210;La Grande-Paroisse;2833;35;2868
11;Île-de-France;77;3;14;211;Grandpuits-Bailly-Carrois;1025;9;1034
11;Île-de-France;77;3;18;212;Gravon;164;3;167
11;Île-de-France;77;1;03;214;Gressy;814;13;827
11;Île-de-France;77;5;16;215;Gretz-Armainvilliers;8476;69;8545
11;Île-de-France;77;4;15;216;Grez-sur-Loing;1413;35;1448
11;Île-de-France;77;2;08;217;Grisy-Suisnes;2532;30;2562
11;Île-de-France;77;3;18;218;Grisy-sur-Seine;108;1;109
11;Île-de-France;77;1;08;219;Guérard;2621;33;2654
11;Île-de-France;77;4;07;220;Guercheville;266;5;271
11;Île-de-France;77;5;09;221;Guermantes;1144;24;1168
11;Île-de-France;77;2;14;222;Guignes;4296;29;4325
11;Île-de-France;77;3;18;223;Gurcy-le-Châtel;565;6;571
11;Île-de-France;77;1;05;224;Hautefeuille;253;2;255
11;Île-de-France;77;1;21;225;La Haute-Maison;318;7;325
11;Île-de-France;77;4;07;226;Héricy;2545;101;2646
11;Île-de-France;77;3;18;227;Hermé;624;17;641
11;Île-de-France;77;3;05;228;Hondevilliers;256;4;260
11;Île-de-France;77;3;08;229;La Houssaye-en-Brie;1650;18;1668
11;Île-de-France;77;4;15;230;Ichy;161;2;163
11;Île-de-France;77;1;06;231;Isles-les-Meldeuses;815;2;817
11;Île-de-France;77;1;03;232;Isles-lès-Villenoy;1149;17;1166
11;Île-de-France;77;1;03;233;Iverny;589;3;592
11;Île-de-France;77;5;09;234;Jablines;691;7;698
11;Île-de-France;77;1;06;235;Jaignes;316;5;321
11;Île-de-France;77;3;18;236;Jaulnes;345;4;349
11;Île-de-France;77;5;22;237;Jossigny;656;9;665
11;Île-de-France;77;1;06;238;Jouarre;4349;41;4390
11;Île-de-France;77;3;18;239;Jouy-le-Châtel;1509;20;1529
11;Île-de-France;77;3;05;240;Jouy-sur-Morin;2171;28;2199
11;Île-de-France;77;1;12;241;Juilly;2003;15;2018
11;Île-de-France;77;3;18;242;Jutigny;537;7;544
11;Île-de-France;77;5;09;243;Lagny-sur-Marne;21539;225;21764
11;Île-de-France;77;4;15;244;Larchant;681;42;723
11;Île-de-France;77;3;13;245;Laval-en-Brie;410;4;414
11;Île-de-France;77;3;18;246;Léchelle;587;15;602
11;Île-de-France;77;3;05;247;Lescherolles;447;11;458
11;Île-de-France;77;5;09;248;Lesches;763;8;771
11;Île-de-France;77;5;16;249;Lésigny;7151;118;7269
11;Île-de-France;77;3;05;250;Leudon-en-Brie;162;7;169
11;Île-de-France;77;2;04;251;Lieusaint;13853;94;13947
11;Île-de-France;77;2;08;252;Limoges-Fourches;561;6;567
11;Île-de-France;77;2;08;253;Lissy;288;1;289
11;Île-de-France;77;3;08;254;Liverdy-en-Brie;1285;22;1307
11;Île-de-France;77;2;11;255;Livry-sur-Seine;2181;34;2215
11;Île-de-France;77;3;18;256;Lizines;186;1;187
11;Île-de-France;77;1;06;257;Lizy-sur-Ourcq;3533;21;3554
11;Île-de-France;77;5;01;258;Lognes;14353;65;14418
11;Île-de-France;77;1;12;259;Longperrier;2331;11;2342
11;Île-de-France;77;3;18;260;Longueville;1781;25;1806
11;Île-de-France;77;4;15;261;Lorrez-le-Bocage-Préaux;1189;20;1209
11;Île-de-France;77;3;18;262;Louan-Villegruis-Fontaine;490;18;508
11;Île-de-France;77;3;18;263;Luisetaines;236;7;243
11;Île-de-France;77;3;08;264;Lumigny-Nesles-Ormeaux;1526;17;1543
11;Île-de-France;77;1;06;265;Luzancy;1112;48;1160
11;Île-de-France;77;2;14;266;Machault;779;12;791
11;Île-de-France;77;4;15;267;La Madeleine-sur-Loing;360;3;363
11;Île-de-France;77;5;21;268;Magny-le-Hongre;9107;150;9257
11;Île-de-France;77;2;11;269;Maincy;1808;54;1862
11;Île-de-France;77;1;05;270;Maisoncelles-en-Brie;926;11;937
11;Île-de-France;77;4;15;271;Maisoncelles-en-Gâtinais;134;1;135
11;Île-de-France;77;3;18;272;Maison-Rouge;862;8;870
11;Île-de-France;77;1;12;273;Marchémoret;583;4;587
11;Île-de-France;77;1;06;274;Marcilly;442;2;444
11;Île-de-France;77;3;18;275;Les Marêts;148;4;152
11;Île-de-France;77;1;03;276;Mareuil-lès-Meaux;3231;41;3272
11;Île-de-France;77;3;08;277;Marles-en-Brie;1763;22;1785
11;Île-de-France;77;1;05;278;Marolles-en-Brie;410;6;416
11;Île-de-France;77;3;13;279;Marolles-sur-Seine;1814;33;1847
11;Île-de-France;77;1;06;280;Mary-sur-Marne;1114;11;1125
11;Île-de-France;77;1;05;281;Mauperthuis;476;4;480
11;Île-de-France;77;1;12;282;Mauregard;361;4;365
11;Île-de-France;77;1;06;283;May-en-Multien;943;4;947
11;Île-de-France;77;1;10;284;Meaux;55750;479;56229
11;Île-de-France;77;2;20;285;Le Mée-sur-Seine;20917;142;21059
11;Île-de-France;77;3;18;286;Meigneux;228;6;234
11;Île-de-France;77;3;05;287;Meilleray;496;11;507
11;Île-de-France;77;2;11;288;Melun;40844;295;41139
11;Île-de-France;77;3;18;289;Melz-sur-Seine;351;3;354
11;Île-de-France;77;1;06;290;Méry-sur-Marne;673;58;731
11;Île-de-France;77;1;12;291;Le Mesnil-Amelot;1068;5;1073
11;Île-de-France;77;1;03;292;Messy;1199;11;1210
11;Île-de-France;77;3;13;293;Misy-sur-Yonne;926;17;943
11;Île-de-France;77;1;12;294;Mitry-Mory;20648;83;20731
11;Île-de-France;77;2;14;295;Moisenay;1387;13;1400
11;Île-de-France;77;2;04;296;Moissy-Cramayel;17849;135;17984
11;Île-de-France;77;4;15;297;Mondreville;329;4;333
11;Île-de-France;77;3;18;298;Mons-en-Montois;445;10;455
11;Île-de-France;77;1;06;300;Montceaux-lès-Meaux;604;12;616
11;Île-de-France;77;3;18;301;Montceaux-lès-Provins;323;1;324
11;Île-de-France;77;4;15;302;Montcourt-Fromonville;1958;34;1992
11;Île-de-France;77;3;05;303;Montdauphin;239;3;242
11;Île-de-France;77;3;05;304;Montenils;25;0;25
11;Île-de-France;77;3;13;305;Montereau-Fault-Yonne;21229;193;21422
11;Île-de-France;77;2;11;306;Montereau-sur-le-Jard;503;6;509
11;Île-de-France;77;5;09;307;Montévrain;13517;111;13628
11;Île-de-France;77;1;12;308;Montgé-en-Goële;743;7;750
11;Île-de-France;77;1;03;309;Monthyon;1753;10;1763
11;Île-de-France;77;3;18;310;Montigny-le-Guesdier;305;6;311
11;Île-de-France;77;3;18;311;Montigny-Lencoup;1427;15;1442
11;Île-de-France;77;4;15;312;Montigny-sur-Loing;2660;75;2735
11;Île-de-France;77;3;15;313;Montmachoux;257;2;259
11;Île-de-France;77;3;05;314;Montolivet;236;2;238
11;Île-de-France;77;5;21;315;Montry;3705;31;3736
11;Île-de-France;77;4;13;316;Moret-Loing-et-Orvanne;12223;333;12556
11;Île-de-France;77;3;14;317;Mormant;5014;36;5050
11;Île-de-France;77;3;08;318;Mortcerf;1431;22;1453
11;Île-de-France;77;3;18;319;Mortery;145;3;148
11;Île-de-France;77;1;05;320;Mouroux;5654;58;5712
11;Île-de-France;77;3;18;321;Mousseaux-lès-Bray;672;4;676
11;Île-de-France;77;1;12;322;Moussy-le-Neuf;3160;27;3187
11;Île-de-France;77;1;12;323;Moussy-le-Vieux;1477;5;1482
11;Île-de-France;77;3;18;325;Mouy-sur-Seine;359;4;363
11;Île-de-France;77;2;19;326;Nandy;6235;71;6306
11;Île-de-France;77;3;14;327;Nangis;8867;86;8953
11;Île-de-France;77;4;07;328;Nanteau-sur-Essonne;429;8;437
11;Île-de-France;77;4;15;329;Nanteau-sur-Lunain;686;3;689
11;Île-de-France;77;1;06;330;Nanteuil-lès-Meaux;6225;74;6299
11;Île-de-France;77;1;06;331;Nanteuil-sur-Marne;429;6;435
11;Île-de-France;77;1;12;332;Nantouillet;286;1;287
11;Île-de-France;77;4;15;333;Nemours;13088;123;13211
11;Île-de-France;77;1;03;335;Chauconin-Neufmontiers;3554;28;3582
11;Île-de-France;77;3;08;336;Neufmoutiers-en-Brie;1185;11;1196
11;Île-de-France;77;5;01;337;Noisiel;15960;107;16067
11;Île-de-France;77;3;15;338;Noisy-Rudignon;597;8;605
11;Île-de-France;77;4;07;339;Noisy-sur-École;1827;58;1885
11;Île-de-France;77;4;15;340;Nonville;602;11;613
11;Île-de-France;77;3;18;341;Noyen-sur-Seine;381;10;391
11;Île-de-France;77;4;15;342;Obsonville;111;1;112
11;Île-de-France;77;1;06;343;Ocquerre;392;19;411
11;Île-de-France;77;1;03;344;Oissery;2431;23;2454
11;Île-de-France;77;3;05;345;Orly-sur-Morin;666;9;675
11;Île-de-France;77;3;18;347;Les Ormes-sur-Voulzie;856;10;866
11;Île-de-France;77;4;15;348;Ormesson;234;6;240
11;Île-de-France;77;1;12;349;Othis;6725;76;6801
11;Île-de-France;77;5;16;350;Ozoir-la-Ferrière;20532;194;20726
11;Île-de-France;77;2;08;352;Ozouer-le-Voulgis;1921;22;1943
11;Île-de-France;77;4;15;353;Paley;425;7;432
11;Île-de-France;77;2;14;354;Pamfou;940;8;948
11;Île-de-France;77;3;18;355;Paroy;159;1;160
11;Île-de-France;77;3;18;356;Passy-sur-Seine;45;1;46
11;Île-de-France;77;3;08;357;Pécy;851;10;861
11;Île-de-France;77;1;03;358;Penchard;1315;12;1327
11;Île-de-France;77;4;07;359;Perthes;1980;25;2005
11;Île-de-France;77;1;05;360;Pézarches;386;4;390
11;Île-de-France;77;1;06;361;Pierre-Levée;463;7;470
11;Île-de-France;77;1;23;363;Le Pin;1568;11;1579
11;Île-de-France;77;1;03;364;Le Plessis-aux-Bois;260;2;262
11;Île-de-France;77;3;08;365;Le Plessis-Feu-Aussoux;614;5;619
11;Île-de-France;77;1;03;366;Le Plessis-l'Évêque;292;1;293
11;Île-de-France;77;1;06;367;Le Plessis-Placy;279;4;283
11;Île-de-France;77;3;18;368;Poigny;515;13;528
11;Île-de-France;77;1;06;369;Poincy;724;12;736
11;Île-de-France;77;4;15;370;Poligny;787;12;799
11;Île-de-France;77;1;08;371;Pommeuse;2966;21;2987
11;Île-de-France;77;5;09;372;Pomponne;4183;38;4221
11;Île-de-France;77;5;17;373;Pontault-Combault;37617;208;37825
11;Île-de-France;77;5;16;374;Pontcarré;2186;18;2204
11;Île-de-France;77;1;03;376;Précy-sur-Marne;809;3;812
11;Île-de-France;77;3;08;377;Presles-en-Brie;2312;29;2341
11;Île-de-France;77;2;19;378;Pringy;2954;20;2974
11;Île-de-France;77;3;18;379;Provins;12132;285;12417
11;Île-de-France;77;1;06;380;Puisieux;320;6;326
11;Île-de-France;77;3;14;381;Quiers;666;5;671
11;Île-de-France;77;1;21;382;Quincy-Voisins;5439;54;5493
11;Île-de-France;77;3;14;383;Rampillon;826;7;833
11;Île-de-France;77;2;04;384;Réau;1919;3;1922
11;Île-de-France;77;3;05;385;Rebais;2292;24;2316
11;Île-de-France;77;4;07;386;Recloses;614;22;636
11;Île-de-France;77;4;15;387;Remauville;466;8;474
11;Île-de-France;77;1;06;388;Reuil-en-Brie;826;7;833
11;Île-de-France;77;2;11;389;La Rochette;3778;105;3883
11;Île-de-France;77;5;17;390;Roissy-en-Brie;22851;82;22933
11;Île-de-France;77;3;18;391;Rouilly;489;6;495
11;Île-de-France;77;1;12;392;Rouvres;910;12;922
11;Île-de-France;77;3;08;393;Rozay-en-Brie;2808;36;2844
11;Île-de-France;77;2;11;394;Rubelles;2831;23;2854
11;Île-de-France;77;4;07;395;Rumont;121;4;125
11;Île-de-France;77;3;18;396;Rupéreux;98;0;98
11;Île-de-France;77;1;06;397;Saâcy-sur-Marne;1844;25;1869
11;Île-de-France;77;3;05;398;Sablonnières;717;8;725
11;Île-de-France;77;1;05;400;Saint-Augustin;1729;28;1757
11;Île-de-France;77;1;06;401;Sainte-Aulde;673;7;680
11;Île-de-France;77;3;05;402;Saint-Barthélemy;338;5;343
11;Île-de-France;77;3;18;403;Saint-Brice;807;17;824
11;Île-de-France;77;3;18;404;Sainte-Colombe;1826;32;1858
11;Île-de-France;77;3;05;405;Saint-Cyr-sur-Morin;1969;44;2013
11;Île-de-France;77;3;05;406;Saint-Denis-lès-Rebais;997;19;1016
11;Île-de-France;77;2;19;407;Saint-Fargeau-Ponthierry;14121;125;14246
11;Île-de-France;77;1;21;408;Saint-Fiacre;417;2;419
11;Île-de-France;77;3;13;409;Saint-Germain-Laval;2707;101;2808
11;Île-de-France;77;2;11;410;Saint-Germain-Laxis;738;33;771
11;Île-de-France;77;3;05;411;Saint-Germain-sous-Doue;553;11;564
11;Île-de-France;77;4;07;412;Saint-Germain-sur-École;380;5;385
11;Île-de-France;77;5;21;413;Saint-Germain-sur-Morin;3770;48;3818
11;Île-de-France;77;3;18;414;Saint-Hilliers;483;7;490
11;Île-de-France;77;1;06;415;Saint-Jean-les-Deux-Jumeaux;1277;18;1295
11;Île-de-France;77;3;14;416;Saint-Just-en-Brie;238;5;243
11;Île-de-France;77;3;05;417;Saint-Léger;260;1;261
11;Île-de-France;77;3;18;418;Saint-Loup-de-Naud;874;11;885
11;Île-de-France;77;4;13;419;Saint-Mammès;3391;117;3508
11;Île-de-France;77;1;12;420;Saint-Mard;3875;26;3901
11;Île-de-France;77;3;05;421;Saint-Mars-Vieux-Maisons;265;6;271
11;Île-de-France;77;3;05;423;Saint-Martin-des-Champs;655;9;664
11;Île-de-France;77;3;18;424;Saint-Martin-du-Boschet;278;4;282
11;Île-de-France;77;4;07;425;Saint-Martin-en-Bière;737;21;758
11;Île-de-France;77;2;14;426;Saint-Méry;337;9;346
11;Île-de-France;77;1;03;427;Saint-Mesmes;612;5;617
11;Île-de-France;77;3;14;428;Saint-Ouen-en-Brie;834;12;846
11;Île-de-France;77;3;05;429;Saint-Ouen-sur-Morin;537;5;542
11;Île-de-France;77;1;12;430;Saint-Pathus;6110;53;6163
11;Île-de-France;77;4;15;431;Saint-Pierre-lès-Nemours;5394;89;5483
11;Île-de-France;77;3;05;432;Saint-Rémy-la-Vanne;992;9;1001
11;Île-de-France;77;1;05;433;Beautheil-Saints;1992;34;2026
11;Île-de-France;77;3;18;434;Saint-Sauveur-lès-Bray;364;5;369
11;Île-de-France;77;4;07;435;Saint-Sauveur-sur-École;1107;31;1138
11;Île-de-France;77;3;05;436;Saint-Siméon;896;5;901
11;Île-de-France;77;1;03;437;Saint-Soupplets;3224;29;3253
11;Île-de-France;77;5;09;438;Saint-Thibault-des-Vignes;6354;73;6427
11;Île-de-France;77;3;13;439;Salins;1169;23;1192
11;Île-de-France;77;1;06;440;Sammeron;1132;13;1145
11;Île-de-France;77;4;07;441;Samois-sur-Seine;2040;47;2087
11;Île-de-France;77;4;07;442;Samoreau;2396;60;2456
11;Île-de-France;77;1;21;443;Sancy;389;8;397
11;Île-de-France;77;3;18;444;Sancy-lès-Provins;318;2;320
11;Île-de-France;77;2;20;445;Savigny-le-Temple;29987;225;30212
11;Île-de-France;77;3;18;446;Savins;603;9;612
11;Île-de-France;77;2;19;447;Seine-Port;1853;48;1901
11;Île-de-France;77;1;06;448;Sept-Sorts;522;7;529
11;Île-de-France;77;5;21;449;Serris;9494;90;9584
11;Île-de-France;77;5;16;450;Servon;3288;52;3340
11;Île-de-France;77;1;06;451;Signy-Signets;582;6;588
11;Île-de-France;77;3;18;452;Sigy;65;0;65
11;Île-de-France;77;2;14;453;Sivry-Courtry;1155;14;1169
11;Île-de-France;77;3;18;454;Sognolles-en-Montois;376;6;382
11;Île-de-France;77;2;08;455;Soignolles-en-Brie;2009;32;2041
11;Île-de-France;77;3;18;456;Soisy-Bouy;814;19;833
11;Île-de-France;77;2;08;457;Solers;1179;22;1201
11;Île-de-France;77;4;15;458;Souppes-sur-Loing;5383;102;5485
11;Île-de-France;77;3;18;459;Sourdun;1504;393;1897
11;Île-de-France;77;1;06;460;Tancrou;349;4;353
11;Île-de-France;77;3;18;461;Thénisy;295;6;301
11;Île-de-France;77;1;12;462;Thieux;872;2;874
11;Île-de-France;77;4;13;463;Thomery;3420;114;3534
11;Île-de-France;77;5;09;464;Thorigny-sur-Marne;10454;116;10570
11;Île-de-France;77;3;15;465;Thoury-Férottes;655;9;664
11;Île-de-France;77;1;21;466;Tigeaux;381;3;384
11;Île-de-France;77;3;18;467;La Tombe;207;0;207
11;Île-de-France;77;5;22;468;Torcy;22030;104;22134
11;Île-de-France;77;1;05;469;Touquin;1221;11;1232
11;Île-de-France;77;5;16;470;Tournan-en-Brie;8521;110;8631
11;Île-de-France;77;4;07;471;Tousson;363;8;371
11;Île-de-France;77;3;05;472;La Trétoire;504;10;514
11;Île-de-France;77;4;15;473;Treuzy-Levelay;411;7;418
11;Île-de-France;77;1;03;474;Trilbardou;657;5;662
11;Île-de-France;77;1;06;475;Trilport;5045;32;5077
11;Île-de-France;77;1;06;476;Trocy-en-Multien;233;2;235
11;Île-de-France;77;4;07;477;Ury;850;30;880
11;Île-de-France;77;1;06;478;Ussy-sur-Marne;1097;10;1107
11;Île-de-France;77;5;23;479;Vaires-sur-Marne;13368;132;13500
11;Île-de-France;77;2;14;480;Valence-en-Brie;1048;9;1057
11;Île-de-France;77;3;14;481;Vanvillé;188;1;189
11;Île-de-France;77;3;13;482;Varennes-sur-Seine;3601;70;3671
11;Île-de-France;77;1;03;483;Varreddes;2032;22;2054
11;Île-de-France;77;1;21;484;Vaucourtois;276;6;282
11;Île-de-France;77;4;07;485;Le Vaudoué;729;14;743
11;Île-de-France;77;3;08;486;Vaudoy-en-Brie;898;8;906
11;Île-de-France;77;2;11;487;Vaux-le-Pénil;11101;159;11260
11;Île-de-France;77;4;15;489;Vaux-sur-Lunain;232;3;235
11;Île-de-France;77;1;06;490;Vendrest;696;9;705
11;Île-de-France;77;3;05;492;Verdelot;657;4;661
11;Île-de-France;77;3;14;493;Verneuil-l'Étang;3204;21;3225
11;Île-de-France;77;4;13;494;Vernou-la-Celle-sur-Seine;2643;37;2680
11;Île-de-France;77;2;20;495;Vert-Saint-Denis;8238;82;8320
11;Île-de-France;77;3;14;496;Vieux-Champagne;189;4;193
11;Île-de-France;77;1;03;498;Vignely;307;0;307
11;Île-de-France;77;4;15;500;Villebéon;468;9;477
11;Île-de-France;77;4;13;501;Villecerf;719;17;736
11;Île-de-France;77;4;15;504;Villemaréchal;1111;17;1128
11;Île-de-France;77;1;21;505;Villemareuil;385;5;390
11;Île-de-France;77;4;15;506;Villemer;782;10;792
11;Île-de-France;77;3;18;507;Villenauxe-la-Petite;410;6;416
11;Île-de-France;77;5;16;508;Villeneuve-le-Comte;1816;36;1852
11;Île-de-France;77;3;18;509;Villeneuve-les-Bordes;610;7;617
11;Île-de-France;77;5;16;510;Villeneuve-Saint-Denis;982;4;986
11;Île-de-France;77;1;12;511;Villeneuve-sous-Dammartin;645;0;645
11;Île-de-France;77;3;05;512;Villeneuve-sur-Bellot;1129;12;1141
11;Île-de-France;77;1;03;513;Villenoy;4975;34;5009
11;Île-de-France;77;1;23;514;Villeparisis;26580;98;26678
11;Île-de-France;77;1;03;515;Villeroy;705;5;710
11;Île-de-France;77;4;13;516;Ville-Saint-Jacques;862;26;888
11;Île-de-France;77;1;23;517;Villevaudé;2137;13;2150
11;Île-de-France;77;2;07;518;Villiers-en-Bière;208;3;211
11;Île-de-France;77;3;18;519;Villiers-Saint-Georges;1189;25;1214
11;Île-de-France;77;4;07;520;Villiers-sous-Grez;646;20;666
11;Île-de-France;77;1;21;521;Villiers-sur-Morin;1935;46;1981
11;Île-de-France;77;3;18;522;Villiers-sur-Seine;298;6;304
11;Île-de-France;77;3;18;523;Villuis;261;3;264
11;Île-de-France;77;3;18;524;Vimpelles;522;6;528
11;Île-de-France;77;1;12;525;Vinantes;383;2;385
11;Île-de-France;77;1;06;526;Vincy-Manœuvre;277;5;282
11;Île-de-France;77;3;08;527;Voinsles;576;17;593
11;Île-de-France;77;2;11;528;Voisenon;1154;16;1170
11;Île-de-France;77;1;21;529;Voulangis;1494;30;1524
11;Île-de-France;77;3;18;530;Voulton;316;12;328
11;Île-de-France;77;3;15;531;Voulx;1664;23;1687
11;Île-de-France;77;3;18;532;Vulaines-lès-Provins;66;0;66
11;Île-de-France;77;4;07;533;Vulaines-sur-Seine;2748;62;2810
11;Île-de-France;77;2;14;534;Yèbles;953;1;954
11;Île-de-France;78;2;14;003;Ablis;3490;48;3538
11;Île-de-France;78;3;13;005;Achères;21529;159;21688
11;Île-de-France;78;1;02;006;Adainville;662;16;678
11;Île-de-France;78;3;16;007;Aigremont;1086;49;1135
11;Île-de-France;78;2;14;009;Allainville;293;6;299
11;Île-de-France;78;3;19;010;Les Alluets-le-Roi;1213;37;1250
11;Île-de-France;78;3;01;013;Andelu;483;4;487
11;Île-de-France;78;3;05;015;Andrésy;13302;147;13449
11;Île-de-France;78;1;02;020;Arnouville-lès-Mantes;939;12;951
11;Île-de-France;78;1;01;029;Aubergenville;12152;64;12216
11;Île-de-France;78;2;14;030;Auffargis;1958;47;2005
11;Île-de-France;78;1;02;031;Auffreville-Brasseuil;649;10;659
11;Île-de-France;78;1;01;033;Aulnay-sur-Mauldre;1142;24;1166
11;Île-de-France;78;2;01;034;Auteuil;967;19;986
11;Île-de-France;78;2;01;036;Autouillet;584;7;591
11;Île-de-France;78;4;04;043;Bailly;3733;140;3873
11;Île-de-France;78;1;02;048;Bazainville;1457;41;1498
11;Île-de-France;78;3;01;049;Bazemont;1649;46;1695
11;Île-de-France;78;2;01;050;Bazoches-sur-Guyonne;641;9;650
11;Île-de-France;78;2;01;053;Béhoust;479;12;491
11;Île-de-France;78;1;02;057;Bennecourt;1883;21;1904
11;Île-de-France;78;2;12;062;Beynes;7618;111;7729
11;Île-de-France;78;1;02;068;Blaru;894;20;914
11;Île-de-France;78;1;02;070;Boinville-en-Mantois;288;2;290
11;Île-de-France;78;2;14;071;Boinville-le-Gaillard;609;9;618
11;Île-de-France;78;1;02;072;Boinvilliers;264;2;266
11;Île-de-France;78;4;15;073;Bois-d'Arcy;15325;143;15468
11;Île-de-France;78;1;02;076;Boissets;275;4;279
11;Île-de-France;78;2;14;077;La Boissière-École;752;57;809
11;Île-de-France;78;1;02;082;Boissy-Mauvoisin;623;11;634
11;Île-de-France;78;2;01;084;Boissy-sans-Avoir;653;12;665
11;Île-de-France;78;2;14;087;Bonnelles;2079;50;2129
11;Île-de-France;78;1;02;089;Bonnières-sur-Seine;4791;38;4829
11;Île-de-France;78;1;01;090;Bouafle;2194;28;2222
11;Île-de-France;78;4;04;092;Bougival;8790;142;8932
11;Île-de-France;78;1;02;096;Bourdonné;499;9;508
11;Île-de-France;78;1;02;104;Breuil-Bois-Robert;743;12;755
11;Île-de-France;78;1;02;107;Bréval;1803;26;1829
11;Île-de-France;78;2;14;108;Les Bréviaires;1305;29;1334
11;Île-de-France;78;1;07;113;Brueil-en-Vexin;696;12;708
11;Île-de-France;78;4;21;117;Buc;6027;165;6192
11;Île-de-France;78;1;08;118;Buchelay;3306;23;3329
11;Île-de-France;78;2;14;120;Bullion;1908;62;1970
11;Île-de-France;78;3;13;123;Carrières-sous-Poissy;16641;116;16757
11;Île-de-France;78;3;06;124;Carrières-sur-Seine;15178;198;15376
11;Île-de-France;78;2;14;125;La Celle-les-Bordes;836;31;867
11;Île-de-France;78;4;04;126;La Celle-Saint-Cloud;20692;404;21096
11;Île-de-France;78;2;14;128;Cernay-la-Ville;1559;38;1597
11;Île-de-France;78;3;16;133;Chambourcy;5587;141;5728
11;Île-de-France;78;3;05;138;Chanteloup-les-Vignes;10426;73;10499
11;Île-de-France;78;1;11;140;Chapet;1335;25;1360
11;Île-de-France;78;4;09;143;Châteaufort;1423;39;1462
11;Île-de-France;78;3;03;146;Chatou;30153;501;30654
11;Île-de-France;78;1;02;147;Chaufour-lès-Bonnières;476;7;483
11;Île-de-France;78;3;15;152;Chavenay;1767;76;1843
11;Île-de-France;78;4;04;158;Le Chesnay-Rocquencourt;31233;638;31871
11;Île-de-France;78;2;09;160;Chevreuse;5610;136;5746
11;Île-de-France;78;2;09;162;Choisel;545;26;571
11;Île-de-France;78;1;02;163;Civry-la-Forêt;332;4;336
11;Île-de-France;78;2;14;164;Clairefontaine-en-Yvelines;818;64;882
11;Île-de-France;78;4;12;165;Les Clayes-sous-Bois;17487;235;17722
11;Île-de-France;78;2;09;168;Coignières;4355;31;4386
11;Île-de-France;78;1;02;171;Condé-sur-Vesgre;1238;27;1265
11;Île-de-France;78;3;05;172;Conflans-Sainte-Honorine;35536;410;35946
11;Île-de-France;78;1;02;185;Courgent;366;11;377
11;Île-de-France;78;1;02;188;Cravent;407;6;413
11;Île-de-France;78;3;19;189;Crespières;1671;63;1734
11;Île-de-France;78;3;03;190;Croissy-sur-Seine;10031;336;10367
11;Île-de-France;78;1;02;192;Dammartin-en-Serve;1375;16;1391
11;Île-de-France;78;2;09;193;Dampierre-en-Yvelines;1022;15;1037
11;Île-de-France;78;1;02;194;Dannemarie;209;3;212
11;Île-de-France;78;3;19;196;Davron;293;14;307
11;Île-de-France;78;1;07;202;Drocourt;561;8;569
11;Île-de-France;78;1;11;206;Ecquevilly;4150;44;4194
11;Île-de-France;78;2;18;208;Élancourt;25624;244;25868
11;Île-de-France;78;2;14;209;Émancé;881;13;894
11;Île-de-France;78;1;07;217;Épône;6561;94;6655
11;Île-de-France;78;2;14;220;Les Essarts-le-Roi;6668;136;6804
11;Île-de-France;78;3;16;224;L'Étang-la-Ville;4453;185;4638
11;Île-de-France;78;1;11;227;Évecquemont;793;14;807
11;Île-de-France;78;1;07;230;La Falaise;592;8;600
11;Île-de-France;78;1;02;231;Favrieux;155;6;161
11;Île-de-France;78;3;19;233;Feucherolles;2983;141;3124
11;Île-de-France;78;1;02;234;Flacourt;183;0;183
11;Île-de-France;78;2;01;236;Flexanville;583;14;597
11;Île-de-France;78;1;02;237;Flins-Neuve-Église;154;2;156
11;Île-de-France;78;1;01;238;Flins-sur-Seine;2428;30;2458
11;Île-de-France;78;1;07;239;Follainville-Dennemont;2146;30;2176
11;Île-de-France;78;4;15;242;Fontenay-le-Fleury;13466;141;13607
11;Île-de-France;78;1;02;245;Fontenay-Mauvoisin;377;14;391
11;Île-de-France;78;1;07;246;Fontenay-Saint-Père;954;19;973
11;Île-de-France;78;1;02;255;Freneuse;4266;58;4324
11;Île-de-France;78;1;11;261;Gaillon-sur-Montcient;665;13;678
11;Île-de-France;78;2;01;262;Galluis;1243;18;1261
11;Île-de-France;78;2;01;263;Gambais;2476;64;2540
11;Île-de-France;78;2;14;264;Gambaiseuil;57;1;58
11;Île-de-France;78;2;01;265;Garancières;2375;53;2428
11;Île-de-France;78;1;07;267;Gargenville;7893;68;7961
11;Île-de-France;78;2;14;269;Gazeran;1290;30;1320
11;Île-de-France;78;1;02;276;Gommecourt;674;5;679
11;Île-de-France;78;2;01;278;Goupillières;511;10;521
11;Île-de-France;78;1;02;281;Goussonville;625;10;635
11;Île-de-France;78;1;02;283;Grandchamp;304;10;314
11;Île-de-France;78;1;02;285;Gressey;544;14;558
11;Île-de-France;78;2;01;289;Grosrouvre;900;39;939
11;Île-de-France;78;1;07;290;Guernes;1074;15;1089
11;Île-de-France;78;1;02;291;Guerville;2166;38;2204
11;Île-de-France;78;1;07;296;Guitrancourt;622;11;633
11;Île-de-France;78;4;10;297;Guyancourt;29471;461;29932
11;Île-de-France;78;1;11;299;Hardricourt;2495;21;2516
11;Île-de-France;78;1;02;300;Hargeville;454;5;459
11;Île-de-France;78;1;02;302;La Hauteville;166;5;171
11;Île-de-France;78;3;01;305;Herbeville;247;6;253
11;Île-de-France;78;2;14;307;Hermeray;949;25;974
11;Île-de-France;78;1;02;310;Houdan;3671;41;3712
11;Île-de-France;78;3;06;311;Houilles;32801;346;33147
11;Île-de-France;78;1;07;314;Issou;3893;46;3939
11;Île-de-France;78;1;07;317;Jambville;796;13;809
11;Île-de-France;78;1;02;320;Notre-Dame-de-la-Mer;687;15;702
11;Île-de-France;78;2;01;321;Jouars-Pontchartrain;5772;117;5889
11;Île-de-France;78;4;21;322;Jouy-en-Josas;8049;167;8216
11;Île-de-France;78;1;02;324;Jouy-Mauvoisin;558;3;561
11;Île-de-France;78;1;02;325;Jumeauville;605;7;612
11;Île-de-France;78;1;07;327;Juziers;3843;46;3889
11;Île-de-France;78;1;07;329;Lainville-en-Vexin;776;12;788
11;Île-de-France;78;2;09;334;Lévis-Saint-Nom;1600;34;1634
11;Île-de-France;78;1;07;335;Limay;17136;105;17241
11;Île-de-France;78;1;02;337;Limetz-Villez;1937;32;1969
11;Île-de-France;78;4;21;343;Les Loges-en-Josas;1629;65;1694
11;Île-de-France;78;1;02;344;Lommoye;658;9;667
11;Île-de-France;78;1;02;346;Longnes;1502;24;1526
11;Île-de-France;78;2;14;349;Longvilliers;504;12;516
11;Île-de-France;78;3;04;350;Louveciennes;7236;165;7401
11;Île-de-France;78;1;08;354;Magnanville;6177;131;6308
11;Île-de-France;78;2;09;356;Magny-les-Hameaux;9418;170;9588
11;Île-de-France;78;3;17;358;Maisons-Laffitte;23361;501;23862
11;Île-de-France;78;1;08;361;Mantes-la-Jolie;43921;195;44116
11;Île-de-France;78;1;08;362;Mantes-la-Ville;20818;157;20975
11;Île-de-France;78;2;01;364;Marcq;765;9;774
11;Île-de-France;78;2;01;366;Mareil-le-Guyon;391;11;402
11;Île-de-France;78;3;16;367;Mareil-Marly;3677;168;3845
11;Île-de-France;78;3;01;368;Mareil-sur-Mauldre;1696;36;1732
11;Île-de-France;78;3;03;372;Marly-le-Roi;16385;499;16884
11;Île-de-France;78;3;01;380;Maule;5881;221;6102
11;Île-de-France;78;1;02;381;Maulette;1013;15;1028
11;Île-de-France;78;3;05;382;Maurecourt;4414;53;4467
11;Île-de-France;78;2;09;383;Maurepas;17683;248;17931
11;Île-de-France;78;3;19;384;Médan;1346;45;1391
11;Île-de-France;78;1;02;385;Ménerville;212;1;213
11;Île-de-France;78;2;01;389;Méré;1665;50;1715
11;Île-de-France;78;1;02;391;Méricourt;394;7;401
11;Île-de-France;78;3;17;396;Le Mesnil-le-Roi;6285;151;6436
11;Île-de-France;78;2;09;397;Le Mesnil-Saint-Denis;6777;117;6894
11;Île-de-France;78;2;01;398;Les Mesnuls;865;22;887
11;Île-de-France;78;1;11;401;Meulan-en-Yvelines;9005;76;9081
11;Île-de-France;78;1;07;402;Mézières-sur-Seine;3683;40;3723
11;Île-de-France;78;1;11;403;Mézy-sur-Seine;2296;35;2331
11;Île-de-France;78;2;01;404;Millemont;269;4;273
11;Île-de-France;78;2;09;406;Milon-la-Chapelle;283;12;295
11;Île-de-France;78;2;14;407;Mittainville;626;15;641
11;Île-de-France;78;1;02;410;Moisson;979;7;986
11;Île-de-France;78;1;02;413;Mondreville;407;3;410
11;Île-de-France;78;3;01;415;Montainville;510;21;531
11;Île-de-France;78;1;07;416;Montalet-le-Bois;316;5;321
11;Île-de-France;78;1;02;417;Montchauvet;297;7;304
11;Île-de-France;78;3;06;418;Montesson;14991;278;15269
11;Île-de-France;78;2;01;420;Montfort-l'Amaury;2935;78;3013
11;Île-de-France;78;4;10;423;Montigny-le-Bretonneux;32282;459;32741
11;Île-de-France;78;3;19;431;Morainvilliers;3023;82;3105
11;Île-de-France;78;1;02;437;Mousseaux-sur-Seine;679;9;688
11;Île-de-France;78;1;02;439;Mulcent;109;1;110
11;Île-de-France;78;1;11;440;Les Mureaux;33203;159;33362
11;Île-de-France;78;2;01;442;Neauphle-le-Château;3385;54;3439
11;Île-de-France;78;2;01;443;Neauphle-le-Vieux;916;19;935
11;Île-de-France;78;1;02;444;Neauphlette;823;15;838
11;Île-de-France;78;1;01;451;Nézel;1040;15;1055
11;Île-de-France;78;4;19;455;Noisy-le-Roi;7635;285;7920
11;Île-de-France;78;1;07;460;Oinville-sur-Montcient;1070;20;1090
11;Île-de-France;78;2;14;464;Orcemont;1020;23;1043
11;Île-de-France;78;1;02;465;Orgerus;2433;68;2501
11;Île-de-France;78;3;19;466;Orgeval;6664;199;6863
11;Île-de-France;78;2;14;470;Orphin;883;26;909
11;Île-de-France;78;2;14;472;Orsonville;330;6;336
11;Île-de-France;78;1;02;474;Orvilliers;927;9;936
11;Île-de-France;78;1;02;475;Osmoy;379;9;388
11;Île-de-France;78;2;14;478;Paray-Douaville;243;7;250
11;Île-de-France;78;3;16;481;Le Pecq;15716;330;16046
11;Île-de-France;78;1;02;484;Perdreauville;637;16;653
11;Île-de-France;78;2;14;486;Le Perray-en-Yvelines;6597;113;6710
11;Île-de-France;78;4;12;490;Plaisir;30950;353;31303
11;Île-de-France;78;2;14;497;Poigny-la-Forêt;916;41;957
11;Île-de-France;78;3;13;498;Poissy;39187;288;39475
11;Île-de-France;78;2;14;499;Ponthévrard;664;19;683
11;Île-de-France;78;1;07;501;Porcheville;3174;70;3244
11;Île-de-France;78;3;03;502;Le Port-Marly;5481;56;5537
11;Île-de-France;78;1;02;505;Prunay-le-Temple;416;17;433
11;Île-de-France;78;2;14;506;Prunay-en-Yvelines;882;9;891
11;Île-de-France;78;2;01;513;La Queue-les-Yvelines;2199;31;2230
11;Île-de-France;78;2;14;516;Raizeux;979;16;995
11;Île-de-France;78;2;14;517;Rambouillet;27141;495;27636
11;Île-de-France;78;4;15;518;Rennemoulin;110;4;114
11;Île-de-France;78;1;02;520;Richebourg;1593;25;1618
11;Île-de-France;78;2;14;522;Rochefort-en-Yvelines;907;38;945
11;Île-de-France;78;1;02;528;Rolleboise;375;3;378
11;Île-de-France;78;1;02;530;Rosay;374;6;380
11;Île-de-France;78;1;08;531;Rosny-sur-Seine;6883;46;6929
11;Île-de-France;78;1;07;536;Sailly;357;11;368
11;Île-de-France;78;2;14;537;Saint-Arnoult-en-Yvelines;5818;135;5953
11;Île-de-France;78;4;15;545;Saint-Cyr-l'École;19792;640;20432
11;Île-de-France;78;2;09;548;Saint-Forget;473;13;486
11;Île-de-France;78;2;01;550;Saint-Germain-de-la-Grange;1850;37;1887
11;Île-de-France;78;3;16;551;Saint-Germain-en-Laye;44806;1843;46649
11;Île-de-France;78;2;14;557;Saint-Hilarion;948;18;966
11;Île-de-France;78;1;02;558;Saint-Illiers-la-Ville;390;8;398
11;Île-de-France;78;1;02;559;Saint-Illiers-le-Bois;426;5;431
11;Île-de-France;78;2;09;561;Saint-Lambert;447;35;482
11;Île-de-France;78;2;14;562;Saint-Léger-en-Yvelines;1394;32;1426
11;Île-de-France;78;2;14;564;Saint-Martin-de-Bréthencourt;667;9;676
11;Île-de-France;78;1;02;565;Saint-Martin-des-Champs;303;9;312
11;Île-de-France;78;1;07;567;Saint-Martin-la-Garenne;928;11;939
11;Île-de-France;78;2;14;569;Sainte-Mesme;921;19;940
11;Île-de-France;78;3;19;571;Saint-Nom-la-Bretèche;4920;210;5130
11;Île-de-France;78;2;09;575;Saint-Rémy-lès-Chevreuse;7806;159;7965
11;Île-de-France;78;2;01;576;Saint-Rémy-l'Honoré;1621;29;1650
11;Île-de-France;78;3;17;586;Sartrouville;52774;449;53223
11;Île-de-France;78;2;01;588;Saulx-Marchais;957;27;984
11;Île-de-France;78;2;09;590;Senlisse;499;11;510
11;Île-de-France;78;1;02;591;Septeuil;2349;24;2373
11;Île-de-France;78;1;02;597;Soindres;685;8;693
11;Île-de-France;78;2;14;601;Sonchamp;1600;62;1662
11;Île-de-France;78;1;02;605;Tacoignières;1042;17;1059
11;Île-de-France;78;1;02;606;Le Tartre-Gaudran;36;1;37
11;Île-de-France;78;1;02;608;Le Tertre-Saint-Denis;123;1;124
11;Île-de-France;78;1;11;609;Tessancourt-sur-Aubette;1051;6;1057
11;Île-de-France;78;2;12;615;Thiverval-Grignon;1189;22;1211
11;Île-de-France;78;2;01;616;Thoiry;1424;28;1452
11;Île-de-France;78;1;02;618;Tilly;516;14;530
11;Île-de-France;78;4;09;620;Toussus-le-Noble;1166;38;1204
11;Île-de-France;78;4;18;621;Trappes;32645;114;32759
11;Île-de-France;78;2;01;623;Le Tremblay-sur-Mauldre;951;150;1101
11;Île-de-France;78;3;19;624;Triel-sur-Seine;12250;213;12463
11;Île-de-France;78;1;11;638;Vaux-sur-Seine;5010;67;5077
11;Île-de-France;78;4;21;640;Vélizy-Villacoublay;23092;184;23276
11;Île-de-France;78;3;19;642;Verneuil-sur-Seine;15980;372;16352
11;Île-de-France;78;3;19;643;Vernouillet;10104;187;10291
11;Île-de-France;78;2;18;644;La Verrière;6386;79;6465
11;Île-de-France;78;4;99;646;Versailles;84808;2038;86846
11;Île-de-France;78;1;02;647;Vert;835;12;847
11;Île-de-France;78;3;03;650;Le Vésinet;15943;553;16496
11;Île-de-France;78;2;01;653;Vicq;377;9;386
11;Île-de-France;78;2;14;655;Vieille-Église-en-Yvelines;635;26;661
11;Île-de-France;78;1;02;668;La Villeneuve-en-Chevrie;656;10;666
11;Île-de-France;78;3;19;672;Villennes-sur-Seine;5292;167;5459
11;Île-de-France;78;4;15;674;Villepreux;11003;205;11208
11;Île-de-France;78;1;02;677;Villette;509;17;526
11;Île-de-France;78;2;01;681;Villiers-le-Mahieu;828;17;845
11;Île-de-France;78;2;01;683;Villiers-Saint-Frédéric;2906;161;3067
11;Île-de-France;78;4;21;686;Viroflay;16752;348;17100
11;Île-de-France;78;2;09;688;Voisins-le-Bretonneux;10835;374;11209
75;Nouvelle-Aquitaine;79;1;04;001;L'Absie;1052;15;1067
75;Nouvelle-Aquitaine;79;3;13;002;Adilly;309;5;314
75;Nouvelle-Aquitaine;79;2;14;003;Aiffres;5396;170;5566
75;Nouvelle-Aquitaine;79;3;17;005;Airvault;3270;47;3317
75;Nouvelle-Aquitaine;79;3;06;007;Allonne;666;19;685
75;Nouvelle-Aquitaine;79;3;13;008;Amailloux;822;7;829
75;Nouvelle-Aquitaine;79;2;05;009;Amuré;432;9;441
75;Nouvelle-Aquitaine;79;2;05;010;Arçais;612;6;618
75;Nouvelle-Aquitaine;79;3;01;012;Ardin;1244;32;1276
75;Nouvelle-Aquitaine;79;1;07;013;Argentonnay;3183;89;3272
75;Nouvelle-Aquitaine;79;1;17;014;Loretz-d'Argenton;2620;36;2656
75;Nouvelle-Aquitaine;79;2;09;015;Asnières-en-Poitou;196;5;201
75;Nouvelle-Aquitaine;79;3;17;016;Assais-les-Jumeaux;769;12;781
75;Nouvelle-Aquitaine;79;2;08;018;Aubigné;184;5;189
75;Nouvelle-Aquitaine;79;3;06;019;Aubigny;164;1;165
75;Nouvelle-Aquitaine;79;2;15;020;Augé;890;21;911
75;Nouvelle-Aquitaine;79;3;17;022;Availles-Thouarsais;193;1;194
75;Nouvelle-Aquitaine;79;2;03;023;Avon;63;1;64
75;Nouvelle-Aquitaine;79;2;15;024;Azay-le-Brûlé;1982;95;2077
75;Nouvelle-Aquitaine;79;3;06;025;Azay-sur-Thouet;1125;29;1154
75;Nouvelle-Aquitaine;79;3;06;029;Beaulieu-sous-Parthenay;664;14;678
75;Nouvelle-Aquitaine;79;2;03;030;Beaussais-Vitré;973;55;1028
75;Nouvelle-Aquitaine;79;2;09;031;Beauvoir-sur-Niort;1768;37;1805
75;Nouvelle-Aquitaine;79;3;01;032;Béceleuf;774;14;788
75;Nouvelle-Aquitaine;79;2;05;034;Bessines;1721;65;1786
75;Nouvelle-Aquitaine;79;1;02;038;Boismé;1192;28;1220
75;Nouvelle-Aquitaine;79;3;06;040;La Boissière-en-Gâtine;236;2;238
75;Nouvelle-Aquitaine;79;2;03;042;Bougon;176;6;182
75;Nouvelle-Aquitaine;79;2;09;046;Le Bourdet;567;6;573
75;Nouvelle-Aquitaine;79;3;17;047;Boussais;453;10;463
75;Nouvelle-Aquitaine;79;2;15;048;La Crèche;5820;133;5953
75;Nouvelle-Aquitaine;79;1;02;049;Bressuire;19850;997;20847
75;Nouvelle-Aquitaine;79;1;04;050;Bretignolles;589;16;605
75;Nouvelle-Aquitaine;79;2;09;055;Brieuil-sur-Chizé;123;3;126
75;Nouvelle-Aquitaine;79;1;17;056;Brion-près-Thouet;740;11;751
75;Nouvelle-Aquitaine;79;2;09;057;Brioux-sur-Boutonne;1445;51;1496
75;Nouvelle-Aquitaine;79;2;14;058;Brûlain;767;17;784
75;Nouvelle-Aquitaine;79;3;01;059;Le Busseau;733;8;741
75;Nouvelle-Aquitaine;79;2;08;060;Caunay;178;3;181
75;Nouvelle-Aquitaine;79;2;03;061;Celles-sur-Belle;3907;57;3964
75;Nouvelle-Aquitaine;79;1;04;062;Cerizay;4764;73;4837
75;Nouvelle-Aquitaine;79;1;17;063;Val en Vignes;2044;110;2154
75;Nouvelle-Aquitaine;79;2;08;064;Fontivillié;848;24;872
75;Nouvelle-Aquitaine;79;3;01;066;Champdeniers;1734;39;1773
75;Nouvelle-Aquitaine;79;1;04;069;Chanteloup;1012;23;1035
75;Nouvelle-Aquitaine;79;3;01;070;La Chapelle-Bâton;402;10;412
75;Nouvelle-Aquitaine;79;3;13;071;La Chapelle-Bertrand;469;14;483
75;Nouvelle-Aquitaine;79;2;08;074;La Chapelle-Pouilloux;179;5;184
75;Nouvelle-Aquitaine;79;1;04;076;La Chapelle-Saint-Laurent;2034;26;2060
75;Nouvelle-Aquitaine;79;3;01;077;Beugnon-Thireuil;731;10;741
75;Nouvelle-Aquitaine;79;2;09;078;Plaine-d'Argenson;965;15;980
75;Nouvelle-Aquitaine;79;1;07;079;Mauléon;8578;226;8804
75;Nouvelle-Aquitaine;79;3;13;080;Châtillon-sur-Thouet;2678;54;2732
75;Nouvelle-Aquitaine;79;2;14;081;Chauray;7083;206;7289
75;Nouvelle-Aquitaine;79;2;08;083;Chef-Boutonne;2457;113;2570
75;Nouvelle-Aquitaine;79;2;03;084;Chenay;451;3;454
75;Nouvelle-Aquitaine;79;2;09;085;Chérigné;135;5;140
75;Nouvelle-Aquitaine;79;2;01;086;Cherveux;1960;42;2002
75;Nouvelle-Aquitaine;79;2;03;087;Chey;559;9;568
75;Nouvelle-Aquitaine;79;1;02;088;Chiché;1695;44;1739
75;Nouvelle-Aquitaine;79;3;17;089;Le Chillou;160;1;161
75;Nouvelle-Aquitaine;79;2;09;090;Chizé;846;22;868
75;Nouvelle-Aquitaine;79;1;04;091;Cirières;947;24;971
75;Nouvelle-Aquitaine;79;3;06;092;Clavé;361;4;365
75;Nouvelle-Aquitaine;79;1;04;094;Clessé;952;9;961
75;Nouvelle-Aquitaine;79;2;08;095;Clussais-la-Pommeraie;586;12;598
75;Nouvelle-Aquitaine;79;1;04;096;Combrand;1144;34;1178
75;Nouvelle-Aquitaine;79;2;05;100;Coulon;2260;55;2315
75;Nouvelle-Aquitaine;79;3;01;101;Coulonges-sur-l'Autize;2355;49;2404
75;Nouvelle-Aquitaine;79;1;17;102;Coulonges-Thouarsais;433;3;436
75;Nouvelle-Aquitaine;79;1;04;103;Courlay;2421;49;2470
75;Nouvelle-Aquitaine;79;3;01;104;Cours;560;13;573
75;Nouvelle-Aquitaine;79;3;06;105;Les Châteliers;473;9;482
75;Nouvelle-Aquitaine;79;2;08;106;Couture-d'Argenson;401;2;403
75;Nouvelle-Aquitaine;79;3;06;108;Doux;230;1;231
75;Nouvelle-Aquitaine;79;2;14;109;Échiré;3441;99;3540
75;Nouvelle-Aquitaine;79;2;09;111;Ensigné;289;4;293
75;Nouvelle-Aquitaine;79;2;05;112;Épannes;860;24;884
75;Nouvelle-Aquitaine;79;2;15;114;Exireuil;1578;31;1609
75;Nouvelle-Aquitaine;79;2;03;115;Exoudun;567;10;577
75;Nouvelle-Aquitaine;79;1;02;116;Faye-l'Abbesse;1114;17;1131
75;Nouvelle-Aquitaine;79;3;01;117;Faye-sur-Ardin;648;8;656
75;Nouvelle-Aquitaine;79;3;13;118;Fénery;281;6;287
75;Nouvelle-Aquitaine;79;3;01;119;Fenioux;628;11;639
75;Nouvelle-Aquitaine;79;3;06;120;La Ferrière-en-Parthenay;762;13;775
75;Nouvelle-Aquitaine;79;3;06;121;Fomperron;405;10;415
75;Nouvelle-Aquitaine;79;2;08;122;Fontenille-Saint-Martin-d'Entraigues;533;5;538
75;Nouvelle-Aquitaine;79;1;04;123;La Forêt-sur-Sèvre;2311;49;2360
75;Nouvelle-Aquitaine;79;3;06;124;Les Forges;112;5;117
75;Nouvelle-Aquitaine;79;2;05;125;Fors;1811;55;1866
75;Nouvelle-Aquitaine;79;2;09;126;Les Fosses;439;10;449
75;Nouvelle-Aquitaine;79;2;09;127;La Foye-Monjault;850;7;857
75;Nouvelle-Aquitaine;79;2;15;128;François;953;26;979
75;Nouvelle-Aquitaine;79;2;03;129;Fressines;1719;31;1750
75;Nouvelle-Aquitaine;79;2;05;130;Frontenay-Rohan-Rohan;2899;99;2998
75;Nouvelle-Aquitaine;79;1;02;131;Geay;314;7;321
75;Nouvelle-Aquitaine;79;1;07;132;Genneton;317;6;323
75;Nouvelle-Aquitaine;79;2;01;133;Germond-Rouvre;1182;23;1205
75;Nouvelle-Aquitaine;79;1;17;134;Glénay;571;14;585
75;Nouvelle-Aquitaine;79;3;06;135;Gourgé;960;23;983
75;Nouvelle-Aquitaine;79;2;08;136;Alloinay;894;17;911
75;Nouvelle-Aquitaine;79;2;05;137;Granzay-Gript;903;18;921
75;Nouvelle-Aquitaine;79;3;06;139;Les Groseillers;55;2;57
75;Nouvelle-Aquitaine;79;2;08;140;Valdelaume;828;10;838
75;Nouvelle-Aquitaine;79;3;17;141;Irais;208;4;212
75;Nouvelle-Aquitaine;79;2;09;142;Juillé;100;2;102
75;Nouvelle-Aquitaine;79;2;14;144;Juscorps;372;7;379
75;Nouvelle-Aquitaine;79;3;13;145;Lageon;368;5;373
75;Nouvelle-Aquitaine;79;1;04;147;Largeasse;732;9;741
75;Nouvelle-Aquitaine;79;2;03;148;Lezay;1982;27;2009
75;Nouvelle-Aquitaine;79;3;06;149;Lhoumois;139;2;141
75;Nouvelle-Aquitaine;79;2;08;150;Limalonges;819;16;835
75;Nouvelle-Aquitaine;79;2;08;152;Lorigné;302;6;308
75;Nouvelle-Aquitaine;79;2;08;153;Loubigné;158;3;161
75;Nouvelle-Aquitaine;79;2;08;154;Loubillé;400;6;406
75;Nouvelle-Aquitaine;79;3;17;156;Louin;687;25;712
75;Nouvelle-Aquitaine;79;1;16;157;Louzy;1320;41;1361
75;Nouvelle-Aquitaine;79;2;09;158;Luché-sur-Brioux;132;3;135
75;Nouvelle-Aquitaine;79;1;17;159;Luché-Thouarsais;526;4;530
75;Nouvelle-Aquitaine;79;2;09;160;Lusseray;164;3;167
75;Nouvelle-Aquitaine;79;1;17;161;Luzay;644;12;656
75;Nouvelle-Aquitaine;79;2;05;162;Magné;2693;65;2758
75;Nouvelle-Aquitaine;79;2;08;163;Mairé-Levescault;519;10;529
75;Nouvelle-Aquitaine;79;2;08;164;Maisonnay;262;4;266
75;Nouvelle-Aquitaine;79;3;17;165;Maisontiers;141;5;146
75;Nouvelle-Aquitaine;79;2;09;166;Marigny;877;14;891
75;Nouvelle-Aquitaine;79;1;17;167;Marnes;236;11;247
75;Nouvelle-Aquitaine;79;2;09;170;Mauzé-sur-le-Mignon;2891;55;2946
75;Nouvelle-Aquitaine;79;3;06;172;Mazières-en-Gâtine;1026;23;1049
75;Nouvelle-Aquitaine;79;2;08;174;Melle;6173;329;6502
75;Nouvelle-Aquitaine;79;2;08;175;Melleran;488;12;500
75;Nouvelle-Aquitaine;79;3;06;176;Ménigoute;861;23;884
75;Nouvelle-Aquitaine;79;2;03;177;Messé;193;4;197
75;Nouvelle-Aquitaine;79;1;04;179;Moncoutant-sur-Sèvre;5057;184;5241
75;Nouvelle-Aquitaine;79;2;08;180;Montalembert;309;3;312
75;Nouvelle-Aquitaine;79;1;04;183;Montravers;373;10;383
75;Nouvelle-Aquitaine;79;2;03;184;La Mothe-Saint-Héray;1674;24;1698
75;Nouvelle-Aquitaine;79;2;03;185;Aigondigné;4677;144;4821
75;Nouvelle-Aquitaine;79;2;15;189;Nanteuil;1704;31;1735
75;Nouvelle-Aquitaine;79;1;04;190;Neuvy-Bouin;492;3;495
75;Nouvelle-Aquitaine;79;2;99;191;Niort;59193;1834;61027
75;Nouvelle-Aquitaine;79;1;07;195;Nueil-les-Aubiers;5536;119;5655
75;Nouvelle-Aquitaine;79;1;17;196;Plaine-et-Vallées;2384;53;2437
75;Nouvelle-Aquitaine;79;3;06;197;Oroux;91;2;93
75;Nouvelle-Aquitaine;79;2;09;198;Paizay-le-Chapt;260;3;263
75;Nouvelle-Aquitaine;79;3;01;200;Pamplie;265;3;268
75;Nouvelle-Aquitaine;79;2;03;201;Pamproux;1704;20;1724
75;Nouvelle-Aquitaine;79;3;13;202;Parthenay;10089;400;10489
75;Nouvelle-Aquitaine;79;1;17;203;Pas-de-Jeu;367;8;375
75;Nouvelle-Aquitaine;79;2;09;204;Périgné;1004;38;1042
75;Nouvelle-Aquitaine;79;2;08;205;Pers;74;3;77
75;Nouvelle-Aquitaine;79;1;07;207;La Petite-Boissière;630;17;647
75;Nouvelle-Aquitaine;79;3;06;208;La Peyratte;1137;38;1175
75;Nouvelle-Aquitaine;79;1;17;209;Pierrefitte;330;8;338
75;Nouvelle-Aquitaine;79;1;04;210;Le Pin;1047;23;1070
75;Nouvelle-Aquitaine;79;2;08;212;Pliboux;206;3;209
75;Nouvelle-Aquitaine;79;3;13;213;Pompaire;1992;54;2046
75;Nouvelle-Aquitaine;79;3;06;215;Pougne-Hérisson;368;7;375
75;Nouvelle-Aquitaine;79;2;14;216;Prahecq;2217;40;2257
75;Nouvelle-Aquitaine;79;2;03;217;Prailles-La Couarde;950;22;972
75;Nouvelle-Aquitaine;79;3;06;218;Pressigny;193;6;199
75;Nouvelle-Aquitaine;79;2;09;220;Prin-Deyrançon;600;15;615
75;Nouvelle-Aquitaine;79;3;01;223;Puihardy;62;1;63
75;Nouvelle-Aquitaine;79;3;06;225;Reffannes;376;6;382
75;Nouvelle-Aquitaine;79;3;06;226;Le Retail;276;5;281
75;Nouvelle-Aquitaine;79;2;09;229;La Rochénard;553;14;567
75;Nouvelle-Aquitaine;79;2;03;230;Rom;867;11;878
75;Nouvelle-Aquitaine;79;2;15;231;Romans;708;15;723
75;Nouvelle-Aquitaine;79;1;07;235;Saint-Amand-sur-Sèvre;1408;42;1450
75;Nouvelle-Aquitaine;79;1;04;236;Saint-André-sur-Sèvre;652;12;664
75;Nouvelle-Aquitaine;79;1;07;238;Saint-Aubin-du-Plain;540;21;561
75;Nouvelle-Aquitaine;79;3;06;239;Saint-Aubin-le-Cloud;1714;127;1841
75;Nouvelle-Aquitaine;79;3;01;241;Saint-Christophe-sur-Roc;569;11;580
75;Nouvelle-Aquitaine;79;1;07;242;Voulmentin;1119;20;1139
75;Nouvelle-Aquitaine;79;2;03;243;Saint-Coutant;279;0;279
75;Nouvelle-Aquitaine;79;1;17;244;Saint-Cyr-la-Lande;366;4;370
75;Nouvelle-Aquitaine;79;2;15;246;Sainte-Eanne;605;13;618
75;Nouvelle-Aquitaine;79;2;14;249;Saint-Gelais;2136;63;2199
75;Nouvelle-Aquitaine;79;1;17;250;Sainte-Gemme;400;4;404
75;Nouvelle-Aquitaine;79;2;08;251;Marcillé;745;29;774
75;Nouvelle-Aquitaine;79;1;17;252;Saint-Généroux;348;13;361
75;Nouvelle-Aquitaine;79;3;06;253;Saint-Georges-de-Noisné;694;14;708
75;Nouvelle-Aquitaine;79;2;09;254;Saint-Georges-de-Rex;451;13;464
75;Nouvelle-Aquitaine;79;3;13;255;Saint-Germain-de-Longue-Chaume;401;3;404
75;Nouvelle-Aquitaine;79;3;06;256;Saint-Germier;233;6;239
75;Nouvelle-Aquitaine;79;2;09;257;Saint-Hilaire-la-Palud;1524;23;1547
75;Nouvelle-Aquitaine;79;1;16;258;Saint-Jacques-de-Thouars;432;13;445
75;Nouvelle-Aquitaine;79;1;16;259;Saint-Jean-de-Thouars;1372;36;1408
75;Nouvelle-Aquitaine;79;3;01;263;Saint-Laurs;596;11;607
75;Nouvelle-Aquitaine;79;1;17;265;Saint-Léger-de-Montbrun;1261;24;1285
75;Nouvelle-Aquitaine;79;3;06;267;Saint-Lin;326;4;330
75;Nouvelle-Aquitaine;79;3;17;268;Saint-Loup-Lamairé;995;40;1035
75;Nouvelle-Aquitaine;79;3;01;269;Saint-Maixent-de-Beugné;414;5;419
75;Nouvelle-Aquitaine;79;2;15;270;Saint-Maixent-l'École;7242;140;7382
75;Nouvelle-Aquitaine;79;3;06;271;Saint-Marc-la-Lande;370;2;372
75;Nouvelle-Aquitaine;79;2;14;273;Saint-Martin-de-Bernegoue;795;20;815
75;Nouvelle-Aquitaine;79;1;17;274;Saint-Martin-de-Mâcon;292;6;298
75;Nouvelle-Aquitaine;79;2;15;276;Saint-Martin-de-Saint-Maixent;1083;31;1114
75;Nouvelle-Aquitaine;79;1;17;277;Saint-Martin-de-Sanzay;1090;18;1108
75;Nouvelle-Aquitaine;79;3;06;278;Saint-Martin-du-Fouilloux;238;6;244
75;Nouvelle-Aquitaine;79;1;07;280;Saint Maurice Étusson;883;14;897
75;Nouvelle-Aquitaine;79;2;01;281;Saint-Maxire;1306;36;1342
75;Nouvelle-Aquitaine;79;2;15;283;Sainte-Néomaye;1327;31;1358
75;Nouvelle-Aquitaine;79;3;01;284;Sainte-Ouenne;782;12;794
75;Nouvelle-Aquitaine;79;3;06;285;Saint-Pardoux-Soutiers;1862;42;1904
75;Nouvelle-Aquitaine;79;1;04;286;Saint-Paul-en-Gâtine;441;7;448
75;Nouvelle-Aquitaine;79;1;07;289;Saint-Pierre-des-Échaubrognes;1444;26;1470
75;Nouvelle-Aquitaine;79;3;01;290;Saint-Pompain;944;15;959
75;Nouvelle-Aquitaine;79;2;01;293;Saint-Rémy;1128;25;1153
75;Nouvelle-Aquitaine;79;2;14;294;Saint-Romans-des-Champs;167;5;172
75;Nouvelle-Aquitaine;79;2;08;295;Saint-Romans-lès-Melle;711;18;729
75;Nouvelle-Aquitaine;79;2;03;297;Sainte-Soline;353;7;360
75;Nouvelle-Aquitaine;79;2;05;298;Saint-Symphorien;1950;56;2006
75;Nouvelle-Aquitaine;79;1;17;299;Saint-Varent;2401;49;2450
75;Nouvelle-Aquitaine;79;1;16;300;Sainte-Verge;1377;30;1407
75;Nouvelle-Aquitaine;79;2;08;301;Saint-Vincent-la-Châtre;627;20;647
75;Nouvelle-Aquitaine;79;2;15;302;Saivres;1391;34;1425
75;Nouvelle-Aquitaine;79;2;03;303;Salles;328;12;340
75;Nouvelle-Aquitaine;79;2;05;304;Sansais;760;51;811
75;Nouvelle-Aquitaine;79;3;06;306;Saurais;188;2;190
75;Nouvelle-Aquitaine;79;2;08;307;Sauzé-Vaussais;1514;28;1542
75;Nouvelle-Aquitaine;79;2;01;308;Sciecq;637;10;647
75;Nouvelle-Aquitaine;79;3;01;309;Scillé;350;7;357
75;Nouvelle-Aquitaine;79;2;09;310;Secondigné-sur-Belle;501;15;516
75;Nouvelle-Aquitaine;79;3;06;311;Secondigny;1802;85;1887
75;Nouvelle-Aquitaine;79;2;09;312;Séligné;116;3;119
75;Nouvelle-Aquitaine;79;2;03;313;Sepvret;625;15;640
75;Nouvelle-Aquitaine;79;2;03;316;Soudan;431;14;445
75;Nouvelle-Aquitaine;79;2;15;319;Souvigné;873;28;901
75;Nouvelle-Aquitaine;79;3;01;320;Surin;655;12;667
75;Nouvelle-Aquitaine;79;3;13;322;Le Tallud;2000;56;2056
75;Nouvelle-Aquitaine;79;3;06;326;Thénezay;1409;27;1436
75;Nouvelle-Aquitaine;79;1;16;329;Thouars;13886;344;14230
75;Nouvelle-Aquitaine;79;1;17;331;Tourtenay;124;6;130
75;Nouvelle-Aquitaine;79;1;04;332;Trayes;121;4;125
75;Nouvelle-Aquitaine;79;2;09;334;Val-du-Mignon;1076;22;1098
75;Nouvelle-Aquitaine;79;2;05;335;Vallans;793;21;814
75;Nouvelle-Aquitaine;79;2;03;336;Vançais;226;2;228
75;Nouvelle-Aquitaine;79;2;05;337;Le Vanneau-Irleau;868;26;894
75;Nouvelle-Aquitaine;79;2;03;338;Vanzay;252;0;252
75;Nouvelle-Aquitaine;79;3;06;339;Vasles;1671;29;1700
75;Nouvelle-Aquitaine;79;3;06;340;Vausseroux;324;6;330
75;Nouvelle-Aquitaine;79;3;06;341;Vautebis;113;1;114
75;Nouvelle-Aquitaine;79;3;06;342;Vernoux-en-Gâtine;573;13;586
75;Nouvelle-Aquitaine;79;2;09;343;Vernoux-sur-Boutonne;211;2;213
75;Nouvelle-Aquitaine;79;3;06;345;Verruyes;896;32;928
75;Nouvelle-Aquitaine;79;2;09;346;Le Vert;129;3;132
75;Nouvelle-Aquitaine;79;3;13;347;Viennay;1105;21;1126
75;Nouvelle-Aquitaine;79;2;09;348;Villefollet;222;5;227
75;Nouvelle-Aquitaine;79;2;08;349;Villemain;148;2;150
75;Nouvelle-Aquitaine;79;2;09;350;Villiers-en-Bois;121;3;124
75;Nouvelle-Aquitaine;79;2;01;351;Villiers-en-Plaine;1793;31;1824
75;Nouvelle-Aquitaine;79;2;09;352;Villiers-sur-Chizé;157;6;163
75;Nouvelle-Aquitaine;79;3;06;354;Vouhé;362;10;372
75;Nouvelle-Aquitaine;79;2;14;355;Vouillé;3345;101;3446
75;Nouvelle-Aquitaine;79;3;01;357;Xaintray;232;3;235
32;Hauts-de-France;80;1;98;001;Abbeville;22980;410;23390
32;Hauts-de-France;80;4;18;002;Ablaincourt-Pressoir;266;5;271
32;Hauts-de-France;80;4;05;003;Acheux-en-Amiénois;581;11;592
32;Hauts-de-France;80;1;02;004;Acheux-en-Vimeu;511;4;515
32;Hauts-de-France;80;2;14;005;Agenville;84;2;86
32;Hauts-de-France;80;1;01;006;Agenvillers;253;4;257
32;Hauts-de-France;80;1;17;008;Aigneville;896;18;914
32;Hauts-de-France;80;1;23;009;Ailly-le-Haut-Clocher;997;24;1021
32;Hauts-de-France;80;3;03;010;Ailly-sur-Noye;2833;31;2864
32;Hauts-de-France;80;2;04;011;Ailly-sur-Somme;2952;26;2978
32;Hauts-de-France;80;2;04;013;Airaines;2383;32;2415
32;Hauts-de-France;80;4;20;014;Aizecourt-le-Bas;56;0;56
32;Hauts-de-France;80;4;20;015;Aizecourt-le-Haut;64;3;67
32;Hauts-de-France;80;4;05;016;Albert;9779;166;9945
32;Hauts-de-France;80;4;20;017;Allaines;442;6;448
32;Hauts-de-France;80;1;16;018;Allenay;248;5;253
32;Hauts-de-France;80;1;17;019;Allery;787;14;801
32;Hauts-de-France;80;2;07;020;Allonville;762;18;780
32;Hauts-de-France;80;2;99;021;Amiens;134706;2674;137380
32;Hauts-de-France;80;2;21;022;Andainville;264;3;267
32;Hauts-de-France;80;3;22;023;Andechy;279;4;283
32;Hauts-de-France;80;2;04;024;Argœuves;544;6;550
32;Hauts-de-France;80;1;23;025;Argoules;327;3;330
32;Hauts-de-France;80;2;21;026;Arguel;28;0;28
32;Hauts-de-France;80;3;22;027;Armancourt;31;0;31
32;Hauts-de-France;80;4;05;028;Arquèves;157;1;158
32;Hauts-de-France;80;1;02;029;Arrest;842;25;867
32;Hauts-de-France;80;1;23;030;Arry;216;8;224
32;Hauts-de-France;80;3;19;031;Arvillers;775;9;784
32;Hauts-de-France;80;3;22;032;Assainvillers;104;0;104
32;Hauts-de-France;80;4;18;033;Assevillers;303;3;306
32;Hauts-de-France;80;4;18;034;Athies;588;6;594
32;Hauts-de-France;80;3;19;035;Aubercourt;78;1;79
32;Hauts-de-France;80;2;08;036;Aubigny;538;4;542
32;Hauts-de-France;80;3;03;037;Aubvillers;153;1;154
32;Hauts-de-France;80;4;05;038;Auchonvillers;144;3;147
32;Hauts-de-France;80;1;16;039;Ault;1397;17;1414
32;Hauts-de-France;80;2;21;040;Aumâtre;175;4;179
32;Hauts-de-France;80;2;21;041;Aumont;147;4;151
32;Hauts-de-France;80;2;14;042;Autheux;122;2;124
32;Hauts-de-France;80;4;05;043;Authie;264;11;275
32;Hauts-de-France;80;2;14;044;Authieule;408;6;414
32;Hauts-de-France;80;4;05;045;Authuille;161;2;163
32;Hauts-de-France;80;2;04;046;Avelesges;55;0;55
32;Hauts-de-France;80;4;05;047;Aveluy;521;5;526
32;Hauts-de-France;80;2;21;048;Avesnes-Chaussoy;63;3;66
32;Hauts-de-France;80;3;22;049;Ayencourt;167;10;177
32;Hauts-de-France;80;2;03;050;Bacouel-sur-Selle;485;10;495
32;Hauts-de-France;80;1;17;051;Bailleul;257;3;260
32;Hauts-de-France;80;2;13;052;Baizieux;212;5;217
32;Hauts-de-France;80;3;22;053;Balâtre;70;1;71
32;Hauts-de-France;80;4;20;054;Barleux;236;5;241
32;Hauts-de-France;80;2;14;055;Barly;168;1;169
32;Hauts-de-France;80;2;13;056;Bavelincourt;96;1;97
32;Hauts-de-France;80;4;05;057;Bayencourt;77;3;80
32;Hauts-de-France;80;4;19;058;Bayonvillers;334;4;338
32;Hauts-de-France;80;4;05;059;Bazentin;77;1;78
32;Hauts-de-France;80;2;14;060;Béalcourt;105;0;105
32;Hauts-de-France;80;2;21;061;Beaucamps-le-Jeune;187;3;190
32;Hauts-de-France;80;2;21;062;Beaucamps-le-Vieux;1422;17;1439
32;Hauts-de-France;80;1;17;063;Beauchamps;988;22;1010
32;Hauts-de-France;80;3;19;064;Beaucourt-en-Santerre;170;3;173
32;Hauts-de-France;80;4;05;065;Beaucourt-sur-l'Ancre;89;3;92
32;Hauts-de-France;80;2;13;066;Beaucourt-sur-l'Hallue;281;6;287
32;Hauts-de-France;80;4;19;067;Beaufort-en-Santerre;194;2;196
32;Hauts-de-France;80;2;14;068;Beaumetz;220;1;221
32;Hauts-de-France;80;4;05;069;Beaumont-Hamel;208;0;208
32;Hauts-de-France;80;2;14;070;Beauquesne;1325;52;1377
32;Hauts-de-France;80;2;14;071;Beauval;2036;23;2059
32;Hauts-de-France;80;4;05;073;Bécordel-Bécourt;156;2;158
32;Hauts-de-France;80;3;22;074;Becquigny;130;1;131
32;Hauts-de-France;80;1;02;076;Béhen;516;4;520
32;Hauts-de-France;80;2;13;077;Béhencourt;324;3;327
32;Hauts-de-France;80;1;01;078;Bellancourt;511;9;520
32;Hauts-de-France;80;2;03;079;Belleuse;326;4;330
32;Hauts-de-France;80;4;18;080;Belloy-en-Santerre;148;5;153
32;Hauts-de-France;80;2;21;081;Belloy-Saint-Léonard;90;2;92
32;Hauts-de-France;80;2;04;082;Belloy-sur-Somme;740;8;748
32;Hauts-de-France;80;2;21;083;Bergicourt;140;4;144
32;Hauts-de-France;80;2;21;084;Bermesnil;213;1;214
32;Hauts-de-France;80;2;14;085;Bernâtre;37;2;39
32;Hauts-de-France;80;2;14;086;Bernaville;1058;17;1075
32;Hauts-de-France;80;1;23;087;Bernay-en-Ponthieu;238;6;244
32;Hauts-de-France;80;4;20;088;Bernes;353;2;355
32;Hauts-de-France;80;2;14;089;Berneuil;264;1;265
32;Hauts-de-France;80;4;18;090;Berny-en-Santerre;152;3;155
32;Hauts-de-France;80;2;07;092;Bertangles;686;6;692
32;Hauts-de-France;80;2;15;093;Berteaucourt-les-Dames;1103;12;1115
32;Hauts-de-France;80;3;19;094;Berteaucourt-lès-Thennes;439;11;450
32;Hauts-de-France;80;4;05;095;Bertrancourt;212;3;215
32;Hauts-de-France;80;1;16;096;Béthencourt-sur-Mer;942;9;951
32;Hauts-de-France;80;4;18;097;Béthencourt-sur-Somme;129;3;132
32;Hauts-de-France;80;2;21;098;Bettembos;106;3;109
32;Hauts-de-France;80;1;17;099;Bettencourt-Rivière;226;4;230
32;Hauts-de-France;80;2;15;100;Bettencourt-Saint-Ouen;619;4;623
32;Hauts-de-France;80;3;22;101;Beuvraignes;861;5;866
32;Hauts-de-France;80;4;20;102;Biaches;383;7;390
32;Hauts-de-France;80;3;22;103;Biarre;66;0;66
32;Hauts-de-France;80;1;17;104;Biencourt;135;2;137
32;Hauts-de-France;80;4;18;105;Billancourt;168;2;170
32;Hauts-de-France;80;2;21;106;Blangy-sous-Poix;175;3;178
32;Hauts-de-France;80;2;09;107;Blangy-Tronville;622;11;633
32;Hauts-de-France;80;2;14;108;Boisbergues;73;1;74
32;Hauts-de-France;80;1;23;109;Le Boisle;343;3;346
32;Hauts-de-France;80;1;02;110;Boismont;474;16;490
32;Hauts-de-France;80;2;13;112;Bonnay;240;1;241
32;Hauts-de-France;80;2;14;113;Bonneville;337;7;344
32;Hauts-de-France;80;2;03;114;Bosquel;336;6;342
32;Hauts-de-France;80;4;20;115;Bouchavesnes-Bergen;282;4;286
32;Hauts-de-France;80;4;19;116;Bouchoir;273;3;276
32;Hauts-de-France;80;2;15;117;Bouchon;158;5;163
32;Hauts-de-France;80;1;23;118;Boufflers;116;1;117
32;Hauts-de-France;80;2;04;119;Bougainville;422;8;430
32;Hauts-de-France;80;1;17;120;Bouillancourt-en-Séry;536;11;547
32;Hauts-de-France;80;3;22;121;Bouillancourt-la-Bataille;156;0;156
32;Hauts-de-France;80;2;14;122;Bouquemaison;488;15;503
32;Hauts-de-France;80;2;04;123;Bourdon;372;8;380
32;Hauts-de-France;80;1;16;124;Bourseville;704;14;718
32;Hauts-de-France;80;3;22;125;Boussicourt;87;0;87
32;Hauts-de-France;80;1;17;126;Bouttencourt;922;17;939
32;Hauts-de-France;80;1;17;127;Bouvaincourt-sur-Bresle;832;11;843
32;Hauts-de-France;80;4;20;128;Bouvincourt-en-Vermandois;147;3;150
32;Hauts-de-France;80;4;05;129;Bouzincourt;541;13;554
32;Hauts-de-France;80;2;04;130;Bovelles;427;6;433
32;Hauts-de-France;80;2;10;131;Boves;3281;56;3337
32;Hauts-de-France;80;3;19;132;Braches;232;3;235
32;Hauts-de-France;80;1;23;133;Brailly-Cornehotte;238;1;239
32;Hauts-de-France;80;2;03;134;Brassy;79;2;81
32;Hauts-de-France;80;1;02;135;Bray-lès-Mareuil;244;4;248
32;Hauts-de-France;80;4;05;136;Bray-sur-Somme;1275;7;1282
32;Hauts-de-France;80;2;04;137;Breilly;746;4;750
32;Hauts-de-France;80;2;13;138;Bresle;125;1;126
32;Hauts-de-France;80;4;18;139;Breuil;43;0;43
32;Hauts-de-France;80;2;14;140;Brévillers;107;3;110
32;Hauts-de-France;80;4;20;141;Brie;329;1;330
32;Hauts-de-France;80;2;04;142;Briquemesnil-Floxicourt;318;4;322
32;Hauts-de-France;80;2;21;143;Brocourt;101;1;102
32;Hauts-de-France;80;4;18;144;Brouchy;497;9;506
32;Hauts-de-France;80;1;23;145;Brucamps;138;0;138
32;Hauts-de-France;80;1;16;146;Brutelles;205;5;210
32;Hauts-de-France;80;1;23;147;Buigny-l'Abbé;326;7;333
32;Hauts-de-France;80;1;17;148;Buigny-lès-Gamaches;400;5;405
32;Hauts-de-France;80;1;01;149;Buigny-Saint-Maclou;524;11;535
32;Hauts-de-France;80;4;20;150;Buire-Courcelles;222;7;229
32;Hauts-de-France;80;4;05;151;Buire-sur-l'Ancre;308;4;312
32;Hauts-de-France;80;3;22;152;Bus-la-Mésière;148;1;149
32;Hauts-de-France;80;4;05;153;Bus-lès-Artois;131;0;131
32;Hauts-de-France;80;4;20;154;Bussu;213;7;220
32;Hauts-de-France;80;1;23;155;Bussus-Bussuel;293;8;301
32;Hauts-de-France;80;2;08;156;Bussy-lès-Daours;398;3;401
32;Hauts-de-France;80;2;21;157;Bussy-lès-Poix;96;5;101
32;Hauts-de-France;80;4;18;158;Buverchy;51;0;51
32;Hauts-de-France;80;2;09;159;Cachy;280;6;286
32;Hauts-de-France;80;2;10;160;Cagny;1203;21;1224
32;Hauts-de-France;80;1;02;161;Cahon;205;7;212
32;Hauts-de-France;80;4;19;162;Caix;699;11;710
32;Hauts-de-France;80;1;02;163;Cambron;761;11;772
32;Hauts-de-France;80;2;08;164;Camon;4436;54;4490
32;Hauts-de-France;80;2;04;165;Camps-en-Amiénois;190;1;191
32;Hauts-de-France;80;2;15;166;Canaples;702;7;709
32;Hauts-de-France;80;1;01;167;Canchy;330;11;341
32;Hauts-de-France;80;2;14;168;Candas;1105;9;1114
32;Hauts-de-France;80;2;21;169;Cannessières;66;0;66
32;Hauts-de-France;80;3;22;170;Cantigny;111;1;112
32;Hauts-de-France;80;1;01;171;Caours;599;19;618
32;Hauts-de-France;80;4;05;172;Cappy;546;7;553
32;Hauts-de-France;80;2;07;173;Cardonnette;538;7;545
32;Hauts-de-France;80;3;22;174;Le Cardonnois;79;3;82
32;Hauts-de-France;80;3;22;176;Carrépuis;268;4;272
32;Hauts-de-France;80;4;20;177;Cartigny;715;23;738
32;Hauts-de-France;80;2;21;179;Caulières;219;4;223
32;Hauts-de-France;80;2;04;180;Cavillon;104;1;105
32;Hauts-de-France;80;3;19;181;Cayeux-en-Santerre;123;0;123
32;Hauts-de-France;80;1;16;182;Cayeux-sur-Mer;2445;31;2476
32;Hauts-de-France;80;2;21;183;Cerisy-Buleux;264;5;269
32;Hauts-de-France;80;2;13;184;Cerisy;534;5;539
32;Hauts-de-France;80;3;22;185;Champien;284;10;294
32;Hauts-de-France;80;4;18;186;Chaulnes;2026;22;2048
32;Hauts-de-France;80;2;04;187;La Chaussée-Tirancourt;650;11;661
32;Hauts-de-France;80;3;03;188;Chaussoy-Epagny;590;7;597
32;Hauts-de-France;80;4;19;189;La Chavatte;72;1;73
32;Hauts-de-France;80;1;17;190;Chépy;1231;17;1248
32;Hauts-de-France;80;4;19;191;Chilly;174;5;179
32;Hauts-de-France;80;2;13;192;Chipilly;167;2;169
32;Hauts-de-France;80;3;03;193;Chirmont;136;3;139
32;Hauts-de-France;80;4;18;194;Chuignes;139;1;140
32;Hauts-de-France;80;4;05;195;Chuignolles;150;1;151
32;Hauts-de-France;80;1;17;196;Citerne;243;8;251
32;Hauts-de-France;80;4;18;197;Cizancourt;31;0;31
32;Hauts-de-France;80;2;04;198;Clairy-Saulchoix;378;4;382
32;Hauts-de-France;80;4;20;199;Cléry-sur-Somme;522;11;533
32;Hauts-de-France;80;1;23;200;Cocquerel;223;2;225
32;Hauts-de-France;80;4;05;201;Coigneux;49;2;51
32;Hauts-de-France;80;2;07;202;Coisy;361;3;364
32;Hauts-de-France;80;4;05;203;Colincamps;87;2;89
32;Hauts-de-France;80;4;20;204;Combles;738;12;750
32;Hauts-de-France;80;1;15;205;Condé-Folie;912;10;922
32;Hauts-de-France;80;4;05;206;Contalmaison;117;0;117
32;Hauts-de-France;80;2;13;207;Contay;364;2;366
32;Hauts-de-France;80;2;14;208;Conteville;219;4;223
32;Hauts-de-France;80;2;03;210;Contre;146;7;153
32;Hauts-de-France;80;2;03;211;Conty;1796;49;1845
32;Hauts-de-France;80;2;13;212;Corbie;6292;79;6371
32;Hauts-de-France;80;3;03;213;Cottenchy;571;170;741
32;Hauts-de-France;80;3;03;214;Coullemelle;320;1;321
32;Hauts-de-France;80;1;23;215;Coulonvillers;220;8;228
32;Hauts-de-France;80;4;05;216;Courcelette;155;1;156
32;Hauts-de-France;80;4;05;217;Courcelles-au-Bois;75;0;75
32;Hauts-de-France;80;2;21;218;Courcelles-sous-Moyencourt;144;3;147
32;Hauts-de-France;80;2;03;219;Courcelles-sous-Thoix;68;1;69
32;Hauts-de-France;80;3;22;220;Courtemanche;100;2;102
32;Hauts-de-France;80;1;23;221;Cramont;305;5;310
32;Hauts-de-France;80;1;23;222;Crécy-en-Ponthieu;1370;28;1398
32;Hauts-de-France;80;3;22;223;Crémery;133;0;133
32;Hauts-de-France;80;3;22;224;Cressy-Omencourt;123;1;124
32;Hauts-de-France;80;2;04;225;Creuse;193;4;197
32;Hauts-de-France;80;4;18;226;Croix-Moligneaux;272;5;277
32;Hauts-de-France;80;2;21;227;Croixrault;447;9;456
32;Hauts-de-France;80;1;23;228;Le Crotoy;1989;33;2022
32;Hauts-de-France;80;2;04;229;Crouy-Saint-Pierre;340;2;342
32;Hauts-de-France;80;4;18;230;Curchy;303;8;311
32;Hauts-de-France;80;4;05;231;Curlu;171;2;173
32;Hauts-de-France;80;3;22;232;Damery;229;5;234
32;Hauts-de-France;80;3;22;233;Dancourt-Popincourt;156;1;157
32;Hauts-de-France;80;2;08;234;Daours;776;16;792
32;Hauts-de-France;80;1;17;235;Dargnies;1197;18;1215
32;Hauts-de-France;80;3;22;236;Davenescourt;575;4;579
32;Hauts-de-France;80;3;19;237;Démuin;524;11;535
32;Hauts-de-France;80;4;05;238;Dernancourt;564;9;573
32;Hauts-de-France;80;4;20;239;Devise;53;2;55
32;Hauts-de-France;80;4;20;240;Doingt;1402;44;1446
32;Hauts-de-France;80;2;15;241;Domart-en-Ponthieu;1065;11;1076
32;Hauts-de-France;80;3;19;242;Domart-sur-la-Luce;409;9;418
32;Hauts-de-France;80;2;14;243;Domesmont;43;0;43
32;Hauts-de-France;80;1;23;244;Dominois;174;3;177
32;Hauts-de-France;80;2;14;245;Domléger-Longvillers;302;3;305
32;Hauts-de-France;80;3;03;246;Dommartin;347;5;352
32;Hauts-de-France;80;4;18;247;Dompierre-Becquincourt;715;8;723
32;Hauts-de-France;80;1;23;248;Dompierre-sur-Authie;418;6;424
32;Hauts-de-France;80;1;23;249;Domqueur;312;7;319
32;Hauts-de-France;80;1;01;250;Domvast;351;4;355
32;Hauts-de-France;80;1;17;251;Doudelainville;351;8;359
32;Hauts-de-France;80;4;18;252;Douilly;251;1;252
32;Hauts-de-France;80;2;14;253;Doullens;5890;172;6062
32;Hauts-de-France;80;2;04;256;Dreuil-lès-Amiens;1639;10;1649
32;Hauts-de-France;80;4;20;258;Driencourt;87;3;90
32;Hauts-de-France;80;2;21;259;Dromesnil;87;1;88
32;Hauts-de-France;80;1;01;260;Drucat;924;23;947
32;Hauts-de-France;80;2;11;261;Dury;1464;61;1525
32;Hauts-de-France;80;1;02;262;Eaucourt-sur-Somme;392;14;406
32;Hauts-de-France;80;3;22;263;L'Échelle-Saint-Aurin;50;1;51
32;Hauts-de-France;80;4;05;264;Éclusier-Vaux;84;39;123
32;Hauts-de-France;80;1;17;265;Embreville;569;7;576
32;Hauts-de-France;80;4;05;266;Englebelmer;305;0;305
32;Hauts-de-France;80;4;18;267;Ennemain;281;2;283
32;Hauts-de-France;80;1;02;268;Épagne-Épagnette;530;14;544
32;Hauts-de-France;80;2;21;269;Épaumesnil;119;2;121
32;Hauts-de-France;80;2;14;270;Épécamps;5;0;5
32;Hauts-de-France;80;4;20;271;Épehy;1129;14;1143
32;Hauts-de-France;80;4;18;272;Épénancourt;124;2;126
32;Hauts-de-France;80;2;21;273;Éplessier;351;5;356
32;Hauts-de-France;80;4;18;274;Eppeville;1789;18;1807
32;Hauts-de-France;80;4;20;275;Équancourt;298;2;300
32;Hauts-de-France;80;2;21;276;Équennes-Éramecourt;286;7;293
32;Hauts-de-France;80;3;22;278;Erches;188;3;191
32;Hauts-de-France;80;3;22;279;Ercheu;769;11;780
32;Hauts-de-France;80;1;02;280;Ercourt;123;2;125
32;Hauts-de-France;80;1;23;281;Ergnies;176;1;177
32;Hauts-de-France;80;1;17;282;Érondelle;511;5;516
32;Hauts-de-France;80;3;03;283;Esclainvillers;166;0;166
32;Hauts-de-France;80;4;18;284;Esmery-Hallon;748;36;784
32;Hauts-de-France;80;2;03;285;Essertaux;260;3;263
32;Hauts-de-France;80;1;02;287;Estrébœuf;239;4;243
32;Hauts-de-France;80;4;18;288;Estrées-Deniécourt;328;10;338
32;Hauts-de-France;80;1;23;290;Estrées-lès-Crécy;391;5;396
32;Hauts-de-France;80;2;03;291;Estrées-sur-Noye;272;3;275
32;Hauts-de-France;80;3;22;292;Étalon;135;1;136
32;Hauts-de-France;80;3;22;293;Ételfay;362;3;365
32;Hauts-de-France;80;4;20;294;Éterpigny;159;3;162
32;Hauts-de-France;80;4;05;295;Étinehem-Méricourt;592;7;599
32;Hauts-de-France;80;2;15;296;L'Étoile;1182;8;1190
32;Hauts-de-France;80;2;21;297;Étréjust;40;1;41
32;Hauts-de-France;80;4;20;298;Étricourt-Manancourt;529;3;532
32;Hauts-de-France;80;3;03;299;La Faloise;236;1;237
32;Hauts-de-France;80;4;18;300;Falvy;156;1;157
32;Hauts-de-France;80;2;21;301;Famechon;274;2;276
32;Hauts-de-France;80;3;22;302;Faverolles;170;3;173
32;Hauts-de-France;80;1;23;303;Favières;462;7;469
32;Hauts-de-France;80;4;18;304;Fay;100;2;102
32;Hauts-de-France;80;2;04;305;Ferrières;474;12;486
32;Hauts-de-France;80;3;22;306;Fescamps;133;5;138
32;Hauts-de-France;80;4;20;307;Feuillères;153;2;155
32;Hauts-de-France;80;1;17;308;Feuquières-en-Vimeu;2499;42;2541
32;Hauts-de-France;80;2;14;310;Fienvillers;684;12;696
32;Hauts-de-France;80;3;22;311;Fignières;153;2;155
32;Hauts-de-France;80;4;20;312;Fins;279;1;280
32;Hauts-de-France;80;4;20;313;Flaucourt;292;5;297
32;Hauts-de-France;80;4;20;314;Flers;199;3;202
32;Hauts-de-France;80;3;03;315;Flers-sur-Noye;508;10;518
32;Hauts-de-France;80;2;15;316;Flesselles;2016;24;2040
32;Hauts-de-France;80;2;03;317;Fleury;212;3;215
32;Hauts-de-France;80;2;15;318;Flixecourt;3237;73;3310
32;Hauts-de-France;80;2;04;319;Fluy;340;0;340
32;Hauts-de-France;80;4;19;320;Folies;156;1;157
32;Hauts-de-France;80;3;03;321;Folleville;142;2;144
32;Hauts-de-France;80;3;22;322;Fonches-Fonchette;170;0;170
32;Hauts-de-France;80;2;21;324;Fontaine-le-Sec;145;5;150
32;Hauts-de-France;80;4;18;325;Fontaine-lès-Cappy;51;1;52
32;Hauts-de-France;80;3;22;326;Fontaine-sous-Montdidier;108;2;110
32;Hauts-de-France;80;1;23;327;Fontaine-sur-Maye;158;5;163
32;Hauts-de-France;80;1;17;328;Fontaine-sur-Somme;525;5;530
32;Hauts-de-France;80;4;05;329;Forceville;178;1;179
32;Hauts-de-France;80;2;21;330;Forceville-en-Vimeu;237;6;243
32;Hauts-de-France;80;1;01;331;Forest-l'Abbaye;308;12;320
32;Hauts-de-France;80;1;01;332;Forest-Montiers;397;9;406
32;Hauts-de-France;80;1;23;333;Fort-Mahon-Plage;1298;13;1311
32;Hauts-de-France;80;2;03;334;Fossemanant;96;3;99
32;Hauts-de-France;80;4;18;335;Foucaucourt-en-Santerre;244;3;247
32;Hauts-de-France;80;2;21;336;Foucaucourt-Hors-Nesle;81;1;82
32;Hauts-de-France;80;3;03;337;Fouencamps;204;3;207
32;Hauts-de-France;80;2;13;338;Fouilloy;1829;17;1846
32;Hauts-de-France;80;4;19;339;Fouquescourt;154;4;158
32;Hauts-de-France;80;2;21;340;Fourcigny;199;2;201
32;Hauts-de-France;80;2;04;341;Fourdrinoy;401;9;410
32;Hauts-de-France;80;4;18;342;Framerville-Rainecourt;459;3;462
32;Hauts-de-France;80;2;21;343;Framicourt;171;2;173
32;Hauts-de-France;80;1;23;344;Francières;182;8;190
32;Hauts-de-France;80;1;02;345;Franleu;530;5;535
32;Hauts-de-France;80;2;15;346;Franqueville;167;1;168
32;Hauts-de-France;80;4;19;347;Fransart;156;2;158
32;Hauts-de-France;80;2;15;348;Fransu;181;4;185
32;Hauts-de-France;80;3;03;349;Fransures;134;1;135
32;Hauts-de-France;80;2;13;350;Franvillers;506;7;513
32;Hauts-de-France;80;2;13;351;Fréchencourt;258;2;260
32;Hauts-de-France;80;2;03;352;Frémontiers;157;1;158
32;Hauts-de-France;80;4;18;353;Fresnes-Mazancourt;151;1;152
32;Hauts-de-France;80;2;21;354;Fresnes-Tilloloy;204;3;207
32;Hauts-de-France;80;2;21;355;Fresneville;102;2;104
32;Hauts-de-France;80;2;21;356;Fresnoy-Andainville;90;9;99
32;Hauts-de-France;80;2;04;357;Fresnoy-au-Val;234;6;240
32;Hauts-de-France;80;3;19;358;Fresnoy-en-Chaussée;137;2;139
32;Hauts-de-France;80;3;22;359;Fresnoy-lès-Roye;287;9;296
32;Hauts-de-France;80;1;16;360;Fressenneville;2181;43;2224
32;Hauts-de-France;80;2;21;361;Frettecuisse;75;0;75
32;Hauts-de-France;80;1;17;362;Frettemeule;308;7;315
32;Hauts-de-France;80;1;16;364;Friaucourt;703;11;714
32;Hauts-de-France;80;2;21;365;Fricamps;185;0;185
32;Hauts-de-France;80;4;05;366;Fricourt;490;4;494
32;Hauts-de-France;80;4;05;367;Frise;180;5;185
32;Hauts-de-France;80;1;16;368;Friville-Escarbotin;4491;98;4589
32;Hauts-de-France;80;2;14;369;Frohen-sur-Authie;235;5;240
32;Hauts-de-France;80;1;23;371;Froyelles;97;4;101
32;Hauts-de-France;80;1;17;372;Frucourt;124;4;128
32;Hauts-de-France;80;1;17;373;Gamaches;2480;84;2564
32;Hauts-de-France;80;1;01;374;Gapennes;280;3;283
32;Hauts-de-France;80;2;21;375;Gauville;341;7;348
32;Hauts-de-France;80;2;09;376;Gentelles;652;4;656
32;Hauts-de-France;80;2;14;377;Gézaincourt;409;5;414
32;Hauts-de-France;80;4;20;378;Ginchy;66;1;67
32;Hauts-de-France;80;2;09;379;Glisy;826;1;827
32;Hauts-de-France;80;1;23;380;Gorenflos;243;5;248
32;Hauts-de-France;80;2;14;381;Gorges;38;1;39
32;Hauts-de-France;80;3;22;383;Goyencourt;92;0;92
32;Hauts-de-France;80;4;05;384;Grandcourt;177;1;178
32;Hauts-de-France;80;1;01;385;Grand-Laviers;459;28;487
32;Hauts-de-France;80;3;22;386;Gratibus;179;3;182
32;Hauts-de-France;80;2;03;387;Grattepanche;324;1;325
32;Hauts-de-France;80;1;02;388;Grébault-Mesnil;213;2;215
32;Hauts-de-France;80;3;03;390;Grivesnes;411;6;417
32;Hauts-de-France;80;3;22;391;Grivillers;88;0;88
32;Hauts-de-France;80;2;14;392;Grouches-Luchuel;576;13;589
32;Hauts-de-France;80;3;22;393;Gruny;312;6;318
32;Hauts-de-France;80;3;22;395;Guerbigny;278;5;283
32;Hauts-de-France;80;1;23;396;Gueschart;361;4;365
32;Hauts-de-France;80;4;20;397;Gueudecourt;93;4;97
32;Hauts-de-France;80;2;04;399;Guignemicourt;395;4;399
32;Hauts-de-France;80;4;19;400;Guillaucourt;413;5;418
32;Hauts-de-France;80;4;20;401;Guillemont;130;1;131
32;Hauts-de-France;80;2;21;402;Guizancourt;136;1;137
32;Hauts-de-France;80;3;03;403;Guyencourt-sur-Noye;184;3;187
32;Hauts-de-France;80;4;20;404;Guyencourt-Saulcourt;142;3;145
32;Hauts-de-France;80;3;19;405;Hailles;429;2;431
32;Hauts-de-France;80;1;17;406;Hallencourt;1302;17;1319
32;Hauts-de-France;80;3;03;407;Hallivillers;141;6;147
32;Hauts-de-France;80;2;15;408;Halloy-lès-Pernois;334;1;335
32;Hauts-de-France;80;4;19;409;Hallu;153;5;158
32;Hauts-de-France;80;4;18;410;Ham;4559;98;4657
32;Hauts-de-France;80;2;13;411;Le Hamel;493;6;499
32;Hauts-de-France;80;2;13;412;Hamelet;638;6;644
32;Hauts-de-France;80;4;20;413;Hancourt;90;1;91
32;Hauts-de-France;80;3;19;414;Hangard;123;2;125
32;Hauts-de-France;80;3;19;415;Hangest-en-Santerre;1012;8;1020
32;Hauts-de-France;80;2;04;416;Hangest-sur-Somme;770;9;779
32;Hauts-de-France;80;4;19;417;Harbonnières;1640;11;1651
32;Hauts-de-France;80;4;20;418;Hardecourt-aux-Bois;84;0;84
32;Hauts-de-France;80;4;05;420;Harponville;175;1;176
32;Hauts-de-France;80;3;22;421;Hattencourt;294;4;298
32;Hauts-de-France;80;1;01;422;Hautvillers-Ouville;578;10;588
32;Hauts-de-France;80;2;15;423;Havernas;381;5;386
32;Hauts-de-France;80;2;11;424;Hébécourt;540;18;558
32;Hauts-de-France;80;4;05;425;Hédauville;116;1;117
32;Hauts-de-France;80;2;13;426;Heilly;435;8;443
32;Hauts-de-France;80;2;14;427;Hem-Hardinval;376;8;384
32;Hauts-de-France;80;4;20;428;Hem-Monacu;134;2;136
32;Hauts-de-France;80;2;13;429;Hénencourt;193;1;194
32;Hauts-de-France;80;4;20;430;Herbécourt;201;7;208
32;Hauts-de-France;80;4;05;431;Hérissart;683;11;694
32;Hauts-de-France;80;4;18;432;Herleville;190;1;191
32;Hauts-de-France;80;3;22;433;Herly;44;0;44
32;Hauts-de-France;80;4;20;434;Hervilly;190;4;194
32;Hauts-de-France;80;4;20;435;Hesbécourt;57;0;57
32;Hauts-de-France;80;2;21;436;Hescamps;522;13;535
32;Hauts-de-France;80;2;21;437;Heucourt-Croquoison;110;4;114
32;Hauts-de-France;80;4;20;438;Heudicourt;511;6;517
32;Hauts-de-France;80;2;14;439;Heuzecourt;167;1;168
32;Hauts-de-France;80;2;14;440;Hiermont;153;3;156
32;Hauts-de-France;80;4;18;442;Hombleux;1178;10;1188
32;Hauts-de-France;80;2;21;443;Hornoy-le-Bourg;1681;28;1709
32;Hauts-de-France;80;1;02;444;Huchenneville;661;13;674
32;Hauts-de-France;80;2;14;445;Humbercourt;272;2;274
32;Hauts-de-France;80;1;17;446;Huppy;755;20;775
32;Hauts-de-France;80;3;19;449;Ignaucourt;69;2;71
32;Hauts-de-France;80;2;21;450;Inval-Boiron;112;1;113
32;Hauts-de-France;80;4;05;451;Irles;123;0;123
32;Hauts-de-France;80;3;03;452;Jumel;521;3;524
32;Hauts-de-France;80;3;22;453;Laboissière-en-Santerre;142;0;142
32;Hauts-de-France;80;2;21;455;Lachapelle;91;2;93
32;Hauts-de-France;80;2;21;456;Lafresguimont-Saint-Martin;554;6;560
32;Hauts-de-France;80;2;13;458;Lahoussoye;451;11;462
32;Hauts-de-France;80;2;04;459;Laleu;108;0;108
32;Hauts-de-France;80;2;21;460;Lamaronde;65;1;66
32;Hauts-de-France;80;2;08;461;Lamotte-Brebière;216;4;220
32;Hauts-de-France;80;1;01;462;Lamotte-Buleux;357;11;368
32;Hauts-de-France;80;2;13;463;Lamotte-Warfusée;702;10;712
32;Hauts-de-France;80;1;16;464;Lanchères;918;14;932
32;Hauts-de-France;80;4;18;465;Languevoisin-Quiquery;196;5;201
32;Hauts-de-France;80;2;15;466;Lanches-Saint-Hilaire;133;1;134
32;Hauts-de-France;80;3;22;467;Laucourt;194;1;195
32;Hauts-de-France;80;4;05;468;Laviéville;170;3;173
32;Hauts-de-France;80;3;03;469;Lawarde-Mauger-l'Hortoy;162;1;163
32;Hauts-de-France;80;4;05;470;Léalvillers;164;2;166
32;Hauts-de-France;80;4;20;472;Lesbœufs;173;7;180
32;Hauts-de-France;80;3;22;473;Liancourt-Fosse;295;2;297
32;Hauts-de-France;80;4;18;474;Licourt;396;3;399
32;Hauts-de-France;80;4;20;475;Liéramont;215;7;222
32;Hauts-de-France;80;1;17;476;Liercourt;372;4;376
32;Hauts-de-France;80;1;23;477;Ligescourt;222;4;226
32;Hauts-de-France;80;3;22;478;Lignières;145;2;147
32;Hauts-de-France;80;2;21;479;Lignières-Châtelain;354;6;360
32;Hauts-de-France;80;2;21;480;Lignières-en-Vimeu;113;2;115
32;Hauts-de-France;80;4;18;481;Lihons;458;5;463
32;Hauts-de-France;80;1;17;482;Limeux;140;2;142
32;Hauts-de-France;80;2;21;484;Liomer;388;6;394
32;Hauts-de-France;80;2;03;485;Ô-de-Selle;1179;9;1188
32;Hauts-de-France;80;1;23;486;Long;618;8;626
32;Hauts-de-France;80;4;20;487;Longavesnes;79;2;81
32;Hauts-de-France;80;1;17;488;Longpré-les-Corps-Saints;1587;29;1616
32;Hauts-de-France;80;2;09;489;Longueau;5765;45;5810
32;Hauts-de-France;80;4;20;490;Longueval;273;9;282
32;Hauts-de-France;80;2;14;491;Longuevillette;75;1;76
32;Hauts-de-France;80;4;05;493;Louvencourt;294;5;299
32;Hauts-de-France;80;3;03;494;Louvrechy;201;3;204
32;Hauts-de-France;80;2;14;495;Lucheux;521;4;525
32;Hauts-de-France;80;1;23;496;Machiel;154;1;155
32;Hauts-de-France;80;1;23;497;Machy;118;5;123
32;Hauts-de-France;80;4;05;498;Mailly-Maillet;632;5;637
32;Hauts-de-France;80;3;03;499;Mailly-Raineval;300;6;306
32;Hauts-de-France;80;1;17;500;Maisnières;531;7;538
32;Hauts-de-France;80;1;23;501;Maison-Ponthieu;283;3;286
32;Hauts-de-France;80;1;23;502;Maison-Roland;101;3;104
32;Hauts-de-France;80;2;14;503;Maizicourt;186;2;188
32;Hauts-de-France;80;3;22;504;Malpart;76;0;76
32;Hauts-de-France;80;4;05;505;Carnoy-Mametz;292;4;296
32;Hauts-de-France;80;2;13;507;Marcelcave;1263;19;1282
32;Hauts-de-France;80;3;22;508;Marché-Allouarde;51;0;51
32;Hauts-de-France;80;4;18;509;Marchélepot-Misery;598;6;604
32;Hauts-de-France;80;3;22;511;Marestmontiers;111;1;112
32;Hauts-de-France;80;1;02;512;Mareuil-Caubert;836;11;847
32;Hauts-de-France;80;4;05;513;Maricourt;180;3;183
32;Hauts-de-France;80;4;05;514;Marieux;129;1;130
32;Hauts-de-France;80;2;21;515;Marlers;144;2;146
32;Hauts-de-France;80;4;20;516;Marquaix;194;1;195
32;Hauts-de-France;80;3;22;517;Marquivillers;197;3;200
32;Hauts-de-France;80;1;17;518;Martainneville;425;3;428
32;Hauts-de-France;80;4;18;519;Matigny;502;7;509
32;Hauts-de-France;80;4;19;520;Maucourt;182;3;185
32;Hauts-de-France;80;4;20;521;Maurepas;211;0;211
32;Hauts-de-France;80;2;21;522;Le Mazis;107;0;107
32;Hauts-de-France;80;4;05;523;Méaulte;1259;22;1281
32;Hauts-de-France;80;4;19;524;Méharicourt;588;6;594
32;Hauts-de-France;80;2;21;525;Meigneux;179;3;182
32;Hauts-de-France;80;2;14;526;Le Meillard;155;3;158
32;Hauts-de-France;80;1;16;527;Méneslies;303;7;310
32;Hauts-de-France;80;2;21;528;Méréaucourt;9;0;9
32;Hauts-de-France;80;1;17;529;Mérélessart;193;4;197
32;Hauts-de-France;80;2;13;530;Méricourt-l'Abbé;607;4;611
32;Hauts-de-France;80;2;21;531;Méricourt-en-Vimeu;102;0;102
32;Hauts-de-France;80;1;16;533;Mers-les-Bains;2655;56;2711
32;Hauts-de-France;80;2;04;535;Le Mesge;161;5;166
32;Hauts-de-France;80;4;20;536;Mesnil-Bruntel;287;3;290
32;Hauts-de-France;80;1;23;537;Mesnil-Domqueur;89;0;89
32;Hauts-de-France;80;4;20;538;Mesnil-en-Arrouaise;122;0;122
32;Hauts-de-France;80;4;05;540;Mesnil-Martinsart;235;4;239
32;Hauts-de-France;80;3;22;541;Mesnil-Saint-Georges;198;3;201
32;Hauts-de-France;80;4;18;542;Mesnil-Saint-Nicaise;561;6;567
32;Hauts-de-France;80;2;04;543;Métigny;117;3;120
32;Hauts-de-France;80;2;14;544;Mézerolles;184;3;187
32;Hauts-de-France;80;3;19;545;Mézières-en-Santerre;559;7;566
32;Hauts-de-France;80;1;02;546;Miannay;584;12;596
32;Hauts-de-France;80;4;05;547;Millencourt;205;4;209
32;Hauts-de-France;80;1;01;548;Millencourt-en-Ponthieu;354;2;356
32;Hauts-de-France;80;4;05;549;Miraumont;655;12;667
32;Hauts-de-France;80;2;13;550;Mirvaux;130;4;134
32;Hauts-de-France;80;4;20;552;Moislains;1153;22;1175
32;Hauts-de-France;80;2;13;553;Molliens-au-Bois;327;10;337
32;Hauts-de-France;80;2;04;554;Molliens-Dreuil;980;9;989
32;Hauts-de-France;80;4;18;555;Monchy-Lagache;601;19;620
32;Hauts-de-France;80;1;02;556;Mons-Boubert;552;6;558
32;Hauts-de-France;80;4;20;557;Estrées-Mons;594;11;605
32;Hauts-de-France;80;2;03;558;Monsures;223;3;226
32;Hauts-de-France;80;2;04;559;Montagne-Fayel;143;3;146
32;Hauts-de-France;80;4;05;560;Montauban-de-Picardie;214;1;215
32;Hauts-de-France;80;3;22;561;Montdidier;6113;105;6218
32;Hauts-de-France;80;2;13;562;Montigny-sur-l'Hallue;206;2;208
32;Hauts-de-France;80;2;14;563;Montigny-les-Jongleurs;96;1;97
32;Hauts-de-France;80;2;07;565;Montonvillers;82;2;84
32;Hauts-de-France;80;2;14;566;Fieffes-Montrelet;341;8;349
32;Hauts-de-France;80;4;18;568;Morchain;347;4;351
32;Hauts-de-France;80;2;13;569;Morcourt;327;3;330
32;Hauts-de-France;80;3;19;570;Moreuil;3986;28;4014
32;Hauts-de-France;80;3;19;571;Morisel;497;9;506
32;Hauts-de-France;80;4;05;572;Morlancourt;367;2;369
32;Hauts-de-France;80;2;21;573;Morvillers-Saint-Saturnin;398;5;403
32;Hauts-de-France;80;1;23;574;Mouflers;95;1;96
32;Hauts-de-France;80;2;21;575;Mouflières;80;8;88
32;Hauts-de-France;80;4;18;576;Moyencourt;321;0;321
32;Hauts-de-France;80;2;21;577;Moyencourt-lès-Poix;183;1;184
32;Hauts-de-France;80;1;02;578;Moyenneville;719;11;730
32;Hauts-de-France;80;4;18;579;Muille-Villette;851;12;863
32;Hauts-de-France;80;1;23;580;Nampont;250;3;253
32;Hauts-de-France;80;2;03;582;Namps-Maisnil;1002;15;1017
32;Hauts-de-France;80;2;03;583;Nampty;290;8;298
32;Hauts-de-France;80;2;13;584;Naours;1078;10;1088
32;Hauts-de-France;80;4;18;585;Nesle;2314;30;2344
32;Hauts-de-France;80;2;21;586;Nesle-l'Hôpital;156;1;157
32;Hauts-de-France;80;2;21;587;Neslette;82;2;84
32;Hauts-de-France;80;1;01;588;Neufmoulin;359;7;366
32;Hauts-de-France;80;1;23;589;Neuilly-le-Dien;100;0;100
32;Hauts-de-France;80;1;01;590;Neuilly-l'Hôpital;321;12;333
32;Hauts-de-France;80;2;21;591;Neuville-au-Bois;151;1;152
32;Hauts-de-France;80;2;21;592;Neuville-Coppegueule;507;7;514
32;Hauts-de-France;80;4;05;593;La Neuville-lès-Bray;254;2;256
32;Hauts-de-France;80;3;19;595;La Neuville-Sire-Bernard;301;1;302
32;Hauts-de-France;80;2;14;596;Neuvillette;221;6;227
32;Hauts-de-France;80;1;16;597;Nibas;852;15;867
32;Hauts-de-France;80;1;01;598;Nouvion;1259;37;1296
32;Hauts-de-France;80;1;23;599;Noyelles-en-Chaussée;241;3;244
32;Hauts-de-France;80;1;01;600;Noyelles-sur-Mer;685;10;695
32;Hauts-de-France;80;4;20;601;Nurlu;373;4;377
32;Hauts-de-France;80;2;14;602;Occoches;129;3;132
32;Hauts-de-France;80;1;16;603;Ochancourt;334;1;335
32;Hauts-de-France;80;2;21;604;Offignies;80;3;83
32;Hauts-de-France;80;4;18;605;Offoy;207;2;209
32;Hauts-de-France;80;2;21;606;Oisemont;1148;45;1193
32;Hauts-de-France;80;2;04;607;Oissy;212;3;215
32;Hauts-de-France;80;1;23;609;Oneux;408;6;414
32;Hauts-de-France;80;2;03;611;Oresmaux;924;11;935
32;Hauts-de-France;80;1;16;613;Oust-Marest;621;12;633
32;Hauts-de-France;80;2;14;614;Outrebois;317;6;323
32;Hauts-de-France;80;4;05;615;Ovillers-la-Boisselle;437;3;440
32;Hauts-de-France;80;4;18;616;Pargny;199;1;200
32;Hauts-de-France;80;4;19;617;Parvillers-le-Quesnoy;231;3;234
32;Hauts-de-France;80;1;16;618;Pendé;1051;14;1065
32;Hauts-de-France;80;2;15;619;Pernois;728;8;736
32;Hauts-de-France;80;4;20;620;Péronne;7577;207;7784
32;Hauts-de-France;80;4;18;621;Hypercourt;723;11;734
32;Hauts-de-France;80;2;04;622;Picquigny;1311;16;1327
32;Hauts-de-France;80;3;22;623;Piennes-Onvillers;371;6;377
32;Hauts-de-France;80;2;13;624;Pierregot;282;5;287
32;Hauts-de-France;80;3;22;625;Trois-Rivières;1516;12;1528
32;Hauts-de-France;80;2;04;626;Pissy;292;2;294
32;Hauts-de-France;80;2;03;627;Plachy-Buyon;829;20;849
32;Hauts-de-France;80;3;19;628;Le Plessier-Rozainvillers;776;4;780
32;Hauts-de-France;80;4;20;629;Pœuilly;108;2;110
32;Hauts-de-France;80;2;21;630;Poix-de-Picardie;2358;39;2397
32;Hauts-de-France;80;1;23;631;Ponches-Estruval;98;3;101
32;Hauts-de-France;80;2;12;632;Pont-de-Metz;2411;37;2448
32;Hauts-de-France;80;1;01;633;Ponthoile;608;10;618
32;Hauts-de-France;80;2;13;634;Pont-Noyelles;821;17;838
32;Hauts-de-France;80;1;23;635;Pont-Remy;1459;22;1481
32;Hauts-de-France;80;1;01;637;Port-le-Grand;288;1;289
32;Hauts-de-France;80;4;18;638;Potte;108;6;114
32;Hauts-de-France;80;2;07;639;Poulainville;1236;23;1259
32;Hauts-de-France;80;4;05;640;Pozières;266;3;269
32;Hauts-de-France;80;2;14;642;Prouville;321;2;323
32;Hauts-de-France;80;2;03;643;Prouzel;558;8;566
32;Hauts-de-France;80;4;18;644;Proyart;728;11;739
32;Hauts-de-France;80;4;05;645;Puchevillers;556;3;559
32;Hauts-de-France;80;4;18;646;Punchy;92;4;96
32;Hauts-de-France;80;4;18;647;Puzeaux;293;3;296
32;Hauts-de-France;80;4;05;648;Pys;121;1;122
32;Hauts-de-France;80;1;23;649;Quend;1313;29;1342
32;Hauts-de-France;80;2;07;650;Querrieu;632;17;649
32;Hauts-de-France;80;2;21;651;Le Quesne;265;2;267
32;Hauts-de-France;80;3;19;652;Le Quesnel;780;9;789
32;Hauts-de-France;80;1;02;654;Quesnoy-le-Montant;543;18;561
32;Hauts-de-France;80;2;04;655;Quesnoy-sur-Airaines;428;5;433
32;Hauts-de-France;80;2;04;656;Quevauvillers;1085;10;1095
32;Hauts-de-France;80;3;03;657;Quiry-le-Sec;322;2;324
32;Hauts-de-France;80;4;18;658;Quivières;144;3;147
32;Hauts-de-France;80;4;05;659;Raincheval;271;6;277
32;Hauts-de-France;80;2;07;661;Rainneville;1010;7;1017
32;Hauts-de-France;80;1;17;662;Ramburelles;284;2;286
32;Hauts-de-France;80;2;21;663;Rambures;340;7;347
32;Hauts-de-France;80;4;20;664;Rancourt;192;3;195
32;Hauts-de-France;80;1;23;665;Regnière-Écluse;123;3;126
32;Hauts-de-France;80;2;14;666;Remaisnil;32;0;32
32;Hauts-de-France;80;3;22;667;Remaugies;132;0;132
32;Hauts-de-France;80;2;03;668;Remiencourt;168;3;171
32;Hauts-de-France;80;4;18;669;Rethonvillers;351;6;357
32;Hauts-de-France;80;2;04;670;Revelles;497;8;505
32;Hauts-de-France;80;2;15;671;Ribeaucourt;234;7;241
32;Hauts-de-France;80;2;13;672;Ribemont-sur-Ancre;648;12;660
32;Hauts-de-France;80;2;04;673;Riencourt;175;7;182
32;Hauts-de-France;80;2;08;674;Rivery;3599;34;3633
32;Hauts-de-France;80;3;03;675;Rogy;127;2;129
32;Hauts-de-France;80;3;22;676;Roiglise;154;7;161
32;Hauts-de-France;80;4;20;677;Roisel;1593;19;1612
32;Hauts-de-France;80;3;22;678;Rollot;770;19;789
32;Hauts-de-France;80;4;20;679;Ronssoy;591;5;596
32;Hauts-de-France;80;4;19;680;Rosières-en-Santerre;3017;25;3042
32;Hauts-de-France;80;3;03;681;Rouvrel;309;8;317
32;Hauts-de-France;80;4;19;682;Rouvroy-en-Santerre;213;6;219
32;Hauts-de-France;80;4;18;683;Rouy-le-Grand;103;3;106
32;Hauts-de-France;80;4;18;684;Rouy-le-Petit;109;4;113
32;Hauts-de-France;80;3;22;685;Roye;5693;61;5754
32;Hauts-de-France;80;2;13;686;Rubempré;728;9;737
32;Hauts-de-France;80;3;22;687;Rubescourt;133;2;135
32;Hauts-de-France;80;1;23;688;Rue;3111;91;3202
32;Hauts-de-France;80;2;11;690;Rumigny;628;9;637
32;Hauts-de-France;80;1;02;691;Saigneville;353;13;366
32;Hauts-de-France;80;1;01;692;Sailly-Flibeaucourt;1023;18;1041
32;Hauts-de-France;80;2;13;693;Sailly-Laurette;327;1;328
32;Hauts-de-France;80;2;13;694;Sailly-le-Sec;350;6;356
32;Hauts-de-France;80;4;20;695;Sailly-Saillisel;483;6;489
32;Hauts-de-France;80;2;11;696;Sains-en-Amiénois;1220;32;1252
32;Hauts-de-France;80;2;14;697;Saint-Acheul;32;0;32
32;Hauts-de-France;80;2;04;698;Saint-Aubin-Montenoy;221;4;225
32;Hauts-de-France;80;2;21;699;Saint-Aubin-Rivière;111;0;111
32;Hauts-de-France;80;1;16;700;Saint-Blimont;878;16;894
32;Hauts-de-France;80;4;18;701;Saint-Christ-Briost;432;10;442
32;Hauts-de-France;80;2;11;702;Saint-Fuscien;1309;27;1336
32;Hauts-de-France;80;2;21;703;Saint-Germain-sur-Bresle;203;3;206
32;Hauts-de-France;80;2;07;704;Saint-Gratien;382;5;387
32;Hauts-de-France;80;4;05;705;Saint-Léger-lès-Authie;82;1;83
32;Hauts-de-France;80;2;15;706;Saint-Léger-lès-Domart;1854;16;1870
32;Hauts-de-France;80;2;21;707;Saint-Léger-sur-Bresle;75;4;79
32;Hauts-de-France;80;3;22;708;Saint-Mard;155;3;158
32;Hauts-de-France;80;2;21;709;Saint-Maulvis;268;8;276
32;Hauts-de-France;80;1;17;710;Saint-Maxent;395;5;400
32;Hauts-de-France;80;2;15;711;Saint-Ouen;1828;15;1843
32;Hauts-de-France;80;1;23;713;Saint-Quentin-en-Tourmont;281;5;286
32;Hauts-de-France;80;1;16;714;Saint-Quentin-la-Motte-Croix-au-Bailly;1280;21;1301
32;Hauts-de-France;80;1;23;716;Saint-Riquier;1265;29;1294
32;Hauts-de-France;80;2;03;717;Saint-Sauflieu;992;7;999
32;Hauts-de-France;80;2;04;718;Saint-Sauveur;1341;16;1357
32;Hauts-de-France;80;2;21;719;Sainte-Segrée;52;5;57
32;Hauts-de-France;80;1;02;721;Saint-Valery-sur-Somme;2469;41;2510
32;Hauts-de-France;80;2;15;722;Saint-Vaast-en-Chaussée;488;7;495
32;Hauts-de-France;80;2;04;723;Saisseval;240;1;241
32;Hauts-de-France;80;2;12;724;Saleux;2805;30;2835
32;Hauts-de-France;80;2;12;725;Salouël;3918;54;3972
32;Hauts-de-France;80;4;18;726;Sancourt;265;6;271
32;Hauts-de-France;80;2;21;728;Saulchoy-sous-Poix;75;0;75
32;Hauts-de-France;80;3;03;729;Sauvillers-Mongival;177;0;177
32;Hauts-de-France;80;2;04;730;Saveuse;952;8;960
32;Hauts-de-France;80;2;21;732;Senarpont;628;14;642
32;Hauts-de-France;80;4;05;733;Senlis-le-Sec;307;3;310
32;Hauts-de-France;80;2;03;734;Sentelie;212;3;215
32;Hauts-de-France;80;2;04;735;Seux;167;2;169
32;Hauts-de-France;80;1;17;736;Sorel-en-Vimeu;208;5;213
32;Hauts-de-France;80;4;20;737;Sorel;161;1;162
32;Hauts-de-France;80;2;04;738;Soues;126;3;129
32;Hauts-de-France;80;3;03;740;Sourdon;344;2;346
32;Hauts-de-France;80;4;18;741;Soyécourt;190;4;194
32;Hauts-de-France;80;2;15;742;Surcamps;65;2;67
32;Hauts-de-France;80;4;05;743;Suzanne;192;4;196
32;Hauts-de-France;80;2;04;744;Tailly;57;2;59
32;Hauts-de-France;80;2;13;746;Talmas;1069;12;1081
32;Hauts-de-France;80;4;20;747;Templeux-la-Fosse;136;3;139
32;Hauts-de-France;80;4;20;748;Templeux-le-Guérard;185;3;188
32;Hauts-de-France;80;2;14;749;Terramesnil;317;4;321
32;Hauts-de-France;80;4;18;750;Tertry;146;1;147
32;Hauts-de-France;80;3;19;751;Thennes;580;6;586
32;Hauts-de-France;80;2;03;752;Thézy-Glimont;678;8;686
32;Hauts-de-France;80;4;05;753;Thiepval;124;2;126
32;Hauts-de-France;80;2;21;754;Thieulloy-l'Abbaye;399;4;403
32;Hauts-de-France;80;2;21;755;Thieulloy-la-Ville;147;4;151
32;Hauts-de-France;80;4;05;756;Thièvres;63;0;63
32;Hauts-de-France;80;2;03;757;Thoix;146;2;148
32;Hauts-de-France;80;3;03;758;Thory;207;0;207
32;Hauts-de-France;80;3;22;759;Tilloloy;349;9;358
32;Hauts-de-France;80;1;17;760;Tilloy-Floriville;378;10;388
32;Hauts-de-France;80;4;20;762;Tincourt-Boucly;346;10;356
32;Hauts-de-France;80;1;01;763;Le Titre;344;8;352
32;Hauts-de-France;80;1;02;764;Tœufles;296;7;303
32;Hauts-de-France;80;1;02;765;Tours-en-Vimeu;809;10;819
32;Hauts-de-France;80;4;05;766;Toutencourt;439;5;444
32;Hauts-de-France;80;2;21;767;Le Translay;258;6;264
32;Hauts-de-France;80;2;13;769;Treux;232;0;232
32;Hauts-de-France;80;1;16;770;Tully;538;9;547
32;Hauts-de-France;80;4;18;771;Ugny-l'Équipée;33;0;33
32;Hauts-de-France;80;2;13;773;Vadencourt;104;0;104
32;Hauts-de-France;80;2;13;774;Vaire-sous-Corbie;291;3;294
32;Hauts-de-France;80;1;16;775;Valines;632;6;638
32;Hauts-de-France;80;4;05;776;Varennes;218;1;219
32;Hauts-de-France;80;4;05;777;Vauchelles-lès-Authie;139;1;140
32;Hauts-de-France;80;2;15;778;Vauchelles-lès-Domart;127;0;127
32;Hauts-de-France;80;1;01;779;Vauchelles-les-Quesnoy;848;19;867
32;Hauts-de-France;80;1;16;780;Vaudricourt;406;5;411
32;Hauts-de-France;80;4;18;781;Vauvillers;225;5;230
32;Hauts-de-France;80;2;15;782;Vaux-en-Amiénois;418;7;425
32;Hauts-de-France;80;1;17;783;Vaux-Marquenneville;84;1;85
32;Hauts-de-France;80;2;13;784;Vaux-sur-Somme;306;6;312
32;Hauts-de-France;80;2;08;785;Vecquemont;544;9;553
32;Hauts-de-France;80;2;03;786;Velennes;149;0;149
32;Hauts-de-France;80;1;23;787;Vercourt;95;1;96
32;Hauts-de-France;80;2;21;788;Vergies;173;2;175
32;Hauts-de-France;80;4;18;789;Vermandovillers;152;0;152
32;Hauts-de-France;80;3;22;790;Verpillières;169;3;172
32;Hauts-de-France;80;2;12;791;Vers-sur-Selle;732;6;738
32;Hauts-de-France;80;2;13;792;La Vicogne;246;1;247
32;Hauts-de-France;80;2;15;793;Vignacourt;2338;34;2372
32;Hauts-de-France;80;4;18;794;Villecourt;57;1;58
32;Hauts-de-France;80;2;15;795;Ville-le-Marclet;469;42;511
32;Hauts-de-France;80;2;21;796;Villeroy;182;6;188
32;Hauts-de-France;80;3;19;797;Villers-aux-Érables;138;3;141
32;Hauts-de-France;80;2;07;798;Villers-Bocage;1435;53;1488
32;Hauts-de-France;80;2;09;799;Villers-Bretonneux;4592;56;4648
32;Hauts-de-France;80;2;21;800;Villers-Campsart;143;7;150
32;Hauts-de-France;80;4;20;801;Villers-Carbonnel;330;4;334
32;Hauts-de-France;80;4;20;802;Villers-Faucon;557;9;566
32;Hauts-de-France;80;3;22;803;Villers-lès-Roye;275;0;275
32;Hauts-de-France;80;1;23;804;Villers-sous-Ailly;179;5;184
32;Hauts-de-France;80;3;22;805;Villers-Tournelle;159;6;165
32;Hauts-de-France;80;1;23;806;Villers-sur-Authie;471;8;479
32;Hauts-de-France;80;4;05;807;Ville-sur-Ancre;266;3;269
32;Hauts-de-France;80;1;23;808;Vironchaux;498;9;507
32;Hauts-de-France;80;1;17;809;Vismes;477;12;489
32;Hauts-de-France;80;1;23;810;Vitz-sur-Authie;135;1;136
32;Hauts-de-France;80;4;18;811;Voyennes;591;7;598
32;Hauts-de-France;80;4;20;812;Vraignes-en-Vermandois;139;3;142
32;Hauts-de-France;80;2;21;813;Vraignes-lès-Hornoy;97;3;100
32;Hauts-de-France;80;4;19;814;Vrély;449;9;458
32;Hauts-de-France;80;1;23;815;Vron;836;26;862
32;Hauts-de-France;80;2;13;819;Wargnies;84;3;87
32;Hauts-de-France;80;2;13;820;Warloy-Baillon;753;10;763
32;Hauts-de-France;80;2;04;821;Warlus;220;5;225
32;Hauts-de-France;80;3;22;822;Warsy;143;2;145
32;Hauts-de-France;80;4;19;823;Warvillers;134;10;144
32;Hauts-de-France;80;4;19;824;Wiencourt-l'Équipée;270;2;272
32;Hauts-de-France;80;1;17;825;Wiry-au-Mont;115;1;116
32;Hauts-de-France;80;1;16;826;Woignarue;791;17;808
32;Hauts-de-France;80;1;16;827;Woincourt;1239;14;1253
32;Hauts-de-France;80;2;21;828;Woirel;67;0;67
32;Hauts-de-France;80;4;18;829;Y;91;2;93
32;Hauts-de-France;80;1;23;830;Yaucourt-Bussus;245;5;250
32;Hauts-de-France;80;1;23;832;Yvrench;305;4;309
32;Hauts-de-France;80;1;23;833;Yvrencheux;123;2;125
32;Hauts-de-France;80;1;16;834;Yzengremer;514;42;556
32;Hauts-de-France;80;2;04;835;Yzeux;269;0;269
32;Hauts-de-France;80;1;02;836;Yonval;220;7;227
76;Occitanie;81;2;15;001;Aguts;226;9;235
76;Occitanie;81;2;16;002;Aiguefonde;2512;57;2569
76;Occitanie;81;1;13;003;Alban;928;36;964
76;Occitanie;81;1;96;004;Albi;48902;1723;50625
76;Occitanie;81;2;17;005;Albine;518;5;523
76;Occitanie;81;2;15;006;Algans;198;3;201
76;Occitanie;81;1;23;007;Alos;95;2;97
76;Occitanie;81;1;05;008;Almayrac;294;4;298
76;Occitanie;81;1;06;009;Amarens;68;0;68
76;Occitanie;81;1;13;010;Ambialet;467;6;473
76;Occitanie;81;2;21;011;Ambres;1010;40;1050
76;Occitanie;81;1;23;012;Andillac;121;1;122
76;Occitanie;81;1;05;013;Andouque;406;8;414
76;Occitanie;81;2;14;014;Anglès;502;8;510
76;Occitanie;81;2;19;015;Appelle;73;1;74
76;Occitanie;81;2;18;016;Arfons;165;7;172
76;Occitanie;81;2;13;017;Arifat;160;1;161
76;Occitanie;81;1;22;018;Arthès;2512;50;2562
76;Occitanie;81;1;05;019;Assac;143;1;144
76;Occitanie;81;1;10;020;Aussac;271;12;283
76;Occitanie;81;2;16;021;Aussillon;5827;135;5962
76;Occitanie;81;2;15;022;Bannières;203;7;210
76;Occitanie;81;2;14;023;Barre;208;2;210
76;Occitanie;81;1;23;024;Beauvais-sur-Tescou;363;9;372
76;Occitanie;81;2;15;025;Belcastel;244;9;253
76;Occitanie;81;1;13;026;Bellegarde-Marsal;703;7;710
76;Occitanie;81;2;18;027;Belleserre;158;2;160
76;Occitanie;81;2;14;028;Berlats;103;1;104
76;Occitanie;81;1;10;029;Bernac;186;5;191
76;Occitanie;81;2;19;030;Bertre;111;1;112
76;Occitanie;81;2;14;031;Le Bez;821;18;839
76;Occitanie;81;2;19;032;Blan;1135;19;1154
76;Occitanie;81;1;06;033;Blaye-les-Mines;2946;186;3132
76;Occitanie;81;2;16;034;Boissezon;387;7;394
76;Occitanie;81;1;06;035;Bournazel;218;7;225
76;Occitanie;81;2;17;036;Bout-du-Pont-de-Larn;1267;22;1289
76;Occitanie;81;2;14;037;Brassac;1305;33;1338
76;Occitanie;81;1;11;038;Brens;2341;64;2405
76;Occitanie;81;2;12;039;Briatexte;2040;30;2070
76;Occitanie;81;2;20;040;Brousse;427;11;438
76;Occitanie;81;1;11;041;Broze;121;1;122
76;Occitanie;81;2;08;042;Burlats;2053;41;2094
76;Occitanie;81;2;12;043;Busque;736;13;749
76;Occitanie;81;2;20;044;Cabanès;303;4;307
76;Occitanie;81;1;06;045;Les Cabannes;369;9;378
76;Occitanie;81;1;10;046;Cadalen;1529;45;1574
76;Occitanie;81;1;05;047;Cadix;225;7;232
76;Occitanie;81;1;03;048;Cagnac-les-Mines;2578;32;2610
76;Occitanie;81;2;18;049;Cahuzac;350;3;353
76;Occitanie;81;2;15;050;Cambon-lès-Lavaur;342;10;352
76;Occitanie;81;1;23;051;Cahuzac-sur-Vère;1158;20;1178
76;Occitanie;81;1;22;052;Cambon;2128;56;2184
76;Occitanie;81;2;14;053;Cambounès;334;10;344
76;Occitanie;81;2;19;054;Cambounet-sur-le-Sor;939;28;967
76;Occitanie;81;2;18;055;Les Cammazes;349;1;350
76;Occitanie;81;1;23;056;Campagnac;157;2;159
76;Occitanie;81;2;20;058;Carbes;230;7;237
76;Occitanie;81;1;02;059;Carlus;669;15;684
76;Occitanie;81;1;97;060;Carmaux;9782;156;9938
76;Occitanie;81;1;10;061;Castanet;191;2;193
76;Occitanie;81;2;14;062;Fontrieu;935;18;953
76;Occitanie;81;1;03;063;Castelnau-de-Lévis;1621;38;1659
76;Occitanie;81;1;23;064;Castelnau-de-Montmiral;1041;25;1066
76;Occitanie;81;2;98;065;Castres;42079;1470;43549
76;Occitanie;81;2;16;066;Caucalières;280;6;286
76;Occitanie;81;1;10;067;Cestayrols;469;16;485
76;Occitanie;81;1;06;068;Combefa;153;6;159
76;Occitanie;81;1;06;069;Cordes-sur-Ciel;822;39;861
76;Occitanie;81;1;21;070;Coufouleux;2939;54;2993
76;Occitanie;81;1;05;071;Courris;79;3;82
76;Occitanie;81;1;05;072;Crespin;134;3;137
76;Occitanie;81;1;05;073;Crespinet;177;1;178
76;Occitanie;81;1;22;074;Cunac;1607;62;1669
76;Occitanie;81;2;20;075;Cuq;502;11;513
76;Occitanie;81;2;15;076;Cuq-Toulza;698;20;718
76;Occitanie;81;1;13;077;Curvalle;399;10;409
76;Occitanie;81;2;20;078;Damiatte;1028;18;1046
76;Occitanie;81;1;22;079;Dénat;803;33;836
76;Occitanie;81;1;06;080;Donnazac;71;2;73
76;Occitanie;81;2;18;081;Dourgne;1311;36;1347
76;Occitanie;81;1;05;082;Le Dourn;111;1;112
76;Occitanie;81;2;18;083;Durfort;246;1;247
76;Occitanie;81;2;18;084;Escoussens;614;21;635
76;Occitanie;81;2;14;085;Escroux;45;1;46
76;Occitanie;81;2;14;086;Espérausses;173;3;176
76;Occitanie;81;1;10;087;Fayssac;357;10;367
76;Occitanie;81;1;13;088;Fauch;554;14;568
76;Occitanie;81;1;05;089;Faussergues;136;5;141
76;Occitanie;81;1;10;090;Fénols;253;6;259
76;Occitanie;81;2;20;092;Fiac;926;15;941
76;Occitanie;81;1;10;093;Florentin;682;46;728
76;Occitanie;81;1;05;094;Fraissines;93;3;96
76;Occitanie;81;1;06;095;Frausseilles;83;1;84
76;Occitanie;81;1;13;096;Le Fraysse;410;5;415
76;Occitanie;81;1;22;097;Fréjairolles;1328;35;1363
76;Occitanie;81;2;20;098;Fréjeville;701;20;721
76;Occitanie;81;1;11;099;Gaillac;15265;323;15588
76;Occitanie;81;2;19;100;Garrevaques;402;10;412
76;Occitanie;81;1;04;101;Le Garric;1270;18;1288
76;Occitanie;81;2;21;102;Garrigues;271;14;285
76;Occitanie;81;2;14;103;Gijounet;134;7;141
76;Occitanie;81;2;21;104;Giroussens;1506;36;1542
76;Occitanie;81;2;12;105;Graulhet;12844;245;13089
76;Occitanie;81;1;23;106;Grazac;618;11;629
76;Occitanie;81;1;06;108;Itzac;168;1;169
76;Occitanie;81;2;20;109;Jonquières;438;7;445
76;Occitanie;81;1;05;110;Jouqueviel;96;3;99
76;Occitanie;81;1;06;111;Labarthe-Bleys;77;0;77
76;Occitanie;81;1;10;112;Labastide-de-Lévis;937;24;961
76;Occitanie;81;1;06;114;Labastide-Gabausse;513;12;525
76;Occitanie;81;2;17;115;Labastide-Rouairoux;1414;25;1439
76;Occitanie;81;2;15;116;Labastide-Saint-Georges;1937;46;1983
76;Occitanie;81;1;10;117;Labessière-Candeil;753;22;775
76;Occitanie;81;2;20;118;Laboulbène;152;4;156
76;Occitanie;81;1;13;119;Laboutarie;489;6;495
76;Occitanie;81;2;18;120;Labruguière;6506;114;6620
76;Occitanie;81;2;17;121;Lacabarède;298;1;299
76;Occitanie;81;1;05;122;Lacapelle-Pinet;81;2;83
76;Occitanie;81;1;06;123;Lacapelle-Ségalar;95;3;98
76;Occitanie;81;2;14;124;Lacaune;2464;77;2541
76;Occitanie;81;2;14;125;Lacaze;310;8;318
76;Occitanie;81;2;15;126;Lacougotte-Cadoul;179;8;187
76;Occitanie;81;2;15;127;Lacroisille;109;7;116
76;Occitanie;81;2;14;128;Lacrouzette;1590;35;1625
76;Occitanie;81;2;18;129;Lagardiolle;232;5;237
76;Occitanie;81;2;16;130;Lagarrigue;1818;35;1853
76;Occitanie;81;1;10;131;Lagrave;2213;41;2254
76;Occitanie;81;2;20;132;Guitalens-L'Albarède;825;12;837
76;Occitanie;81;1;13;133;Lamillarié;504;13;517
76;Occitanie;81;2;14;134;Lamontélarié;58;0;58
76;Occitanie;81;1;06;135;Laparrouquial;96;0;96
76;Occitanie;81;1;23;136;Larroque;153;3;156
76;Occitanie;81;2;14;137;Lasfaillades;87;1;88
76;Occitanie;81;1;10;138;Lasgraisses;550;9;559
76;Occitanie;81;2;20;139;Lautrec;1731;51;1782
76;Occitanie;81;2;15;140;Lavaur;10879;426;11305
76;Occitanie;81;1;05;141;Lédas-et-Penthiès;149;5;154
76;Occitanie;81;2;19;142;Lempaut;889;14;903
76;Occitanie;81;2;19;143;Lescout;731;13;744
76;Occitanie;81;1;04;144;Lescure-d'Albigeois;4574;91;4665
76;Occitanie;81;1;23;145;Lisle-sur-Tarn;4676;84;4760
76;Occitanie;81;1;06;146;Livers-Cazelles;230;5;235
76;Occitanie;81;1;13;147;Lombers;1139;14;1153
76;Occitanie;81;1;06;148;Loubers;75;6;81
76;Occitanie;81;1;21;149;Loupiac;421;15;436
76;Occitanie;81;2;21;150;Lugan;424;13;437
76;Occitanie;81;2;20;151;Magrin;128;6;134
76;Occitanie;81;1;03;152;Mailhoc;319;3;322
76;Occitanie;81;1;06;154;Marnaves;76;1;77
76;Occitanie;81;1;03;156;Marssac-sur-Tarn;3395;79;3474
76;Occitanie;81;2;15;157;Marzens;312;11;323
76;Occitanie;81;2;14;158;Le Masnau-Massuguiès;265;6;271
76;Occitanie;81;2;15;159;Massac-Séran;405;18;423
76;Occitanie;81;2;18;160;Massaguel;372;8;380
76;Occitanie;81;1;13;161;Massals;108;1;109
76;Occitanie;81;2;15;162;Maurens-Scopont;162;2;164
76;Occitanie;81;2;99;163;Mazamet;9996;422;10418
76;Occitanie;81;1;23;164;Mézens;509;12;521
76;Occitanie;81;1;06;165;Milhars;247;3;250
76;Occitanie;81;1;03;166;Milhavet;91;3;94
76;Occitanie;81;1;13;167;Miolles;105;1;106
76;Occitanie;81;1;05;168;Mirandol-Bourgnounac;1046;22;1068
76;Occitanie;81;2;12;169;Missècle;98;1;99
76;Occitanie;81;1;06;170;Monestiés;1358;13;1371
76;Occitanie;81;1;10;171;Montans;1513;32;1545
76;Occitanie;81;1;05;172;Montauriol;59;0;59
76;Occitanie;81;2;15;173;Montcabrier;319;7;326
76;Occitanie;81;2;20;174;Montdragon;623;6;629
76;Occitanie;81;1;23;175;Montdurausse;441;5;446
76;Occitanie;81;1;23;176;Montels;104;5;109
76;Occitanie;81;2;08;177;Montfa;493;6;499
76;Occitanie;81;1;23;178;Montgaillard;367;13;380
76;Occitanie;81;2;15;179;Montgey;280;8;288
76;Occitanie;81;1;06;180;Montirat;249;9;258
76;Occitanie;81;2;20;181;Montpinier;190;4;194
76;Occitanie;81;2;13;182;Montredon-Labessonnié;1987;42;2029
76;Occitanie;81;2;13;183;Mont-Roc;188;6;194
76;Occitanie;81;1;06;184;Montrosier;35;0;35
76;Occitanie;81;1;23;185;Montvalen;237;3;240
76;Occitanie;81;1;05;186;Moularès;262;5;267
76;Occitanie;81;2;12;187;Moulayrès;211;3;214
76;Occitanie;81;2;14;188;Moulin-Mage;316;3;319
76;Occitanie;81;2;15;189;Mouzens;126;2;128
76;Occitanie;81;1;13;190;Mouzieys-Teulet;534;9;543
76;Occitanie;81;1;06;191;Mouzieys-Panens;236;1;237
76;Occitanie;81;2;14;192;Murat-sur-Vèbre;862;12;874
76;Occitanie;81;2;14;193;Nages;338;4;342
76;Occitanie;81;2;09;195;Navès;691;23;714
76;Occitanie;81;2;16;196;Noailhac;850;21;871
76;Occitanie;81;1;06;197;Noailles;213;4;217
76;Occitanie;81;1;13;198;Orban;329;4;333
76;Occitanie;81;1;05;199;Padiès;189;3;192
76;Occitanie;81;2;19;200;Palleville;433;52;485
76;Occitanie;81;1;05;201;Pampelonne;840;20;860
76;Occitanie;81;1;10;202;Parisot;960;18;978
76;Occitanie;81;1;13;203;Paulinet;559;8;567
76;Occitanie;81;2;16;204;Payrin-Augmontel;2170;37;2207
76;Occitanie;81;2;15;205;Péchaudier;193;9;202
76;Occitanie;81;1;06;206;Penne;586;19;605
76;Occitanie;81;2;20;207;Peyregoux;78;29;107
76;Occitanie;81;1;10;208;Peyrole;594;11;605
76;Occitanie;81;2;17;209;Pont-de-Larn;2775;79;2854
76;Occitanie;81;2;19;210;Poudis;261;7;268
76;Occitanie;81;1;13;211;Poulan-Pouzols;495;10;505
76;Occitanie;81;2;20;212;Prades;125;4;129
76;Occitanie;81;2;20;213;Pratviel;89;2;91
76;Occitanie;81;2;15;214;Puéchoursi;101;1;102
76;Occitanie;81;2;12;215;Puybegon;638;9;647
76;Occitanie;81;2;20;216;Puycalvel;213;3;216
76;Occitanie;81;1;23;217;Puycelsi;452;11;463
76;Occitanie;81;1;02;218;Puygouzon;3510;80;3590
76;Occitanie;81;2;19;219;Puylaurens;3160;72;3232
76;Occitanie;81;1;23;220;Rabastens;5713;146;5859
76;Occitanie;81;2;13;221;Rayssac;236;1;237
76;Occitanie;81;1;13;222;Réalmont;3480;58;3538
76;Occitanie;81;2;17;223;Le Rialet;54;0;54
76;Occitanie;81;1;06;224;Le Riols;101;0;101
76;Occitanie;81;1;10;225;Rivières;1064;30;1094
76;Occitanie;81;2;08;227;Roquecourbe;2187;46;2233
76;Occitanie;81;1;23;228;Roquemaure;458;10;468
76;Occitanie;81;2;15;229;Roquevidal;131;4;135
76;Occitanie;81;1;05;230;Rosières;731;14;745
76;Occitanie;81;2;17;231;Rouairoux;378;7;385
76;Occitanie;81;1;02;232;Rouffiac;626;13;639
76;Occitanie;81;1;13;233;Terre-de-Bancalié;1717;27;1744
76;Occitanie;81;1;06;234;Roussayrolles;86;3;89
76;Occitanie;81;2;18;235;Saint-Affrique-les-Montagnes;723;28;751
76;Occitanie;81;2;21;236;Saint-Agnan;254;8;262
76;Occitanie;81;2;18;237;Saint-Amancet;186;3;189
76;Occitanie;81;2;17;238;Saint-Amans-Soult;1527;123;1650
76;Occitanie;81;2;17;239;Saint-Amans-Valtoret;877;12;889
76;Occitanie;81;1;13;240;Saint-André;101;4;105
76;Occitanie;81;2;18;242;Saint-Avit;260;3;263
76;Occitanie;81;1;23;243;Saint-Beauzile;133;2;135
76;Occitanie;81;1;06;244;Saint-Benoît-de-Carmaux;2094;34;2128
76;Occitanie;81;1;06;245;Saint-Christophe;124;6;130
76;Occitanie;81;1;23;246;Sainte-Cécile-du-Cayrou;111;2;113
76;Occitanie;81;1;05;247;Saint-Cirgue;208;3;211
76;Occitanie;81;2;12;248;Saint-Gauzens;889;20;909
76;Occitanie;81;1;05;249;Sainte-Gemme;925;13;938
76;Occitanie;81;2;20;250;Saint-Genest-de-Contest;281;9;290
76;Occitanie;81;2;19;251;Saint-Germain-des-Prés;932;18;950
76;Occitanie;81;2;08;252;Saint-Germier;145;1;146
76;Occitanie;81;1;05;253;Saint-Grégoire;456;7;463
76;Occitanie;81;1;05;254;Saint-Jean-de-Marcel;376;5;381
76;Occitanie;81;2;21;255;Saint-Jean-de-Rives;532;12;544
76;Occitanie;81;2;08;256;Saint-Jean-de-Vals;76;1;77
76;Occitanie;81;1;22;257;Saint-Juéry;6694;103;6797
76;Occitanie;81;2;20;258;Saint-Julien-du-Puy;439;16;455
76;Occitanie;81;1;05;259;Saint-Julien-Gaulène;223;1;224
76;Occitanie;81;2;21;261;Saint-Lieux-lès-Lavaur;1121;18;1139
76;Occitanie;81;1;06;262;Saint-Marcel-Campes;213;2;215
76;Occitanie;81;1;06;263;Saint-Martin-Laguépie;390;11;401
76;Occitanie;81;1;05;264;Saint-Michel-Labadié;90;2;92
76;Occitanie;81;1;06;265;Saint-Michel-de-Vax;77;1;78
76;Occitanie;81;2;20;266;Saint-Paul-Cap-de-Joux;1084;28;1112
76;Occitanie;81;2;14;267;Saint-Pierre-de-Trivisy;618;12;630
76;Occitanie;81;2;14;268;Saint-Salvi-de-Carcavès;75;4;79
76;Occitanie;81;2;08;269;Saint-Salvy-de-la-Balme;510;8;518
76;Occitanie;81;2;19;270;Saint-Sernin-lès-Lavaur;167;3;170
76;Occitanie;81;2;21;271;Saint-Sulpice-la-Pointe;9336;268;9604
76;Occitanie;81;1;23;272;Saint-Urcisse;217;1;218
76;Occitanie;81;2;19;273;Saïx;3602;72;3674
76;Occitanie;81;1;02;274;Saliès;836;18;854
76;Occitanie;81;1;06;275;Salles;195;2;197
76;Occitanie;81;1;23;276;Salvagnac;1223;19;1242
76;Occitanie;81;1;05;277;Saussenac;596;9;605
76;Occitanie;81;2;17;278;Sauveterre;161;2;163
76;Occitanie;81;1;23;279;La Sauzière-Saint-Jean;261;8;269
76;Occitanie;81;1;06;280;Le Ségur;262;7;269
76;Occitanie;81;2;20;281;Sémalens;2008;55;2063
76;Occitanie;81;2;14;282;Senaux;34;0;34
76;Occitanie;81;1;10;283;Senouillac;1115;33;1148
76;Occitanie;81;1;02;284;Le Sequestre;1917;29;1946
76;Occitanie;81;1;05;285;Sérénac;487;2;489
76;Occitanie;81;2;20;286;Serviès;612;20;632
76;Occitanie;81;1;13;287;Sieurac;264;2;266
76;Occitanie;81;2;18;288;Sorèze;2903;64;2967
76;Occitanie;81;2;19;289;Soual;2622;41;2663
76;Occitanie;81;1;06;290;Souel;165;2;167
76;Occitanie;81;1;06;291;Taïx;504;6;510
76;Occitanie;81;1;05;292;Tanus;531;18;549
76;Occitanie;81;1;23;293;Tauriac;356;3;359
76;Occitanie;81;1;10;294;Técou;1002;18;1020
76;Occitanie;81;1;13;295;Teillet;441;6;447
76;Occitanie;81;1;03;297;Terssac;1229;29;1258
76;Occitanie;81;2;15;298;Teulat;483;13;496
76;Occitanie;81;2;20;299;Teyssode;382;16;398
76;Occitanie;81;1;06;300;Tonnac;98;2;100
76;Occitanie;81;1;05;302;Tréban;52;1;53
76;Occitanie;81;1;05;303;Trébas;410;4;414
76;Occitanie;81;1;06;304;Trévien;184;4;188
76;Occitanie;81;2;14;305;Vabre;738;19;757
76;Occitanie;81;1;05;306;Valderiès;840;23;863
76;Occitanie;81;2;16;307;Valdurenque;857;18;875
76;Occitanie;81;1;05;308;Valence-d'Albigeois;1299;27;1326
76;Occitanie;81;1;06;309;Vaour;303;15;318
76;Occitanie;81;2;15;310;Veilhes;163;4;167
76;Occitanie;81;2;20;311;Vénès;759;20;779
76;Occitanie;81;2;18;312;Verdalle;1009;173;1182
76;Occitanie;81;1;23;313;Le Verdier;229;6;235
76;Occitanie;81;2;14;314;Viane;531;39;570
76;Occitanie;81;2;20;315;Vielmur-sur-Agout;1421;48;1469
76;Occitanie;81;1;23;316;Vieux;226;3;229
76;Occitanie;81;1;13;317;Villefranche-d'Albigeois;1248;30;1278
76;Occitanie;81;2;15;318;Villeneuve-lès-Lavaur;141;2;143
76;Occitanie;81;1;03;319;Villeneuve-sur-Vère;493;14;507
76;Occitanie;81;1;06;320;Vindrac-Alayrac;149;5;154
76;Occitanie;81;2;17;321;Le Vintrou;89;1;90
76;Occitanie;81;1;06;322;Virac;245;6;251
76;Occitanie;81;2;20;323;Viterbe;360;6;366
76;Occitanie;81;2;15;324;Viviers-lès-Lavaur;226;5;231
76;Occitanie;81;2;19;325;Viviers-lès-Montagnes;1968;39;2007
76;Occitanie;81;1;03;326;Sainte-Croix;386;13;399
76;Occitanie;82;1;09;001;Albefeuille-Lagarde;627;18;645
76;Occitanie;82;2;11;002;Albias;3294;58;3352
76;Occitanie;82;1;02;003;Angeville;249;5;254
76;Occitanie;82;1;04;004;Asques;135;0;135
76;Occitanie;82;2;15;005;Aucamville;1504;20;1524
76;Occitanie;82;1;02;006;Auterive;84;2;86
76;Occitanie;82;2;11;007;Auty;144;1;145
76;Occitanie;82;1;04;008;Auvillar;914;42;956
76;Occitanie;82;1;04;009;Balignac;40;2;42
76;Occitanie;82;1;04;010;Bardigues;260;5;265
76;Occitanie;82;1;03;011;Barry-d'Islemade;941;14;955
76;Occitanie;82;1;03;012;Les Barthes;564;8;572
76;Occitanie;82;1;02;013;Beaumont-de-Lomagne;3773;174;3947
76;Occitanie;82;2;15;014;Beaupuy;257;6;263
76;Occitanie;82;1;02;015;Belbèze-en-Lomagne;149;4;153
76;Occitanie;82;1;10;016;Belvèze;215;2;217
76;Occitanie;82;2;09;017;Bessens;1487;25;1512
76;Occitanie;82;2;01;018;Bioule;1148;30;1178
76;Occitanie;82;1;14;019;Boudou;751;17;768
76;Occitanie;82;2;15;020;Bouillac;594;14;608
76;Occitanie;82;1;10;021;Bouloc-en-Quercy;193;3;196
76;Occitanie;82;1;14;022;Bourg-de-Visa;382;10;392
76;Occitanie;82;2;02;023;Bourret;959;11;970
76;Occitanie;82;1;14;024;Brassac;248;3;251
76;Occitanie;82;2;09;025;Bressols;3697;104;3801
76;Occitanie;82;2;13;026;Bruniquel;600;9;609
76;Occitanie;82;2;15;027;Campsas;1405;23;1428
76;Occitanie;82;2;15;028;Canals;793;11;804
76;Occitanie;82;2;12;029;Castanet;281;3;284
76;Occitanie;82;1;02;030;Castelferrus;491;4;495
76;Occitanie;82;1;04;031;Castelmayran;1222;17;1239
76;Occitanie;82;1;14;032;Castelsagrat;542;13;555
76;Occitanie;82;1;03;033;Castelsarrasin;14114;323;14437
76;Occitanie;82;1;04;034;Castéra-Bouzet;108;3;111
76;Occitanie;82;1;04;035;Caumont;335;9;344
76;Occitanie;82;1;02;036;Le Causé;135;2;137
76;Occitanie;82;2;01;037;Caussade;6808;202;7010
76;Occitanie;82;2;12;038;Caylus;1473;28;1501
76;Occitanie;82;2;11;039;Cayrac;555;22;577
76;Occitanie;82;2;12;040;Cayriech;280;9;289
76;Occitanie;82;2;12;041;Cazals;233;3;236
76;Occitanie;82;1;10;042;Cazes-Mondenard;1192;21;1213
76;Occitanie;82;2;02;043;Comberouger;269;10;279
76;Occitanie;82;2;13;044;Corbarieu;1647;50;1697
76;Occitanie;82;1;02;045;Cordes-Tolosannes;354;6;360
76;Occitanie;82;1;02;046;Coutures;114;0;114
76;Occitanie;82;1;02;047;Cumont;51;0;51
76;Occitanie;82;2;15;048;Dieupentale;1650;14;1664
76;Occitanie;82;1;04;049;Donzac;1034;13;1047
76;Occitanie;82;1;04;050;Dunes;1208;24;1232
76;Occitanie;82;1;10;051;Durfort-Lacapelette;841;90;931
76;Occitanie;82;2;02;052;Escatalens;1114;106;1220
76;Occitanie;82;1;02;053;Escazeaux;288;3;291
76;Occitanie;82;1;14;054;Espalais;382;7;389
76;Occitanie;82;1;02;055;Esparsac;255;8;263
76;Occitanie;82;2;12;056;Espinas;173;4;177
76;Occitanie;82;2;15;057;Fabas;658;15;673
76;Occitanie;82;1;02;058;Fajolles;100;2;102
76;Occitanie;82;1;02;059;Faudoas;290;10;300
76;Occitanie;82;1;10;060;Fauroux;194;4;198
76;Occitanie;82;2;12;061;Féneyrols;142;2;144
76;Occitanie;82;2;09;062;Finhan;1546;19;1565
76;Occitanie;82;1;02;063;Garganvillar;679;13;692
76;Occitanie;82;1;02;064;Gariès;121;0;121
76;Occitanie;82;1;14;065;Gasques;409;10;419
76;Occitanie;82;2;13;066;Génébrières;609;13;622
76;Occitanie;82;1;04;067;Gensac;107;1;108
76;Occitanie;82;1;02;068;Gimat;240;6;246
76;Occitanie;82;2;12;069;Ginals;202;6;208
76;Occitanie;82;1;02;070;Glatens;73;2;75
76;Occitanie;82;1;02;071;Goas;37;2;39
76;Occitanie;82;1;14;072;Golfech;1014;27;1041
76;Occitanie;82;1;14;073;Goudourville;937;31;968
76;Occitanie;82;1;04;074;Gramont;133;5;138
76;Occitanie;82;2;15;075;Grisolles;4177;56;4233
76;Occitanie;82;2;11;076;L'Honor-de-Cos;1587;35;1622
76;Occitanie;82;2;10;077;Labarthe;400;5;405
76;Occitanie;82;2;12;078;Labastide-de-Penne;128;0;128
76;Occitanie;82;2;13;079;Labastide-Saint-Pierre;3783;80;3863
76;Occitanie;82;1;03;080;Labastide-du-Temple;1143;27;1170
76;Occitanie;82;1;02;081;Labourgade;194;2;196
76;Occitanie;82;2;12;082;Lacapelle-Livron;196;5;201
76;Occitanie;82;1;04;083;Lachapelle;118;1;119
76;Occitanie;82;1;10;084;Lacour;168;5;173
76;Occitanie;82;2;09;085;Lacourt-Saint-Pierre;1239;11;1250
76;Occitanie;82;1;02;086;Lafitte;221;3;224
76;Occitanie;82;2;10;087;Lafrançaise;2835;65;2900
76;Occitanie;82;2;12;088;Laguépie;604;13;617
76;Occitanie;82;1;14;089;Lamagistère;1167;18;1185
76;Occitanie;82;2;11;090;Lamothe-Capdeville;1052;28;1080
76;Occitanie;82;1;02;091;Lamothe-Cumont;126;3;129
76;Occitanie;82;2;12;092;Lapenche;284;4;288
76;Occitanie;82;1;02;093;Larrazet;693;8;701
76;Occitanie;82;1;10;094;Lauzerte;1454;17;1471
76;Occitanie;82;2;12;095;Lavaurette;217;13;230
76;Occitanie;82;2;03;096;La Ville-Dieu-du-Temple;3148;44;3192
76;Occitanie;82;1;04;097;Lavit;1619;18;1637
76;Occitanie;82;2;13;098;Léojac;1269;28;1297
76;Occitanie;82;1;05;099;Lizac;529;7;536
76;Occitanie;82;2;12;100;Loze;132;7;139
76;Occitanie;82;1;04;101;Malause;1199;17;1216
76;Occitanie;82;1;04;102;Mansonville;294;4;298
76;Occitanie;82;1;02;103;Marignac;107;6;113
76;Occitanie;82;1;04;104;Marsac;186;5;191
76;Occitanie;82;2;15;105;Mas-Grenier;1342;18;1360
76;Occitanie;82;1;02;106;Maubec;137;1;138
76;Occitanie;82;1;04;107;Maumusson;46;1;47
76;Occitanie;82;1;03;108;Meauzac;1360;29;1389
76;Occitanie;82;1;04;109;Merles;201;13;214
76;Occitanie;82;2;11;110;Mirabel;1037;18;1055
76;Occitanie;82;1;10;111;Miramont-de-Quercy;316;9;325
76;Occitanie;82;1;05;112;Moissac;13378;319;13697
76;Occitanie;82;2;11;113;Molières;1182;25;1207
76;Occitanie;82;2;09;114;Monbéqui;645;7;652
76;Occitanie;82;2;13;115;Monclar-de-Quercy;2004;18;2022
76;Occitanie;82;1;10;116;Montagudet;194;4;198
76;Occitanie;82;1;10;117;Montaigu-de-Quercy;1302;25;1327
76;Occitanie;82;1;02;118;Montaïn;100;1;101
76;Occitanie;82;2;11;119;Montalzat;654;18;672
76;Occitanie;82;2;11;120;Montastruc;295;5;300
76;Occitanie;82;2;99;121;Montauban;61372;1460;62832
76;Occitanie;82;1;10;122;Montbarla;183;3;186
76;Occitanie;82;2;09;123;Montbartier;1474;22;1496
76;Occitanie;82;2;09;124;Montbeton;4241;87;4328
76;Occitanie;82;2;09;125;Montech;6589;127;6716
76;Occitanie;82;2;12;126;Monteils;1359;102;1461
76;Occitanie;82;1;05;127;Montesquieu;758;19;777
76;Occitanie;82;2;11;128;Montfermier;106;3;109
76;Occitanie;82;1;04;129;Montgaillard;145;4;149
76;Occitanie;82;1;14;130;Montjoi;166;1;167
76;Occitanie;82;2;11;131;Montpezat-de-Quercy;1590;41;1631
76;Occitanie;82;2;01;132;Montricoux;1186;27;1213
76;Occitanie;82;2;12;133;Mouillac;93;1;94
76;Occitanie;82;2;01;134;Nègrepelisse;5685;81;5766
76;Occitanie;82;2;13;135;Nohic;1340;18;1358
76;Occitanie;82;2;13;136;Orgueil;1754;34;1788
76;Occitanie;82;2;12;137;Parisot;570;11;581
76;Occitanie;82;1;14;138;Perville;162;2;164
76;Occitanie;82;1;04;139;Le Pin;121;3;124
76;Occitanie;82;2;11;140;Piquecos;444;3;447
76;Occitanie;82;1;14;141;Pommevic;546;4;550
76;Occitanie;82;2;15;142;Pompignan;1544;20;1564
76;Occitanie;82;1;04;143;Poupas;85;0;85
76;Occitanie;82;2;10;144;Puycornet;746;11;757
76;Occitanie;82;2;13;145;Puygaillard-de-Quercy;379;8;387
76;Occitanie;82;1;04;146;Puygaillard-de-Lomagne;60;2;62
76;Occitanie;82;2;12;147;Puylagarde;331;8;339
76;Occitanie;82;2;12;148;Puylaroque;694;25;719
76;Occitanie;82;2;11;149;Réalville;1879;32;1911
76;Occitanie;82;2;13;150;Reyniès;862;24;886
76;Occitanie;82;1;10;151;Roquecor;401;9;410
76;Occitanie;82;1;04;152;Saint-Aignan;398;11;409
76;Occitanie;82;1;10;153;Saint-Amans-du-Pech;226;1;227
76;Occitanie;82;1;10;154;Saint-Amans-de-Pellagal;212;5;217
76;Occitanie;82;2;12;155;Saint-Antonin-Noble-Val;1851;46;1897
76;Occitanie;82;1;02;156;Saint-Arroumex;148;3;151
76;Occitanie;82;1;10;157;Saint-Beauzeil;96;2;98
76;Occitanie;82;1;04;158;Saint-Cirice;147;6;153
76;Occitanie;82;2;12;159;Saint-Cirq;557;17;574
76;Occitanie;82;1;14;160;Saint-Clair;264;8;272
76;Occitanie;82;2;01;161;Saint-Étienne-de-Tulmont;3901;78;3979
76;Occitanie;82;2;12;162;Saint-Georges;261;7;268
76;Occitanie;82;1;04;163;Saint-Jean-du-Bouzet;49;0;49
76;Occitanie;82;1;10;164;Sainte-Juliette;126;3;129
76;Occitanie;82;1;04;165;Saint-Loup;531;4;535
76;Occitanie;82;1;04;166;Saint-Michel;276;3;279
76;Occitanie;82;2;13;167;Saint-Nauphary;1875;41;1916
76;Occitanie;82;1;14;168;Saint-Nazaire-de-Valentane;323;3;326
76;Occitanie;82;1;04;169;Saint-Nicolas-de-la-Grave;2296;30;2326
76;Occitanie;82;1;14;170;Saint-Paul-d'Espis;566;18;584
76;Occitanie;82;2;02;171;Saint-Porquier;1414;24;1438
76;Occitanie;82;2;12;172;Saint-Projet;278;8;286
76;Occitanie;82;2;15;173;Saint-Sardos;1155;14;1169
76;Occitanie;82;2;11;174;Saint-Vincent-d'Autéjac;285;2;287
76;Occitanie;82;1;14;175;Saint-Vincent-Lespinasse;277;4;281
76;Occitanie;82;2;13;176;La Salvetat-Belmontet;856;13;869
76;Occitanie;82;1;10;177;Sauveterre;160;3;163
76;Occitanie;82;2;15;178;Savenès;811;17;828
76;Occitanie;82;2;12;179;Septfonds;2238;50;2288
76;Occitanie;82;1;02;180;Sérignac;526;8;534
76;Occitanie;82;1;04;181;Sistels;207;4;211
76;Occitanie;82;1;10;182;Touffailles;339;3;342
76;Occitanie;82;1;10;183;Tréjouls;238;10;248
76;Occitanie;82;2;01;184;Vaïssac;896;10;906
76;Occitanie;82;1;10;185;Valeilles;248;6;254
76;Occitanie;82;1;14;186;Valence;5205;153;5358
76;Occitanie;82;2;12;187;Varen;654;13;667
76;Occitanie;82;2;13;188;Varennes;632;14;646
76;Occitanie;82;2;10;189;Vazerac;743;14;757
76;Occitanie;82;2;15;190;Verdun-sur-Garonne;4808;67;4875
76;Occitanie;82;2;12;191;Verfeil;416;3;419
76;Occitanie;82;2;13;192;Verlhac-Tescou;522;14;536
76;Occitanie;82;1;02;193;Vigueron;137;3;140
76;Occitanie;82;2;13;194;Villebrumier;1368;35;1403
76;Occitanie;82;2;11;195;Villemade;779;13;792
93;Provence-Alpes-Côte d'Azur;83;1;14;001;Les Adrets-de-l'Estérel;2784;74;2858
93;Provence-Alpes-Côte d'Azur;83;3;04;002;Aiguines;270;5;275
93;Provence-Alpes-Côte d'Azur;83;1;04;003;Ampus;913;24;937
93;Provence-Alpes-Côte d'Azur;83;1;23;004;Les Arcs;7066;174;7240
93;Provence-Alpes-Côte d'Azur;83;3;04;005;Artignosc-sur-Verdon;288;6;294
93;Provence-Alpes-Côte d'Azur;83;3;13;006;Artigues;283;8;291
93;Provence-Alpes-Côte d'Azur;83;3;04;007;Aups;2284;37;2321
93;Provence-Alpes-Côte d'Azur;83;1;11;008;Bagnols-en-Forêt;2862;59;2921
93;Provence-Alpes-Côte d'Azur;83;2;10;009;Bandol;8403;145;8548
93;Provence-Alpes-Côte d'Azur;83;1;04;010;Bargème;225;1;226
93;Provence-Alpes-Côte d'Azur;83;1;04;011;Bargemon;1334;21;1355
93;Provence-Alpes-Côte d'Azur;83;3;13;012;Barjols;2990;39;3029
93;Provence-Alpes-Côte d'Azur;83;1;04;013;La Bastide;208;1;209
93;Provence-Alpes-Côte d'Azur;83;3;04;014;Baudinard-sur-Verdon;235;9;244
93;Provence-Alpes-Côte d'Azur;83;3;04;015;Bauduen;321;4;325
93;Provence-Alpes-Côte d'Azur;83;2;12;016;Le Beausset;9845;175;10020
93;Provence-Alpes-Côte d'Azur;83;2;18;017;Belgentier;2423;30;2453
93;Provence-Alpes-Côte d'Azur;83;3;09;018;Besse-sur-Issole;3038;44;3082
93;Provence-Alpes-Côte d'Azur;83;2;02;019;Bormes-les-Mimosas;8162;117;8279
93;Provence-Alpes-Côte d'Azur;83;1;04;020;Le Bourguet;41;1;42
93;Provence-Alpes-Côte d'Azur;83;3;13;021;Bras;2629;52;2681
93;Provence-Alpes-Côte d'Azur;83;1;04;022;Brenon;25;0;25
93;Provence-Alpes-Côte d'Azur;83;3;01;023;Brignoles;17361;345;17706
93;Provence-Alpes-Côte d'Azur;83;3;13;025;Brue-Auriac;1419;22;1441
93;Provence-Alpes-Côte d'Azur;83;3;09;026;Cabasse;1951;36;1987
93;Provence-Alpes-Côte d'Azur;83;2;12;027;La Cadière-d'Azur;5574;98;5672
93;Provence-Alpes-Côte d'Azur;83;1;04;028;Callas;1948;39;1987
93;Provence-Alpes-Côte d'Azur;83;1;11;029;Callian;3341;61;3402
93;Provence-Alpes-Côte d'Azur;83;3;07;030;Camps-la-Source;1897;47;1944
93;Provence-Alpes-Côte d'Azur;83;3;09;031;Le Cannet-des-Maures;4279;59;4338
93;Provence-Alpes-Côte d'Azur;83;3;01;032;Carcès;3380;81;3461
93;Provence-Alpes-Côte d'Azur;83;3;07;033;Carnoules;3525;36;3561
93;Provence-Alpes-Côte d'Azur;83;2;06;034;Carqueiranne;9518;163;9681
93;Provence-Alpes-Côte d'Azur;83;2;12;035;Le Castellet;3873;42;3915
93;Provence-Alpes-Côte d'Azur;83;1;15;036;Cavalaire-sur-Mer;7586;86;7672
93;Provence-Alpes-Côte d'Azur;83;3;01;037;La Celle;1483;55;1538
93;Provence-Alpes-Côte d'Azur;83;1;04;038;Châteaudouble;477;15;492
93;Provence-Alpes-Côte d'Azur;83;3;13;039;Châteauvert;147;14;161
93;Provence-Alpes-Côte d'Azur;83;1;04;040;Châteauvieux;79;1;80
93;Provence-Alpes-Côte d'Azur;83;1;04;041;Claviers;720;12;732
93;Provence-Alpes-Côte d'Azur;83;1;15;042;Cogolin;11311;238;11549
93;Provence-Alpes-Côte d'Azur;83;2;09;043;Collobrières;1874;89;1963
93;Provence-Alpes-Côte d'Azur;83;1;04;044;Comps-sur-Artuby;328;5;333
93;Provence-Alpes-Côte d'Azur;83;3;01;045;Correns;906;8;914
93;Provence-Alpes-Côte d'Azur;83;3;01;046;Cotignac;2111;39;2150
93;Provence-Alpes-Côte d'Azur;83;2;02;047;La Crau;18774;428;19202
93;Provence-Alpes-Côte d'Azur;83;1;15;048;La Croix-Valmer;3779;96;3875
93;Provence-Alpes-Côte d'Azur;83;2;18;049;Cuers;11962;139;12101
93;Provence-Alpes-Côte d'Azur;83;1;03;050;Draguignan;39433;911;40344
93;Provence-Alpes-Côte d'Azur;83;3;01;051;Entrecasteaux;1118;23;1141
93;Provence-Alpes-Côte d'Azur;83;3;13;052;Esparron;371;5;376
93;Provence-Alpes-Côte d'Azur;83;2;10;053;Évenos;2416;51;2467
93;Provence-Alpes-Côte d'Azur;83;2;18;054;La Farlède;9614;118;9732
93;Provence-Alpes-Côte d'Azur;83;1;11;055;Fayence;5735;85;5820
93;Provence-Alpes-Côte d'Azur;83;1;04;056;Figanières;2623;53;2676
93;Provence-Alpes-Côte d'Azur;83;3;09;057;Flassans-sur-Issole;3564;67;3631
93;Provence-Alpes-Côte d'Azur;83;1;04;058;Flayosc;4247;104;4351
93;Provence-Alpes-Côte d'Azur;83;3;07;059;Forcalqueiret;3101;47;3148
93;Provence-Alpes-Côte d'Azur;83;3;04;060;Fox-Amphoux;458;4;462
93;Provence-Alpes-Côte d'Azur;83;1;96;061;Fréjus;54458;843;55301
93;Provence-Alpes-Côte d'Azur;83;2;06;062;La Garde;25505;313;25818
93;Provence-Alpes-Côte d'Azur;83;1;09;063;La Garde-Freinet;1847;42;1889
93;Provence-Alpes-Côte d'Azur;83;3;07;064;Garéoult;5303;99;5402
93;Provence-Alpes-Côte d'Azur;83;1;15;065;Gassin;2614;55;2669
93;Provence-Alpes-Côte d'Azur;83;3;13;066;Ginasservis;1874;35;1909
93;Provence-Alpes-Côte d'Azur;83;3;09;067;Gonfaron;4329;60;4389
93;Provence-Alpes-Côte d'Azur;83;1;15;068;Grimaud;4562;60;4622
93;Provence-Alpes-Côte d'Azur;83;2;97;069;Hyères;54821;977;55798
93;Provence-Alpes-Côte d'Azur;83;2;02;070;Le Lavandou;5985;60;6045
93;Provence-Alpes-Côte d'Azur;83;2;02;071;La Londe-les-Maures;10641;135;10776
93;Provence-Alpes-Côte d'Azur;83;1;23;072;Lorgues;9054;292;9346
93;Provence-Alpes-Côte d'Azur;83;3;09;073;Le Luc;11094;112;11206
93;Provence-Alpes-Côte d'Azur;83;1;04;074;La Martre;204;5;209
93;Provence-Alpes-Côte d'Azur;83;3;09;075;Les Mayons;631;8;639
93;Provence-Alpes-Côte d'Azur;83;3;07;076;Mazaugues;868;13;881
93;Provence-Alpes-Côte d'Azur;83;3;07;077;Méounes-lès-Montrieux;2226;20;2246
93;Provence-Alpes-Côte d'Azur;83;3;04;078;Moissac-Bellevue;290;7;297
93;Provence-Alpes-Côte d'Azur;83;1;15;079;La Môle;1461;25;1486
93;Provence-Alpes-Côte d'Azur;83;1;11;080;Mons;806;15;821
93;Provence-Alpes-Côte d'Azur;83;1;11;081;Montauroux;6548;132;6680
93;Provence-Alpes-Côte d'Azur;83;1;04;082;Montferrat;1527;22;1549
93;Provence-Alpes-Côte d'Azur;83;3;01;083;Montfort-sur-Argens;1420;26;1446
93;Provence-Alpes-Côte d'Azur;83;3;04;084;Montmeyan;533;3;536
93;Provence-Alpes-Côte d'Azur;83;1;04;085;La Motte;2804;52;2856
93;Provence-Alpes-Côte d'Azur;83;1;23;086;Le Muy;9288;249;9537
93;Provence-Alpes-Côte d'Azur;83;3;12;087;Nans-les-Pins;4835;85;4920
93;Provence-Alpes-Côte d'Azur;83;3;07;088;Néoules;2828;68;2896
93;Provence-Alpes-Côte d'Azur;83;3;13;089;Ollières;650;23;673
93;Provence-Alpes-Côte d'Azur;83;2;10;090;Ollioules;13866;253;14119
93;Provence-Alpes-Côte d'Azur;83;2;07;091;Pierrefeu-du-Var;6068;105;6173
93;Provence-Alpes-Côte d'Azur;83;3;09;092;Pignans;4588;47;4635
93;Provence-Alpes-Côte d'Azur;83;3;12;093;Plan-d'Aups-Sainte-Baume;2187;27;2214
93;Provence-Alpes-Côte d'Azur;83;1;15;094;Le Plan-de-la-Tour;3048;52;3100
93;Provence-Alpes-Côte d'Azur;83;3;13;095;Pontevès;737;18;755
93;Provence-Alpes-Côte d'Azur;83;3;13;096;Pourcieux;1574;22;1596
93;Provence-Alpes-Côte d'Azur;83;3;13;097;Pourrières;5181;91;5272
93;Provence-Alpes-Côte d'Azur;83;2;06;098;Le Pradet;10277;149;10426
93;Provence-Alpes-Côte d'Azur;83;1;11;099;Puget-sur-Argens;8062;108;8170
93;Provence-Alpes-Côte d'Azur;83;3;07;100;Puget-Ville;4357;51;4408
93;Provence-Alpes-Côte d'Azur;83;1;15;101;Ramatuelle;2115;48;2163
93;Provence-Alpes-Côte d'Azur;83;3;04;102;Régusse;2642;16;2658
93;Provence-Alpes-Côte d'Azur;83;2;21;103;Le Revest-les-Eaux;3962;59;4021
93;Provence-Alpes-Côte d'Azur;83;3;13;104;Rians;4278;85;4363
93;Provence-Alpes-Côte d'Azur;83;2;12;105;Riboux;49;0;49
93;Provence-Alpes-Côte d'Azur;83;3;07;106;Rocbaron;5250;68;5318
93;Provence-Alpes-Côte d'Azur;83;1;11;107;Roquebrune-sur-Argens;14937;191;15128
93;Provence-Alpes-Côte d'Azur;83;3;07;108;La Roquebrussanne;2203;41;2244
93;Provence-Alpes-Côte d'Azur;83;1;04;109;La Roque-Esclapon;256;0;256
93;Provence-Alpes-Côte d'Azur;83;3;01;110;Rougiers;1662;30;1692
93;Provence-Alpes-Côte d'Azur;83;3;07;111;Sainte-Anastasie-sur-Issole;2048;25;2073
93;Provence-Alpes-Côte d'Azur;83;2;12;112;Saint-Cyr-sur-Mer;11484;241;11725
93;Provence-Alpes-Côte d'Azur;83;3;13;113;Saint-Julien;2402;41;2443
93;Provence-Alpes-Côte d'Azur;83;3;13;114;Saint-Martin-de-Pallières;247;4;251
93;Provence-Alpes-Côte d'Azur;83;1;15;115;Sainte-Maxime;14448;224;14672
93;Provence-Alpes-Côte d'Azur;83;3;13;116;Saint-Maximin-la-Sainte-Baume;17095;497;17592
93;Provence-Alpes-Côte d'Azur;83;1;11;117;Saint-Paul-en-Forêt;1757;42;1799
93;Provence-Alpes-Côte d'Azur;83;1;14;118;Saint-Raphaël;36027;601;36628
93;Provence-Alpes-Côte d'Azur;83;1;15;119;Saint-Tropez;3851;71;3922
93;Provence-Alpes-Côte d'Azur;83;3;12;120;Saint-Zacharie;6051;83;6134
93;Provence-Alpes-Côte d'Azur;83;1;04;121;Salernes;3761;77;3838
93;Provence-Alpes-Côte d'Azur;83;3;04;122;Les Salles-sur-Verdon;226;4;230
93;Provence-Alpes-Côte d'Azur;83;2;10;123;Sanary-sur-Mer;16889;271;17160
93;Provence-Alpes-Côte d'Azur;83;1;11;124;Seillans;2669;33;2702
93;Provence-Alpes-Côte d'Azur;83;3;13;125;Seillons-Source-d'Argens;2492;38;2530
93;Provence-Alpes-Côte d'Azur;83;2;98;126;La Seyne-sur-Mer;62987;762;63749
93;Provence-Alpes-Côte d'Azur;83;2;12;127;Signes;2927;44;2971
93;Provence-Alpes-Côte d'Azur;83;1;04;128;Sillans-la-Cascade;745;55;800
93;Provence-Alpes-Côte d'Azur;83;2;17;129;Six-Fours-les-Plages;34592;562;35154
93;Provence-Alpes-Côte d'Azur;83;2;18;130;Solliès-Pont;11762;184;11946
93;Provence-Alpes-Côte d'Azur;83;2;18;131;Solliès-Toucas;5753;108;5861
93;Provence-Alpes-Côte d'Azur;83;2;18;132;Solliès-Ville;2526;46;2572
93;Provence-Alpes-Côte d'Azur;83;1;11;133;Tanneron;1671;33;1704
93;Provence-Alpes-Côte d'Azur;83;1;23;134;Taradeau;1784;33;1817
93;Provence-Alpes-Côte d'Azur;83;3;04;135;Tavernes;1405;16;1421
93;Provence-Alpes-Côte d'Azur;83;3;09;136;Le Thoronet;2552;47;2599
93;Provence-Alpes-Côte d'Azur;83;2;99;137;Toulon;178745;1896;180641
93;Provence-Alpes-Côte d'Azur;83;1;11;138;Tourrettes;2877;51;2928
93;Provence-Alpes-Côte d'Azur;83;3;04;139;Tourtour;585;15;600
93;Provence-Alpes-Côte d'Azur;83;3;01;140;Tourves;5042;71;5113
93;Provence-Alpes-Côte d'Azur;83;1;03;141;Trans-en-Provence;5947;134;6081
93;Provence-Alpes-Côte d'Azur;83;1;04;142;Trigance;203;5;208
93;Provence-Alpes-Côte d'Azur;83;3;01;143;Le Val;4292;95;4387
93;Provence-Alpes-Côte d'Azur;83;2;21;144;La Valette-du-Var;24087;259;24346
93;Provence-Alpes-Côte d'Azur;83;3;13;145;Varages;1176;15;1191
93;Provence-Alpes-Côte d'Azur;83;3;13;146;La Verdière;1603;13;1616
93;Provence-Alpes-Côte d'Azur;83;3;04;147;Vérignon;9;0;9
93;Provence-Alpes-Côte d'Azur;83;1;23;148;Vidauban;12616;144;12760
93;Provence-Alpes-Côte d'Azur;83;3;04;149;Villecroze;1466;28;1494
93;Provence-Alpes-Côte d'Azur;83;3;13;150;Vinon-sur-Verdon;4248;88;4336
93;Provence-Alpes-Côte d'Azur;83;3;01;151;Vins-sur-Caramy;963;15;978
93;Provence-Alpes-Côte d'Azur;83;1;02;152;Rayol-Canadel-sur-Mer;667;13;680
93;Provence-Alpes-Côte d'Azur;83;2;17;153;Saint-Mandrier-sur-Mer;6095;68;6163
93;Provence-Alpes-Côte d'Azur;83;1;01;154;Saint-Antonin-du-Var;722;14;736
93;Provence-Alpes-Côte d'Azur;84;3;10;001;Althen-des-Paluds;2851;46;2897
93;Provence-Alpes-Côte d'Azur;84;1;13;002;Ansouis;1046;25;1071
93;Provence-Alpes-Côte d'Azur;84;1;01;003;Apt;11037;221;11258
93;Provence-Alpes-Côte d'Azur;84;3;06;004;Aubignan;5778;94;5872
93;Provence-Alpes-Côte d'Azur;84;3;12;005;Aurel;193;2;195
93;Provence-Alpes-Côte d'Azur;84;1;01;006;Auribeau;70;4;74
93;Provence-Alpes-Côte d'Azur;84;2;99;007;Avignon;91143;1678;92821
93;Provence-Alpes-Côte d'Azur;84;3;16;008;Le Barroux;639;50;689
93;Provence-Alpes-Côte d'Azur;84;1;13;009;La Bastide-des-Jourdans;1614;95;1709
93;Provence-Alpes-Côte d'Azur;84;1;13;010;La Bastidonne;873;22;895
93;Provence-Alpes-Côte d'Azur;84;3;12;011;Le Beaucet;355;9;364
93;Provence-Alpes-Côte d'Azur;84;3;10;012;Beaumes-de-Venise;2389;48;2437
93;Provence-Alpes-Côte d'Azur;84;1;01;013;Beaumettes;280;4;284
93;Provence-Alpes-Côte d'Azur;84;1;13;014;Beaumont-de-Pertuis;1134;16;1150
93;Provence-Alpes-Côte d'Azur;84;3;16;015;Beaumont-du-Ventoux;296;5;301
93;Provence-Alpes-Côte d'Azur;84;2;15;016;Bédarrides;5316;76;5392
93;Provence-Alpes-Côte d'Azur;84;3;12;017;Bédoin;3093;68;3161
93;Provence-Alpes-Côte d'Azur;84;3;12;018;Blauvac;518;8;526
93;Provence-Alpes-Côte d'Azur;84;3;05;019;Bollène;13439;232;13671
93;Provence-Alpes-Côte d'Azur;84;1;01;020;Bonnieux;1206;23;1229
93;Provence-Alpes-Côte d'Azur;84;3;16;021;Brantes;90;3;93
93;Provence-Alpes-Côte d'Azur;84;3;16;022;Buisson;277;12;289
93;Provence-Alpes-Côte d'Azur;84;1;01;023;Buoux;87;3;90
93;Provence-Alpes-Côte d'Azur;84;1;13;024;Cabrières-d'Aigues;957;14;971
93;Provence-Alpes-Côte d'Azur;84;1;08;025;Cabrières-d'Avignon;1835;37;1872
93;Provence-Alpes-Côte d'Azur;84;1;08;026;Cadenet;4201;77;4278
93;Provence-Alpes-Côte d'Azur;84;3;11;027;Caderousse;2651;47;2698
93;Provence-Alpes-Côte d'Azur;84;3;16;028;Cairanne;1084;20;1104
93;Provence-Alpes-Côte d'Azur;84;3;16;029;Camaret-sur-Aigues;4542;111;4653
93;Provence-Alpes-Côte d'Azur;84;3;10;030;Caromb;3399;58;3457
93;Provence-Alpes-Côte d'Azur;84;3;06;031;Carpentras;29236;713;29949
93;Provence-Alpes-Côte d'Azur;84;1;01;032;Caseneuve;493;8;501
93;Provence-Alpes-Côte d'Azur;84;1;01;033;Castellet-en-Luberon;120;0;120
93;Provence-Alpes-Côte d'Azur;84;2;07;034;Caumont-sur-Durance;4914;99;5013
93;Provence-Alpes-Côte d'Azur;84;1;07;035;Cavaillon;26236;412;26648
93;Provence-Alpes-Côte d'Azur;84;2;09;036;Châteauneuf-de-Gadagne;3321;75;3396
93;Provence-Alpes-Côte d'Azur;84;3;15;037;Châteauneuf-du-Pape;2055;30;2085
93;Provence-Alpes-Côte d'Azur;84;1;08;038;Cheval-Blanc;4290;75;4365
93;Provence-Alpes-Côte d'Azur;84;2;15;039;Courthézon;6026;76;6102
93;Provence-Alpes-Côte d'Azur;84;3;16;040;Crestet;416;16;432
93;Provence-Alpes-Côte d'Azur;84;3;12;041;Crillon-le-Brave;475;20;495
93;Provence-Alpes-Côte d'Azur;84;1;08;042;Cucuron;1771;32;1803
93;Provence-Alpes-Côte d'Azur;84;2;10;043;Entraigues-sur-la-Sorgue;8595;123;8718
93;Provence-Alpes-Côte d'Azur;84;3;16;044;Entrechaux;1134;33;1167
93;Provence-Alpes-Côte d'Azur;84;3;16;045;Faucon;450;8;458
93;Provence-Alpes-Côte d'Azur;84;3;12;046;Flassan;478;14;492
93;Provence-Alpes-Côte d'Azur;84;1;01;047;Gargas;3078;49;3127
93;Provence-Alpes-Côte d'Azur;84;1;01;048;Gignac;71;1;72
93;Provence-Alpes-Côte d'Azur;84;3;16;049;Gigondas;434;10;444
93;Provence-Alpes-Côte d'Azur;84;1;01;050;Gordes;1670;34;1704
93;Provence-Alpes-Côte d'Azur;84;1;01;051;Goult;1100;27;1127
93;Provence-Alpes-Côte d'Azur;84;1;13;052;Grambois;1226;29;1255
93;Provence-Alpes-Côte d'Azur;84;3;17;053;Grillon;1749;31;1780
93;Provence-Alpes-Côte d'Azur;84;2;09;054;L'Isle-sur-la-Sorgue;20042;493;20535
93;Provence-Alpes-Côte d'Azur;84;2;14;055;Jonquerettes;1550;37;1587
93;Provence-Alpes-Côte d'Azur;84;3;15;056;Jonquières;5469;63;5532
93;Provence-Alpes-Côte d'Azur;84;1;01;057;Joucas;347;5;352
93;Provence-Alpes-Côte d'Azur;84;1;01;058;Lacoste;423;7;430
93;Provence-Alpes-Côte d'Azur;84;3;16;059;Lafare;121;1;122
93;Provence-Alpes-Côte d'Azur;84;1;01;060;Lagarde-d'Apt;32;1;33
93;Provence-Alpes-Côte d'Azur;84;3;05;061;Lagarde-Paréol;327;13;340
93;Provence-Alpes-Côte d'Azur;84;1;08;062;Lagnes;1641;33;1674
93;Provence-Alpes-Côte d'Azur;84;3;05;063;Lamotte-du-Rhône;395;1;396
93;Provence-Alpes-Côte d'Azur;84;3;05;064;Lapalud;3830;79;3909
93;Provence-Alpes-Côte d'Azur;84;1;08;065;Lauris;3879;69;3948
93;Provence-Alpes-Côte d'Azur;84;1;01;066;Lioux;291;4;295
93;Provence-Alpes-Côte d'Azur;84;3;06;067;Loriol-du-Comtat;2520;55;2575
93;Provence-Alpes-Côte d'Azur;84;1;08;068;Lourmarin;1040;22;1062
93;Provence-Alpes-Côte d'Azur;84;3;16;069;Malaucène;2785;60;2845
93;Provence-Alpes-Côte d'Azur;84;3;12;070;Malemort-du-Comtat;1887;24;1911
93;Provence-Alpes-Côte d'Azur;84;1;08;071;Maubec;1920;48;1968
93;Provence-Alpes-Côte d'Azur;84;3;12;072;Mazan;6201;158;6359
93;Provence-Alpes-Côte d'Azur;84;1;01;073;Ménerbes;1002;17;1019
93;Provence-Alpes-Côte d'Azur;84;1;08;074;Mérindol;2189;37;2226
93;Provence-Alpes-Côte d'Azur;84;3;12;075;Méthamis;442;8;450
93;Provence-Alpes-Côte d'Azur;84;1;13;076;Mirabeau;1344;39;1383
93;Provence-Alpes-Côte d'Azur;84;3;12;077;Modène;465;7;472
93;Provence-Alpes-Côte d'Azur;84;3;05;078;Mondragon;3736;63;3799
93;Provence-Alpes-Côte d'Azur;84;3;12;079;Monieux;282;5;287
93;Provence-Alpes-Côte d'Azur;84;3;10;080;Monteux;12935;226;13161
93;Provence-Alpes-Côte d'Azur;84;2;04;081;Morières-lès-Avignon;8786;130;8916
93;Provence-Alpes-Côte d'Azur;84;3;12;082;Mormoiron;1864;49;1913
93;Provence-Alpes-Côte d'Azur;84;3;05;083;Mornas;2438;47;2485
93;Provence-Alpes-Côte d'Azur;84;1;13;084;La Motte-d'Aigues;1371;41;1412
93;Provence-Alpes-Côte d'Azur;84;1;01;085;Murs;418;6;424
93;Provence-Alpes-Côte d'Azur;84;1;01;086;Oppède;1295;27;1322
93;Provence-Alpes-Côte d'Azur;84;3;11;087;Orange;28772;665;29437
93;Provence-Alpes-Côte d'Azur;84;3;12;088;Pernes-les-Fontaines;10170;287;10457
93;Provence-Alpes-Côte d'Azur;84;1;13;089;Pertuis;20557;309;20866
93;Provence-Alpes-Côte d'Azur;84;1;13;090;Peypin-d'Aigues;673;15;688
93;Provence-Alpes-Côte d'Azur;84;3;11;091;Piolenc;5394;95;5489
93;Provence-Alpes-Côte d'Azur;84;2;14;092;Le Pontet;17041;136;17177
93;Provence-Alpes-Côte d'Azur;84;1;08;093;Puget;819;21;840
93;Provence-Alpes-Côte d'Azur;84;3;16;094;Puyméras;580;12;592
93;Provence-Alpes-Côte d'Azur;84;1;08;095;Puyvert;830;14;844
93;Provence-Alpes-Côte d'Azur;84;3;16;096;Rasteau;803;20;823
93;Provence-Alpes-Côte d'Azur;84;3;17;097;Richerenches;537;81;618
93;Provence-Alpes-Côte d'Azur;84;3;16;098;Roaix;634;9;643
93;Provence-Alpes-Côte d'Azur;84;1;08;099;Robion;4631;75;4706
93;Provence-Alpes-Côte d'Azur;84;3;16;100;La Roque-Alric;52;0;52
93;Provence-Alpes-Côte d'Azur;84;3;12;101;La Roque-sur-Pernes;416;13;429
93;Provence-Alpes-Côte d'Azur;84;1;01;102;Roussillon;1289;31;1320
93;Provence-Alpes-Côte d'Azur;84;1;01;103;Rustrel;661;20;681
93;Provence-Alpes-Côte d'Azur;84;3;16;104;Sablet;1349;32;1381
93;Provence-Alpes-Côte d'Azur;84;1;01;105;Saignon;929;22;951
93;Provence-Alpes-Côte d'Azur;84;3;05;106;Sainte-Cécile-les-Vignes;2591;53;2644
93;Provence-Alpes-Côte d'Azur;84;3;12;107;Saint-Christol;1401;20;1421
93;Provence-Alpes-Côte d'Azur;84;3;12;108;Saint-Didier;1996;41;2037
93;Provence-Alpes-Côte d'Azur;84;3;10;109;Saint-Hippolyte-le-Graveyron;167;9;176
93;Provence-Alpes-Côte d'Azur;84;3;16;110;Saint-Léger-du-Ventoux;33;0;33
93;Provence-Alpes-Côte d'Azur;84;3;16;111;Saint-Marcellin-lès-Vaison;327;11;338
93;Provence-Alpes-Côte d'Azur;84;1;01;112;Saint-Martin-de-Castillon;728;6;734
93;Provence-Alpes-Côte d'Azur;84;1;13;113;Saint-Martin-de-la-Brasque;815;17;832
93;Provence-Alpes-Côte d'Azur;84;1;01;114;Saint-Pantaléon;189;3;192
93;Provence-Alpes-Côte d'Azur;84;3;12;115;Saint-Pierre-de-Vassols;509;12;521
93;Provence-Alpes-Côte d'Azur;84;3;16;116;Saint-Romain-en-Viennois;783;21;804
93;Provence-Alpes-Côte d'Azur;84;3;16;117;Saint-Roman-de-Malegarde;330;7;337
93;Provence-Alpes-Côte d'Azur;84;1;01;118;Saint-Saturnin-lès-Apt;2877;71;2948
93;Provence-Alpes-Côte d'Azur;84;2;14;119;Saint-Saturnin-lès-Avignon;4935;113;5048
93;Provence-Alpes-Côte d'Azur;84;3;12;120;Saint-Trinit;118;1;119
93;Provence-Alpes-Côte d'Azur;84;1;13;121;Sannes;265;0;265
93;Provence-Alpes-Côte d'Azur;84;3;10;122;Sarrians;6128;78;6206
93;Provence-Alpes-Côte d'Azur;84;3;12;123;Sault;1361;23;1384
93;Provence-Alpes-Côte d'Azur;84;2;09;124;Saumane-de-Vaucluse;946;16;962
93;Provence-Alpes-Côte d'Azur;84;3;16;125;Savoillan;61;0;61
93;Provence-Alpes-Côte d'Azur;84;3;16;126;Séguret;856;23;879
93;Provence-Alpes-Côte d'Azur;84;3;05;127;Sérignan-du-Comtat;2853;81;2934
93;Provence-Alpes-Côte d'Azur;84;1;01;128;Sivergues;46;1;47
93;Provence-Alpes-Côte d'Azur;84;2;15;129;Sorgues;18893;234;19127
93;Provence-Alpes-Côte d'Azur;84;3;16;130;Suzette;113;3;116
93;Provence-Alpes-Côte d'Azur;84;1;08;131;Taillades;1921;40;1961
93;Provence-Alpes-Côte d'Azur;84;2;09;132;Le Thor;8940;177;9117
93;Provence-Alpes-Côte d'Azur;84;1;13;133;La Tour-d'Aigues;4334;138;4472
93;Provence-Alpes-Côte d'Azur;84;3;16;134;Travaillan;711;13;724
93;Provence-Alpes-Côte d'Azur;84;3;05;135;Uchaux;1666;51;1717
93;Provence-Alpes-Côte d'Azur;84;3;16;136;Vacqueyras;1240;31;1271
93;Provence-Alpes-Côte d'Azur;84;3;16;137;Vaison-la-Romaine;5908;129;6037
93;Provence-Alpes-Côte d'Azur;84;3;17;138;Valréas;9403;230;9633
93;Provence-Alpes-Côte d'Azur;84;2;09;139;Fontaine-de-Vaucluse;579;16;595
93;Provence-Alpes-Côte d'Azur;84;1;08;140;Vaugines;558;19;577
93;Provence-Alpes-Côte d'Azur;84;2;14;141;Vedène;11383;368;11751
93;Provence-Alpes-Côte d'Azur;84;2;14;142;Velleron;2976;54;3030
93;Provence-Alpes-Côte d'Azur;84;3;12;143;Venasque;1013;18;1031
93;Provence-Alpes-Côte d'Azur;84;1;01;144;Viens;641;18;659
93;Provence-Alpes-Côte d'Azur;84;1;01;145;Villars;781;14;795
93;Provence-Alpes-Côte d'Azur;84;3;16;146;Villedieu;489;14;503
93;Provence-Alpes-Côte d'Azur;84;1;13;147;Villelaure;3356;86;3442
93;Provence-Alpes-Côte d'Azur;84;3;12;148;Villes-sur-Auzon;1284;34;1318
93;Provence-Alpes-Côte d'Azur;84;3;16;149;Violès;1710;33;1743
93;Provence-Alpes-Côte d'Azur;84;3;17;150;Visan;1956;57;2013
93;Provence-Alpes-Côte d'Azur;84;1;13;151;Vitrolles-en-Lubéron;164;5;169
52;Pays de la Loire;85;1;09;001;L'Aiguillon-sur-Mer;2061;35;2096
52;Pays de la Loire;85;3;15;002;L'Aiguillon-sur-Vie;2024;24;2048
52;Pays de la Loire;85;2;01;003;Aizenay;9881;198;10079
52;Pays de la Loire;85;3;09;004;Angles;2878;34;2912
52;Pays de la Loire;85;1;04;005;Antigny;1054;21;1075
52;Pays de la Loire;85;2;02;006;Apremont;1854;13;1867
52;Pays de la Loire;85;2;13;008;Aubigny-Les Clouzeaux;6880;104;6984
52;Pays de la Loire;85;1;05;009;Auchay-sur-Vendée;1165;24;1189
52;Pays de la Loire;85;3;17;010;Avrillé;1423;20;1443
52;Pays de la Loire;85;3;16;011;Barbâtre;1723;52;1775
52;Pays de la Loire;85;3;16;012;La Barre-de-Monts;2179;48;2227
52;Pays de la Loire;85;2;10;013;Bazoges-en-Paillers;1460;28;1488
52;Pays de la Loire;85;1;04;014;Bazoges-en-Pareds;1149;27;1176
52;Pays de la Loire;85;2;01;015;Beaufou;1514;21;1535
52;Pays de la Loire;85;3;17;016;Beaulieu-sous-la-Roche;2252;30;2282
52;Pays de la Loire;85;2;11;017;Beaurepaire;2442;49;2491
52;Pays de la Loire;85;3;16;018;Beauvoir-sur-Mer;3880;60;3940
52;Pays de la Loire;85;2;01;019;Bellevigny;6095;123;6218
52;Pays de la Loire;85;1;05;020;Benet;4014;75;4089
52;Pays de la Loire;85;2;11;021;La Bernardière;1868;35;1903
52;Pays de la Loire;85;3;17;022;Le Bernard;1239;18;1257
52;Pays de la Loire;85;1;09;023;Bessay;439;9;448
52;Pays de la Loire;85;3;02;024;Bois-de-Céné;2048;34;2082
52;Pays de la Loire;85;2;10;025;La Boissière-de-Montaigu;2272;52;2324
52;Pays de la Loire;85;3;09;026;La Boissière-des-Landes;1417;18;1435
52;Pays de la Loire;85;1;05;028;Bouillé-Courdault;595;8;603
52;Pays de la Loire;85;3;16;029;Bouin;2156;36;2192
52;Pays de la Loire;85;1;03;031;Le Boupère;3227;43;3270
52;Pays de la Loire;85;1;04;033;Bourneau;731;19;750
52;Pays de la Loire;85;2;03;034;Bournezeau;3403;101;3504
52;Pays de la Loire;85;3;15;035;Bretignolles-sur-Mer;5066;89;5155
52;Pays de la Loire;85;1;09;036;La Bretonnière-la-Claye;573;11;584
52;Pays de la Loire;85;1;04;037;Breuil-Barret;590;16;606
52;Pays de la Loire;85;2;10;038;Les Brouzils;2816;44;2860
52;Pays de la Loire;85;2;11;039;La Bruffière;4028;61;4089
52;Pays de la Loire;85;1;04;040;La Caillère-Saint-Hilaire;1128;24;1152
52;Pays de la Loire;85;1;04;041;Cezais;296;12;308
52;Pays de la Loire;85;1;08;042;Chaillé-les-Marais;1883;24;1907
52;Pays de la Loire;85;3;15;045;La Chaize-Giraud;1083;14;1097
52;Pays de la Loire;85;2;13;046;La Chaize-le-Vicomte;3799;58;3857
52;Pays de la Loire;85;3;02;047;Challans;21322;773;22095
52;Pays de la Loire;85;1;08;049;Champagné-les-Marais;1783;16;1799
52;Pays de la Loire;85;3;09;050;Le Champ-Saint-Père;1857;22;1879
52;Pays de la Loire;85;2;03;051;Chantonnay;8394;471;8865
52;Pays de la Loire;85;1;04;053;La Chapelle-aux-Lys;260;3;263
52;Pays de la Loire;85;3;17;054;La Chapelle-Hermier;900;7;907
52;Pays de la Loire;85;2;02;055;La Chapelle-Palluau;935;18;953
52;Pays de la Loire;85;1;04;056;La Chapelle-Thémer;391;9;400
52;Pays de la Loire;85;1;08;058;Chasnais;735;20;755
52;Pays de la Loire;85;1;04;059;La Châtaigneraie;2586;36;2622
52;Pays de la Loire;85;1;09;061;Château-Guibert;1506;33;1539
52;Pays de la Loire;85;3;02;062;Châteauneuf;1114;20;1134
52;Pays de la Loire;85;2;10;064;Chauché;2469;33;2502
52;Pays de la Loire;85;2;10;065;Chavagnes-en-Paillers;3552;101;3653
52;Pays de la Loire;85;1;06;066;Chavagnes-les-Redoux;834;17;851
52;Pays de la Loire;85;1;04;067;Cheffois;994;21;1015
52;Pays de la Loire;85;3;15;070;Coëx;3285;37;3322
52;Pays de la Loire;85;3;15;071;Commequiers;3605;57;3662
52;Pays de la Loire;85;2;10;072;La Copechagnière;1018;11;1029
52;Pays de la Loire;85;1;09;073;Corpe;1014;16;1030
52;Pays de la Loire;85;1;09;074;La Couture;224;3;227
52;Pays de la Loire;85;2;11;076;Cugand;3563;90;3653
52;Pays de la Loire;85;3;09;077;Curzon;538;8;546
52;Pays de la Loire;85;1;05;078;Damvix;741;17;758
52;Pays de la Loire;85;1;05;080;Doix lès Fontaines;1731;33;1764
52;Pays de la Loire;85;2;12;081;Dompierre-sur-Yon;4344;114;4458
52;Pays de la Loire;85;2;06;082;Les Epesses;2914;57;2971
52;Pays de la Loire;85;3;16;083;L'Épine;1633;40;1673
52;Pays de la Loire;85;2;03;084;Essarts en Bocage;9174;166;9340
52;Pays de la Loire;85;2;02;086;Falleron;1637;15;1652
52;Pays de la Loire;85;1;05;087;Faymoreau;198;4;202
52;Pays de la Loire;85;3;15;088;Le Fenouiller;4854;136;4990
52;Pays de la Loire;85;2;03;089;La Ferrière;5315;157;5472
52;Pays de la Loire;85;1;06;090;Sèvremont;6423;255;6678
52;Pays de la Loire;85;1;05;092;Fontenay-le-Comte;13235;724;13959
52;Pays de la Loire;85;2;03;093;Fougeré;1224;22;1246
52;Pays de la Loire;85;1;05;094;Foussais-Payré;1157;30;1187
52;Pays de la Loire;85;3;02;095;Froidfond;1942;21;1963
52;Pays de la Loire;85;3;02;096;La Garnache;5114;100;5214
52;Pays de la Loire;85;2;11;097;La Gaubretière;3111;67;3178
52;Pays de la Loire;85;2;01;098;La Genétouze;1982;37;2019
52;Pays de la Loire;85;3;17;099;Le Girouard;1097;23;1120
52;Pays de la Loire;85;3;15;100;Givrand;2230;52;2282
52;Pays de la Loire;85;3;09;101;Le Givre;489;5;494
52;Pays de la Loire;85;2;02;102;Grand'Landes;692;9;701
52;Pays de la Loire;85;3;17;103;Grosbreuil;2229;31;2260
52;Pays de la Loire;85;1;08;104;Grues;895;11;906
52;Pays de la Loire;85;1;08;105;Le Gué-de-Velluire;529;13;542
52;Pays de la Loire;85;3;16;106;La Guérinière;1320;35;1355
52;Pays de la Loire;85;2;01;108;L'Herbergement;3297;110;3407
52;Pays de la Loire;85;2;06;109;Les Herbiers;16250;485;16735
52;Pays de la Loire;85;1;04;110;L'Hermenault;924;14;938
52;Pays de la Loire;85;1;08;111;L'Île-d'Elle;1501;23;1524
52;Pays de la Loire;85;3;17;112;L'Île-d'Olonne;2783;59;2842
52;Pays de la Loire;85;3;07;113;L'Île-d'Yeu;4850;138;4988
52;Pays de la Loire;85;3;17;114;Jard-sur-Mer;2665;31;2696
52;Pays de la Loire;85;1;04;115;La Jaudonnière;600;11;611
52;Pays de la Loire;85;3;09;116;La Jonchère;461;6;467
52;Pays de la Loire;85;1;08;117;Lairoux;621;19;640
52;Pays de la Loire;85;2;12;118;Landeronde;2363;50;2413
52;Pays de la Loire;85;2;11;119;Les Landes-Genusson;2403;42;2445
52;Pays de la Loire;85;3;15;120;Landevieille;1449;36;1485
52;Pays de la Loire;85;1;05;121;Le Langon;993;31;1024
52;Pays de la Loire;85;1;05;123;Liez;280;4;284
52;Pays de la Loire;85;1;04;125;Loge-Fougereuse;400;4;404
52;Pays de la Loire;85;1;05;126;Longèves;1341;50;1391
52;Pays de la Loire;85;3;17;127;Longeville-sur-Mer;2405;26;2431
52;Pays de la Loire;85;1;08;128;Luçon;9554;386;9940
52;Pays de la Loire;85;2;01;129;Les Lucs-sur-Boulogne;3522;72;3594
52;Pays de la Loire;85;2;02;130;Maché;1589;20;1609
52;Pays de la Loire;85;1;08;131;Les Magnils-Reigniers;1486;40;1526
52;Pays de la Loire;85;1;05;132;Maillé;749;13;762
52;Pays de la Loire;85;1;05;133;Maillezais;921;23;944
52;Pays de la Loire;85;2;11;134;Mallièvre;243;10;253
52;Pays de la Loire;85;1;09;135;Mareuil-sur-Lay-Dissais;2792;122;2914
52;Pays de la Loire;85;1;04;136;Marillet;123;1;124
52;Pays de la Loire;85;1;04;137;Marsais-Sainte-Radégonde;480;14;494
52;Pays de la Loire;85;3;17;138;Martinet;1171;12;1183
52;Pays de la Loire;85;1;05;139;Le Mazeau;445;14;459
52;Pays de la Loire;85;1;06;140;La Meilleraie-Tillay;1502;43;1545
52;Pays de la Loire;85;1;04;141;Menomblet;675;13;688
52;Pays de la Loire;85;2;03;142;La Merlatière;1014;23;1037
52;Pays de la Loire;85;1;05;143;Mervent;1047;20;1067
52;Pays de la Loire;85;2;10;144;Mesnard-la-Barotière;1504;27;1531
52;Pays de la Loire;85;1;06;145;Monsireigne;957;17;974
52;Pays de la Loire;85;2;10;146;Montaigu-Vendée;20424;634;21058
52;Pays de la Loire;85;1;06;147;Montournais;1641;50;1691
52;Pays de la Loire;85;1;05;148;Montreuil;814;23;837
52;Pays de la Loire;85;1;08;149;Moreilles;413;5;418
52;Pays de la Loire;85;2;11;151;Mortagne-sur-Sèvre;6059;168;6227
52;Pays de la Loire;85;3;17;152;Les Achards;5271;108;5379
52;Pays de la Loire;85;2;06;153;Mouchamps;2922;46;2968
52;Pays de la Loire;85;1;04;154;Mouilleron-Saint-Germain;1806;92;1898
52;Pays de la Loire;85;2;12;155;Mouilleron-le-Captif;4971;123;5094
52;Pays de la Loire;85;3;09;156;Moutiers-les-Mauxfaits;2212;34;2246
52;Pays de la Loire;85;1;09;157;Moutiers-sur-le-Lay;761;12;773
52;Pays de la Loire;85;1;08;158;Mouzeuil-Saint-Martin;1194;27;1221
52;Pays de la Loire;85;1;08;159;Nalliers;2310;47;2357
52;Pays de la Loire;85;2;13;160;Nesmy;2912;45;2957
52;Pays de la Loire;85;3;17;161;Nieul-le-Dolent;2549;26;2575
52;Pays de la Loire;85;1;05;162;Rives-d'Autise;2094;51;2145
52;Pays de la Loire;85;3;16;163;Noirmoutier-en-l'Île;4550;106;4656
52;Pays de la Loire;85;3;16;164;Notre-Dame-de-Monts;2149;47;2196
52;Pays de la Loire;85;1;05;167;L'Orbrie;787;17;804
52;Pays de la Loire;85;2;02;169;Palluau;1106;17;1123
52;Pays de la Loire;85;1;09;171;Péault;608;23;631
52;Pays de la Loire;85;3;16;172;Le Perrier;2056;34;2090
52;Pays de la Loire;85;1;04;174;Petosse;687;18;705
52;Pays de la Loire;85;1;09;175;Les Pineaux;660;3;663
52;Pays de la Loire;85;1;05;176;Pissotte;1160;36;1196
52;Pays de la Loire;85;1;05;177;Les Velluire-sur-Vendée;1383;22;1405
52;Pays de la Loire;85;2;01;178;Le Poiré-sur-Vie;8596;220;8816
52;Pays de la Loire;85;3;17;179;Poiroux;1158;11;1169
52;Pays de la Loire;85;1;08;181;Pouillé;644;17;661
52;Pays de la Loire;85;1;06;182;Pouzauges;5557;204;5761
52;Pays de la Loire;85;1;05;184;Puy-de-Serre;321;7;328
52;Pays de la Loire;85;1;08;185;Puyravault;657;6;663
52;Pays de la Loire;85;2;10;186;La Rabatelière;999;15;1014
52;Pays de la Loire;85;1;06;187;Réaumur;862;15;877
52;Pays de la Loire;85;1;04;188;La Réorthe;1097;22;1119
52;Pays de la Loire;85;3;16;189;Notre-Dame-de-Riez;2156;44;2200
52;Pays de la Loire;85;2;01;190;Rocheservière;3400;47;3447
52;Pays de la Loire;85;2;99;191;La Roche-sur-Yon;55147;2956;58103
52;Pays de la Loire;85;2;03;192;Rochetrejoux;988;9;997
52;Pays de la Loire;85;1;09;193;Rosnay;645;17;662
52;Pays de la Loire;85;3;14;194;Les Sables-d'Olonne;45030;1433;46463
52;Pays de la Loire;85;2;10;196;Saint-André-Goule-d'Oie;1892;16;1908
52;Pays de la Loire;85;2;01;197;Montréverd;3761;58;3819
52;Pays de la Loire;85;2;11;198;Saint-Aubin-des-Ormeaux;1344;18;1362
52;Pays de la Loire;85;1;04;199;Saint-Aubin-la-Plaine;542;6;548
52;Pays de la Loire;85;3;09;200;Saint-Avaugourd-des-Landes;1082;21;1103
52;Pays de la Loire;85;3;09;201;Saint-Benoist-sur-Mer;493;6;499
52;Pays de la Loire;85;2;03;202;Sainte-Cécile;1597;114;1711
52;Pays de la Loire;85;3;02;204;Saint-Christophe-du-Ligneron;2586;43;2629
52;Pays de la Loire;85;1;04;205;Saint-Cyr-des-Gâts;528;8;536
52;Pays de la Loire;85;3;09;206;Saint-Cyr-en-Talmondais;394;13;407
52;Pays de la Loire;85;1;08;207;Saint-Denis-du-Payré;389;8;397
52;Pays de la Loire;85;2;01;208;Saint-Denis-la-Chevasse;2376;37;2413
52;Pays de la Loire;85;1;04;209;Saint-Étienne-de-Brillouet;642;9;651
52;Pays de la Loire;85;2;02;210;Saint-Étienne-du-Bois;2135;25;2160
52;Pays de la Loire;85;3;17;211;Sainte-Flaive-des-Loups;2439;25;2464
52;Pays de la Loire;85;2;09;213;Rives de l'Yon;4217;171;4388
52;Pays de la Loire;85;3;17;214;Sainte-Foy;2378;47;2425
52;Pays de la Loire;85;2;10;215;Saint-Fulgent;3814;139;3953
52;Pays de la Loire;85;1;08;216;Sainte-Gemme-la-Plaine;2058;213;2271
52;Pays de la Loire;85;3;17;218;Saint-Georges-de-Pointindoux;1696;15;1711
52;Pays de la Loire;85;2;03;220;Saint-Germain-de-Prinçay;1598;27;1625
52;Pays de la Loire;85;3;16;221;Saint-Gervais;2697;36;2733
52;Pays de la Loire;85;3;15;222;Saint-Gilles-Croix-de-Vie;7862;250;8112
52;Pays de la Loire;85;1;04;223;Sainte-Hermine;2940;62;3002
52;Pays de la Loire;85;3;15;226;Saint-Hilaire-de-Riez;11297;204;11501
52;Pays de la Loire;85;1;05;227;Saint-Hilaire-des-Loges;1921;52;1973
52;Pays de la Loire;85;1;04;229;Saint-Hilaire-de-Voust;585;12;597
52;Pays de la Loire;85;3;17;231;Saint-Hilaire-la-Forêt;790;15;805
52;Pays de la Loire;85;2;03;232;Saint-Hilaire-le-Vouhis;1079;23;1102
52;Pays de la Loire;85;1;04;233;Saint-Jean-de-Beugné;604;9;613
52;Pays de la Loire;85;3;16;234;Saint-Jean-de-Monts;8696;226;8922
52;Pays de la Loire;85;1;04;235;Saint-Juire-Champgillon;421;13;434
52;Pays de la Loire;85;3;17;236;Saint-Julien-des-Landes;1872;21;1893
52;Pays de la Loire;85;1;04;237;Saint-Laurent-de-la-Salle;378;12;390
52;Pays de la Loire;85;2;11;238;Saint-Laurent-sur-Sèvre;3689;441;4130
52;Pays de la Loire;85;3;15;239;Saint-Maixent-sur-Vie;1124;5;1129
52;Pays de la Loire;85;2;11;240;Saint-Malô-du-Bois;1615;50;1665
52;Pays de la Loire;85;2;06;242;Saint-Mars-la-Réorthe;999;20;1019
52;Pays de la Loire;85;3;15;243;Brem-sur-Mer;2817;49;2866
52;Pays de la Loire;85;1;05;244;Saint-Martin-de-Fraigneau;821;58;879
52;Pays de la Loire;85;1;04;245;Saint-Martin-des-Fontaines;171;2;173
52;Pays de la Loire;85;2;03;246;Saint-Martin-des-Noyers;2483;39;2522
52;Pays de la Loire;85;2;11;247;Saint-Martin-des-Tilleuls;1082;18;1100
52;Pays de la Loire;85;1;04;248;Saint-Martin-Lars-en-Sainte-Hermine;416;12;428
52;Pays de la Loire;85;3;17;250;Saint-Mathurin;2323;35;2358
52;Pays de la Loire;85;1;04;251;Saint-Maurice-des-Noues;632;18;650
52;Pays de la Loire;85;1;04;252;Saint-Maurice-le-Girard;593;24;617
52;Pays de la Loire;85;1;06;254;Saint-Mesmin;1755;44;1799
52;Pays de la Loire;85;1;08;255;Saint-Michel-en-l'Herm;2341;80;2421
52;Pays de la Loire;85;1;05;256;Saint-Michel-le-Cloucq;1287;32;1319
52;Pays de la Loire;85;2;06;259;Saint-Paul-en-Pareds;1328;35;1363
52;Pays de la Loire;85;2;02;260;Saint-Paul-Mont-Penit;826;11;837
52;Pays de la Loire;85;1;09;261;Sainte-Pexine;278;12;290
52;Pays de la Loire;85;2;01;262;Saint-Philbert-de-Bouaine;3535;39;3574
52;Pays de la Loire;85;1;04;264;Saint-Pierre-du-Chemin;1331;20;1351
52;Pays de la Loire;85;1;05;265;Saint-Pierre-le-Vieux;940;21;961
52;Pays de la Loire;85;2;03;266;Saint-Prouant;1662;29;1691
52;Pays de la Loire;85;1;08;267;Sainte-Radégonde-des-Noyers;934;18;952
52;Pays de la Loire;85;3;15;268;Saint-Révérend;1459;31;1490
52;Pays de la Loire;85;1;05;269;Saint-Sigismond;419;7;426
52;Pays de la Loire;85;1;04;271;Saint-Sulpice-en-Pareds;436;13;449
52;Pays de la Loire;85;3;16;273;Saint-Urbain;1879;35;1914
52;Pays de la Loire;85;1;04;274;Saint-Valérien;532;12;544
52;Pays de la Loire;85;2;03;276;Saint-Vincent-Sterlanges;759;13;772
52;Pays de la Loire;85;3;09;277;Saint-Vincent-sur-Graon;1535;25;1560
52;Pays de la Loire;85;3;17;278;Saint-Vincent-sur-Jard;1312;22;1334
52;Pays de la Loire;85;3;02;280;Sallertaine;3171;71;3242
52;Pays de la Loire;85;1;04;281;Sérigné;987;30;1017
52;Pays de la Loire;85;2;03;282;Sigournais;912;16;928
52;Pays de la Loire;85;3;16;284;Soullans;4259;95;4354
52;Pays de la Loire;85;2;09;285;Le Tablier;740;13;753
52;Pays de la Loire;85;1;08;286;La Taillée;561;5;566
52;Pays de la Loire;85;1;06;287;Tallud-Sainte-Gemme;458;8;466
52;Pays de la Loire;85;3;17;288;Talmont-Saint-Hilaire;7831;185;8016
52;Pays de la Loire;85;1;04;289;La Tardière;1327;26;1353
52;Pays de la Loire;85;1;04;290;Thiré;553;13;566
52;Pays de la Loire;85;2;03;291;Thorigny;1231;20;1251
52;Pays de la Loire;85;1;04;292;Thouarsais-Bouildroux;778;10;788
52;Pays de la Loire;85;2;11;293;Tiffauges;1576;38;1614
52;Pays de la Loire;85;3;09;294;La Tranche-sur-Mer;2904;65;2969
52;Pays de la Loire;85;2;10;295;Treize-Septiers;3280;82;3362
52;Pays de la Loire;85;2;11;296;Treize-Vents;1246;24;1270
52;Pays de la Loire;85;1;08;297;Triaize;986;15;1001
52;Pays de la Loire;85;3;17;298;Vairé;1744;31;1775
52;Pays de la Loire;85;2;12;300;Venansault;4628;178;4806
52;Pays de la Loire;85;2;10;301;Vendrennes;1772;22;1794
52;Pays de la Loire;85;2;11;302;Chanverrie;5453;130;5583
52;Pays de la Loire;85;1;05;303;Vix;1809;30;1839
52;Pays de la Loire;85;1;08;304;Vouillé-les-Marais;753;10;763
52;Pays de la Loire;85;1;04;305;Vouvant;880;49;929
52;Pays de la Loire;85;1;05;306;Xanton-Chassenon;732;9;741
52;Pays de la Loire;85;3;09;307;La Faute-sur-Mer;665;8;673
75;Nouvelle-Aquitaine;86;2;10;001;Adriers;714;8;722
75;Nouvelle-Aquitaine;86;3;11;002;Amberre;580;20;600
75;Nouvelle-Aquitaine;86;2;09;003;Anché;338;7;345
75;Nouvelle-Aquitaine;86;1;12;004;Angles-sur-l'Anglin;347;14;361
75;Nouvelle-Aquitaine;86;1;08;005;Angliers;617;23;640
75;Nouvelle-Aquitaine;86;2;12;006;Antigny;546;19;565
75;Nouvelle-Aquitaine;86;1;03;007;Antran;1163;32;1195
75;Nouvelle-Aquitaine;86;1;08;008;Arçay;343;6;349
75;Nouvelle-Aquitaine;86;1;05;009;Archigny;1070;17;1087
75;Nouvelle-Aquitaine;86;3;18;010;Aslonnes;1119;19;1138
75;Nouvelle-Aquitaine;86;2;10;011;Asnières-sur-Blour;180;4;184
75;Nouvelle-Aquitaine;86;2;06;012;Asnois;164;8;172
75;Nouvelle-Aquitaine;86;1;08;013;Aulnay;97;3;100
75;Nouvelle-Aquitaine;86;1;05;014;Availles-en-Châtellerault;1740;42;1782
75;Nouvelle-Aquitaine;86;2;06;015;Availles-Limouzine;1244;26;1270
75;Nouvelle-Aquitaine;86;3;11;016;Avanton;2200;40;2240
75;Nouvelle-Aquitaine;86;3;19;017;Ayron;1104;17;1121
75;Nouvelle-Aquitaine;86;1;08;018;Basses;321;2;323
75;Nouvelle-Aquitaine;86;3;07;019;Beaumont Saint-Cyr;2958;43;3001
75;Nouvelle-Aquitaine;86;1;05;020;Bellefonds;253;4;257
75;Nouvelle-Aquitaine;86;1;08;022;Berrie;259;4;263
75;Nouvelle-Aquitaine;86;1;08;023;Berthegon;280;6;286
75;Nouvelle-Aquitaine;86;3;19;024;Béruges;1553;24;1577
75;Nouvelle-Aquitaine;86;2;12;025;Béthines;474;5;479
75;Nouvelle-Aquitaine;86;1;08;026;Beuxes;546;5;551
75;Nouvelle-Aquitaine;86;3;13;027;Biard;1832;62;1894
75;Nouvelle-Aquitaine;86;3;01;028;Bignoux;1067;18;1085
75;Nouvelle-Aquitaine;86;2;06;029;Blanzay;780;24;804
75;Nouvelle-Aquitaine;86;3;01;031;Bonnes;1729;20;1749
75;Nouvelle-Aquitaine;86;1;05;032;Bonneuil-Matours;2079;99;2178
75;Nouvelle-Aquitaine;86;2;10;034;Bouresse;601;13;614
75;Nouvelle-Aquitaine;86;2;12;035;Bourg-Archambault;185;6;191
75;Nouvelle-Aquitaine;86;1;08;036;Bournand;885;20;905
75;Nouvelle-Aquitaine;86;2;12;037;Brigueil-le-Chantre;507;6;513
75;Nouvelle-Aquitaine;86;2;10;038;Brion;219;8;227
75;Nouvelle-Aquitaine;86;2;09;039;Brux;733;9;742
75;Nouvelle-Aquitaine;86;2;12;040;La Bussière;314;11;325
75;Nouvelle-Aquitaine;86;3;14;041;Buxerolles;10060;139;10199
75;Nouvelle-Aquitaine;86;1;03;042;Buxeuil;919;12;931
75;Nouvelle-Aquitaine;86;1;08;044;Ceaux-en-Loudun;548;11;559
75;Nouvelle-Aquitaine;86;3;09;045;Celle-Lévescault;1351;17;1368
75;Nouvelle-Aquitaine;86;1;05;046;Cenon-sur-Vienne;1737;29;1766
75;Nouvelle-Aquitaine;86;1;08;047;Cernay;485;13;498
75;Nouvelle-Aquitaine;86;3;07;048;Chabournay;1153;12;1165
75;Nouvelle-Aquitaine;86;1;08;049;Chalais;501;16;517
75;Nouvelle-Aquitaine;86;3;19;050;Chalandray;843;13;856
75;Nouvelle-Aquitaine;86;2;06;051;Champagné-le-Sec;197;4;201
75;Nouvelle-Aquitaine;86;2;06;052;Champagné-Saint-Hilaire;995;20;1015
75;Nouvelle-Aquitaine;86;3;11;053;Champigny en Rochereau;1961;36;1997
75;Nouvelle-Aquitaine;86;2;06;054;Champniers;352;5;357
75;Nouvelle-Aquitaine;86;2;06;055;La Chapelle-Bâton;356;12;368
75;Nouvelle-Aquitaine;86;3;01;058;La Chapelle-Moulière;726;20;746
75;Nouvelle-Aquitaine;86;2;05;059;Chapelle-Viviers;581;4;585
75;Nouvelle-Aquitaine;86;2;06;061;Charroux;1128;25;1153
75;Nouvelle-Aquitaine;86;3;01;062;Chasseneuil-du-Poitou;4692;51;4743
75;Nouvelle-Aquitaine;86;2;06;063;Chatain;249;1;250
75;Nouvelle-Aquitaine;86;2;06;064;Château-Garnier;613;10;623
75;Nouvelle-Aquitaine;86;3;18;065;Château-Larcher;1045;16;1061
75;Nouvelle-Aquitaine;86;1;98;066;Châtellerault;31487;799;32286
75;Nouvelle-Aquitaine;86;2;09;068;Chaunay;1211;17;1228
75;Nouvelle-Aquitaine;86;1;08;069;La Chaussée;180;4;184
75;Nouvelle-Aquitaine;86;3;05;070;Chauvigny;7062;114;7176
75;Nouvelle-Aquitaine;86;1;04;072;Chenevelles;454;9;463
75;Nouvelle-Aquitaine;86;3;11;073;Cherves;528;11;539
75;Nouvelle-Aquitaine;86;3;19;074;Chiré-en-Montreuil;915;15;930
75;Nouvelle-Aquitaine;86;3;08;075;Chouppes;750;19;769
75;Nouvelle-Aquitaine;86;3;11;076;Cissé;2835;48;2883
75;Nouvelle-Aquitaine;86;2;10;077;Civaux;1209;17;1226
75;Nouvelle-Aquitaine;86;2;06;078;Civray;2596;137;2733
75;Nouvelle-Aquitaine;86;1;08;079;La Roche-Rigault;560;36;596
75;Nouvelle-Aquitaine;86;3;09;080;Cloué;493;5;498
75;Nouvelle-Aquitaine;86;1;02;081;Colombiers;1438;30;1468
75;Nouvelle-Aquitaine;86;2;09;082;Valence-en-Poitou;4455;116;4571
75;Nouvelle-Aquitaine;86;3;09;083;Coulombiers;1132;13;1145
75;Nouvelle-Aquitaine;86;2;12;084;Coulonges;235;5;240
75;Nouvelle-Aquitaine;86;3;08;085;Coussay;249;6;255
75;Nouvelle-Aquitaine;86;1;04;086;Coussay-les-Bois;954;17;971
75;Nouvelle-Aquitaine;86;1;08;087;Craon;185;4;189
75;Nouvelle-Aquitaine;86;3;13;088;Croutelle;865;24;889
75;Nouvelle-Aquitaine;86;3;11;089;Cuhon;391;6;397
75;Nouvelle-Aquitaine;86;1;08;090;Curçay-sur-Dive;216;1;217
75;Nouvelle-Aquitaine;86;3;09;091;Curzay-sur-Vonne;387;7;394
75;Nouvelle-Aquitaine;86;1;03;092;Dangé-Saint-Romain;2969;58;3027
75;Nouvelle-Aquitaine;86;1;08;093;Dercé;156;3;159
75;Nouvelle-Aquitaine;86;3;18;094;Dienné;573;12;585
75;Nouvelle-Aquitaine;86;3;07;095;Dissay;3255;50;3305
75;Nouvelle-Aquitaine;86;1;08;096;Doussay;659;9;668
75;Nouvelle-Aquitaine;86;2;06;097;La Ferrière-Airoux;328;5;333
75;Nouvelle-Aquitaine;86;2;05;098;Fleix;141;2;143
75;Nouvelle-Aquitaine;86;3;18;099;Fleuré;1054;9;1063
75;Nouvelle-Aquitaine;86;3;13;100;Fontaine-le-Comte;3934;74;4008
75;Nouvelle-Aquitaine;86;3;19;102;Frozes;583;8;591
75;Nouvelle-Aquitaine;86;2;10;103;Gençay;1746;65;1811
75;Nouvelle-Aquitaine;86;2;06;104;Genouillé;497;5;502
75;Nouvelle-Aquitaine;86;3;18;105;Gizay;369;1;370
75;Nouvelle-Aquitaine;86;1;08;106;Glénouze;98;2;100
75;Nouvelle-Aquitaine;86;2;10;107;Gouex;467;8;475
75;Nouvelle-Aquitaine;86;1;08;108;La Grimaudière;402;12;414
75;Nouvelle-Aquitaine;86;1;08;109;Guesnes;220;8;228
75;Nouvelle-Aquitaine;86;2;12;110;Haims;227;4;231
75;Nouvelle-Aquitaine;86;1;03;111;Ingrandes;1744;35;1779
75;Nouvelle-Aquitaine;86;2;10;112;L'Isle-Jourdain;1165;12;1177
75;Nouvelle-Aquitaine;86;3;18;113;Iteuil;2966;49;3015
75;Nouvelle-Aquitaine;86;3;01;114;Jardres;1279;23;1302
75;Nouvelle-Aquitaine;86;3;07;115;Jaunay-Marigny;7600;255;7855
75;Nouvelle-Aquitaine;86;3;09;116;Jazeneuil;783;17;800
75;Nouvelle-Aquitaine;86;2;12;117;Jouhet;525;7;532
75;Nouvelle-Aquitaine;86;2;12;118;Journet;373;9;382
75;Nouvelle-Aquitaine;86;2;06;119;Joussé;302;1;303
75;Nouvelle-Aquitaine;86;2;12;120;Lathus-Saint-Rémy;1217;16;1233
75;Nouvelle-Aquitaine;86;3;19;121;Latillé;1458;27;1485
75;Nouvelle-Aquitaine;86;2;05;122;Lauthiers;67;3;70
75;Nouvelle-Aquitaine;86;3;19;123;Boivre-la-Vallée;3073;52;3125
75;Nouvelle-Aquitaine;86;3;01;124;Lavoux;1185;19;1204
75;Nouvelle-Aquitaine;86;1;04;125;Leigné-les-Bois;596;13;609
75;Nouvelle-Aquitaine;86;2;05;126;Leignes-sur-Fontaine;644;13;657
75;Nouvelle-Aquitaine;86;1;03;127;Leigné-sur-Usseau;465;3;468
75;Nouvelle-Aquitaine;86;1;02;128;Lencloître;2457;31;2488
75;Nouvelle-Aquitaine;86;1;04;129;Lésigny;527;8;535
75;Nouvelle-Aquitaine;86;1;03;130;Leugny;382;4;386
75;Nouvelle-Aquitaine;86;2;10;131;Lhommaizé;883;24;907
75;Nouvelle-Aquitaine;86;2;12;132;Liglet;310;3;313
75;Nouvelle-Aquitaine;86;3;17;133;Ligugé;3374;59;3433
75;Nouvelle-Aquitaine;86;2;06;134;Linazay;221;1;222
75;Nouvelle-Aquitaine;86;3;01;135;Liniers;573;11;584
75;Nouvelle-Aquitaine;86;2;06;136;Lizant;391;8;399
75;Nouvelle-Aquitaine;86;1;08;137;Loudun;6712;351;7063
75;Nouvelle-Aquitaine;86;2;10;138;Luchapt;250;3;253
75;Nouvelle-Aquitaine;86;3;09;139;Lusignan;2659;38;2697
75;Nouvelle-Aquitaine;86;2;10;140;Lussac-les-Châteaux;2294;50;2344
75;Nouvelle-Aquitaine;86;2;06;141;Magné;674;14;688
75;Nouvelle-Aquitaine;86;3;19;142;Maillé;642;12;654
75;Nouvelle-Aquitaine;86;1;04;143;Mairé;169;5;174
75;Nouvelle-Aquitaine;86;3;11;144;Maisonneuve;328;8;336
75;Nouvelle-Aquitaine;86;3;18;145;Marçay;1228;15;1243
75;Nouvelle-Aquitaine;86;3;18;147;Marigny-Chemereau;605;12;617
75;Nouvelle-Aquitaine;86;3;18;148;Marnay;712;12;724
75;Nouvelle-Aquitaine;86;1;08;149;Martaizé;376;9;385
75;Nouvelle-Aquitaine;86;3;11;150;Massognes;274;7;281
75;Nouvelle-Aquitaine;86;1;08;151;Maulay;174;8;182
75;Nouvelle-Aquitaine;86;2;06;152;Mauprévoir;583;15;598
75;Nouvelle-Aquitaine;86;2;10;153;Mazerolles;862;13;875
75;Nouvelle-Aquitaine;86;1;08;154;Mazeuil;263;4;267
75;Nouvelle-Aquitaine;86;1;08;156;Messemé;239;4;243
75;Nouvelle-Aquitaine;86;3;16;157;Mignaloux-Beauvoir;5026;176;5202
75;Nouvelle-Aquitaine;86;3;11;158;Migné-Auxances;6154;117;6271
75;Nouvelle-Aquitaine;86;2;10;159;Millac;552;14;566
75;Nouvelle-Aquitaine;86;3;11;160;Mirebeau;2171;34;2205
75;Nouvelle-Aquitaine;86;1;08;161;Moncontour;998;19;1017
75;Nouvelle-Aquitaine;86;1;03;162;Mondion;110;1;111
75;Nouvelle-Aquitaine;86;3;01;163;Montamisé;3677;61;3738
75;Nouvelle-Aquitaine;86;1;05;164;Monthoiron;665;5;670
75;Nouvelle-Aquitaine;86;2;12;165;Montmorillon;5940;459;6399
75;Nouvelle-Aquitaine;86;1;08;167;Monts-sur-Guesnes;909;7;916
75;Nouvelle-Aquitaine;86;1;08;169;Morton;348;5;353
75;Nouvelle-Aquitaine;86;2;12;170;Moulismes;367;12;379
75;Nouvelle-Aquitaine;86;2;10;171;Moussac;441;14;455
75;Nouvelle-Aquitaine;86;2;10;172;Mouterre-sur-Blourde;162;4;166
75;Nouvelle-Aquitaine;86;1;08;173;Mouterre-Silly;661;12;673
75;Nouvelle-Aquitaine;86;1;02;174;Naintré;5941;119;6060
75;Nouvelle-Aquitaine;86;2;12;175;Nalliers;312;12;324
75;Nouvelle-Aquitaine;86;2;10;176;Nérignac;123;5;128
75;Nouvelle-Aquitaine;86;3;11;177;Neuville-de-Poitou;5359;84;5443
75;Nouvelle-Aquitaine;86;3;18;178;Nieuil-l'Espoir;2757;38;2795
75;Nouvelle-Aquitaine;86;3;18;180;Nouaillé-Maupertuis;2847;52;2899
75;Nouvelle-Aquitaine;86;1;08;181;Nueil-sous-Faye;208;5;213
75;Nouvelle-Aquitaine;86;1;03;182;Orches;378;9;387
75;Nouvelle-Aquitaine;86;1;03;183;Les Ormes;1606;21;1627
75;Nouvelle-Aquitaine;86;1;02;184;Ouzilly;939;11;950
75;Nouvelle-Aquitaine;86;1;03;186;Oyré;952;23;975
75;Nouvelle-Aquitaine;86;2;05;187;Paizay-le-Sec;458;14;472
75;Nouvelle-Aquitaine;86;2;06;189;Payroux;475;6;481
75;Nouvelle-Aquitaine;86;2;10;190;Persac;737;14;751
75;Nouvelle-Aquitaine;86;2;12;191;Pindray;248;7;255
75;Nouvelle-Aquitaine;86;2;12;192;Plaisance;174;4;178
75;Nouvelle-Aquitaine;86;1;04;193;Pleumartin;1217;13;1230
75;Nouvelle-Aquitaine;86;3;99;194;Poitiers;89212;2275;91487
75;Nouvelle-Aquitaine;86;1;03;195;Port-de-Piles;571;11;582
75;Nouvelle-Aquitaine;86;1;08;196;Pouançay;234;5;239
75;Nouvelle-Aquitaine;86;1;08;197;Pouant;416;11;427
75;Nouvelle-Aquitaine;86;3;01;198;Pouillé;692;9;701
75;Nouvelle-Aquitaine;86;2;06;200;Pressac;572;12;584
75;Nouvelle-Aquitaine;86;1;08;201;Prinçay;212;2;214
75;Nouvelle-Aquitaine;86;3;12;202;La Puye;599;10;609
75;Nouvelle-Aquitaine;86;2;10;203;Queaux;547;11;558
75;Nouvelle-Aquitaine;86;3;19;204;Quinçay;2160;56;2216
75;Nouvelle-Aquitaine;86;1;08;205;Ranton;200;3;203
75;Nouvelle-Aquitaine;86;1;08;206;Raslay;138;5;143
75;Nouvelle-Aquitaine;86;1;04;207;La Roche-Posay;1560;31;1591
75;Nouvelle-Aquitaine;86;3;18;209;Roches-Prémarie-Andillé;2034;32;2066
75;Nouvelle-Aquitaine;86;1;08;210;Roiffé;753;20;773
75;Nouvelle-Aquitaine;86;2;09;211;Romagne;905;92;997
75;Nouvelle-Aquitaine;86;3;09;213;Rouillé;2496;185;2681
75;Nouvelle-Aquitaine;86;3;17;214;Saint-Benoît;7267;247;7514
75;Nouvelle-Aquitaine;86;1;03;217;Saint-Christophe;290;12;302
75;Nouvelle-Aquitaine;86;1;08;218;Saint-Clair;198;8;206
75;Nouvelle-Aquitaine;86;2;06;220;Saint-Gaudent;313;8;321
75;Nouvelle-Aquitaine;86;1;02;221;Saint-Genest-d'Ambière;1205;22;1227
75;Nouvelle-Aquitaine;86;3;07;222;Saint-Georges-lès-Baillargeaux;4233;56;4289
75;Nouvelle-Aquitaine;86;2;12;223;Saint-Germain;915;25;940
75;Nouvelle-Aquitaine;86;1;03;224;Saint-Gervais-les-Trois-Clochers;1327;32;1359
75;Nouvelle-Aquitaine;86;1;08;225;Saint-Jean-de-Sauves;1408;29;1437
75;Nouvelle-Aquitaine;86;3;01;226;Saint-Julien-l'Ars;2779;49;2828
75;Nouvelle-Aquitaine;86;1;08;227;Saint-Laon;133;4;137
75;Nouvelle-Aquitaine;86;2;10;228;Saint-Laurent-de-Jourdes;198;3;201
75;Nouvelle-Aquitaine;86;1;08;229;Saint-Léger-de-Montbrillais;338;5;343
75;Nouvelle-Aquitaine;86;2;12;230;Saint-Léomer;174;4;178
75;Nouvelle-Aquitaine;86;2;06;231;Saint-Macoux;485;17;502
75;Nouvelle-Aquitaine;86;2;05;233;Valdivienne;2749;43;2792
75;Nouvelle-Aquitaine;86;2;06;234;Saint-Martin-l'Ars;385;5;390
75;Nouvelle-Aquitaine;86;2;10;235;Saint-Maurice-la-Clouère;1299;36;1335
75;Nouvelle-Aquitaine;86;2;12;236;Saint-Pierre-de-Maillé;885;16;901
75;Nouvelle-Aquitaine;86;2;06;237;Saint-Pierre-d'Exideuil;769;20;789
75;Nouvelle-Aquitaine;86;3;05;239;Sainte-Radégonde;172;0;172
75;Nouvelle-Aquitaine;86;1;03;241;Saint-Rémy-sur-Creuse;391;6;397
75;Nouvelle-Aquitaine;86;2;06;242;Saint-Romain;394;7;401
75;Nouvelle-Aquitaine;86;3;09;244;Saint-Sauvant;1255;24;1279
75;Nouvelle-Aquitaine;86;1;04;245;Senillé-Saint-Sauveur;1795;43;1838
75;Nouvelle-Aquitaine;86;2;12;246;Saint-Savin;826;16;842
75;Nouvelle-Aquitaine;86;2;06;247;Saint-Saviol;534;13;547
75;Nouvelle-Aquitaine;86;2;10;248;Saint-Secondin;536;16;552
75;Nouvelle-Aquitaine;86;1;08;249;Saires;125;6;131
75;Nouvelle-Aquitaine;86;1;08;250;Saix;290;5;295
75;Nouvelle-Aquitaine;86;1;08;252;Sammarçolles;651;14;665
75;Nouvelle-Aquitaine;86;3;09;253;Sanxay;550;11;561
75;Nouvelle-Aquitaine;86;2;12;254;Saulgé;1005;11;1016
75;Nouvelle-Aquitaine;86;2;06;255;Savigné;1337;27;1364
75;Nouvelle-Aquitaine;86;3;01;256;Savigny-Lévescault;1187;25;1212
75;Nouvelle-Aquitaine;86;1;03;257;Savigny-sous-Faye;373;5;378
75;Nouvelle-Aquitaine;86;1;02;258;Scorbé-Clairvaux;2242;31;2273
75;Nouvelle-Aquitaine;86;1;03;260;Sérigny;311;1;312
75;Nouvelle-Aquitaine;86;3;01;261;Sèvres-Anxaumont;2236;77;2313
75;Nouvelle-Aquitaine;86;2;10;262;Sillars;593;15;608
75;Nouvelle-Aquitaine;86;3;18;263;Smarves;2892;44;2936
75;Nouvelle-Aquitaine;86;2;06;264;Sommières-du-Clain;753;17;770
75;Nouvelle-Aquitaine;86;1;03;265;Sossais;428;7;435
75;Nouvelle-Aquitaine;86;2;06;266;Surin;142;2;144
75;Nouvelle-Aquitaine;86;3;01;268;Tercé;1118;17;1135
75;Nouvelle-Aquitaine;86;1;08;269;Ternay;191;3;194
75;Nouvelle-Aquitaine;86;2;12;270;Thollet;151;3;154
75;Nouvelle-Aquitaine;86;3;11;271;Thurageau;814;14;828
75;Nouvelle-Aquitaine;86;1;02;272;Thuré;2858;151;3009
75;Nouvelle-Aquitaine;86;2;12;273;La Trimouille;859;23;882
75;Nouvelle-Aquitaine;86;1;08;274;Les Trois-Moutiers;1097;24;1121
75;Nouvelle-Aquitaine;86;1;03;275;Usseau;601;9;610
75;Nouvelle-Aquitaine;86;2;10;276;Usson-du-Poitou;1251;22;1273
75;Nouvelle-Aquitaine;86;1;03;279;Vaux-sur-Vienne;532;6;538
75;Nouvelle-Aquitaine;86;1;03;280;Vellèches;358;5;363
75;Nouvelle-Aquitaine;86;3;07;281;Saint-Martin-la-Pallu;5578;88;5666
75;Nouvelle-Aquitaine;86;3;18;284;Vernon;714;21;735
75;Nouvelle-Aquitaine;86;2;10;285;Verrières;969;25;994
75;Nouvelle-Aquitaine;86;1;08;286;Verrue;389;4;393
75;Nouvelle-Aquitaine;86;1;08;287;Vézières;357;6;363
75;Nouvelle-Aquitaine;86;1;04;288;Vicq-sur-Gartempe;607;7;614
75;Nouvelle-Aquitaine;86;2;10;289;Le Vigeant;676;30;706
75;Nouvelle-Aquitaine;86;3;18;290;La Villedieu-du-Clain;1555;35;1590
75;Nouvelle-Aquitaine;86;2;12;291;Villemort;102;7;109
75;Nouvelle-Aquitaine;86;3;11;292;Villiers;920;18;938
75;Nouvelle-Aquitaine;86;3;18;293;Vivonne;4409;75;4484
75;Nouvelle-Aquitaine;86;3;19;294;Vouillé;3683;73;3756
75;Nouvelle-Aquitaine;86;2;06;295;Voulême;391;5;396
75;Nouvelle-Aquitaine;86;2;09;296;Voulon;471;7;478
75;Nouvelle-Aquitaine;86;3;19;297;Vouneuil-sous-Biard;6060;142;6202
75;Nouvelle-Aquitaine;86;1;05;298;Vouneuil-sur-Vienne;2264;31;2295
75;Nouvelle-Aquitaine;86;3;11;299;Vouzailles;575;9;584
75;Nouvelle-Aquitaine;86;3;11;300;Yversay;602;5;607
75;Nouvelle-Aquitaine;87;2;01;001;Aixe-sur-Vienne;5804;78;5882
75;Nouvelle-Aquitaine;87;2;02;002;Ambazac;5593;74;5667
75;Nouvelle-Aquitaine;87;1;04;003;Arnac-la-Poste;936;26;962
75;Nouvelle-Aquitaine;87;2;07;004;Augne;109;2;111
75;Nouvelle-Aquitaine;87;2;20;005;Aureil;1008;20;1028
75;Nouvelle-Aquitaine;87;1;04;006;Azat-le-Ris;246;1;247
75;Nouvelle-Aquitaine;87;1;04;007;Balledent;196;3;199
75;Nouvelle-Aquitaine;87;1;04;008;La Bazeuge;147;0;147
75;Nouvelle-Aquitaine;87;2;07;009;Beaumont-du-Lac;142;5;147
75;Nouvelle-Aquitaine;87;1;03;011;Bellac;3639;127;3766
75;Nouvelle-Aquitaine;87;1;03;012;Berneuil;437;5;442
75;Nouvelle-Aquitaine;87;2;02;013;Bersac-sur-Rivalier;651;16;667
75;Nouvelle-Aquitaine;87;1;02;014;Bessines-sur-Gartempe;2803;57;2860
75;Nouvelle-Aquitaine;87;2;01;015;Beynac;702;73;775
75;Nouvelle-Aquitaine;87;2;02;016;Les Billanges;282;6;288
75;Nouvelle-Aquitaine;87;1;03;017;Blanzac;499;11;510
75;Nouvelle-Aquitaine;87;1;03;018;Blond;696;24;720
75;Nouvelle-Aquitaine;87;2;05;019;Boisseuil;2926;63;2989
75;Nouvelle-Aquitaine;87;2;02;020;Bonnac-la-Côte;1651;27;1678
75;Nouvelle-Aquitaine;87;2;01;021;Bosmie-l'Aiguille;2616;34;2650
75;Nouvelle-Aquitaine;87;1;03;022;Breuilaufa;120;1;121
75;Nouvelle-Aquitaine;87;1;03;023;Le Buis;188;4;192
75;Nouvelle-Aquitaine;87;2;07;024;Bujaleuf;814;9;823
75;Nouvelle-Aquitaine;87;2;01;025;Burgnac;848;12;860
75;Nouvelle-Aquitaine;87;2;21;027;Bussière-Galant;1282;16;1298
75;Nouvelle-Aquitaine;87;1;04;028;Val-d'Oire-et-Gartempe;1646;22;1668
75;Nouvelle-Aquitaine;87;2;21;029;Les Cars;629;11;640
75;Nouvelle-Aquitaine;87;3;19;030;Chaillac-sur-Vienne;1257;23;1280
75;Nouvelle-Aquitaine;87;2;21;031;Le Chalard;310;4;314
75;Nouvelle-Aquitaine;87;2;21;032;Châlus;1640;29;1669
75;Nouvelle-Aquitaine;87;1;03;033;Chamboret;791;9;800
75;Nouvelle-Aquitaine;87;3;18;034;Champagnac-la-Rivière;566;8;574
75;Nouvelle-Aquitaine;87;2;20;035;Champnétery;530;9;539
75;Nouvelle-Aquitaine;87;3;18;036;Champsac;669;11;680
75;Nouvelle-Aquitaine;87;3;18;037;La Chapelle-Montbrandeix;262;2;264
75;Nouvelle-Aquitaine;87;2;06;038;Chaptelat;2102;18;2120
75;Nouvelle-Aquitaine;87;2;07;039;Château-Chervix;800;13;813
75;Nouvelle-Aquitaine;87;2;07;040;Châteauneuf-la-Forêt;1523;20;1543
75;Nouvelle-Aquitaine;87;1;04;041;Châteauponsac;2042;21;2063
75;Nouvelle-Aquitaine;87;2;20;042;Le Châtenet-en-Dognon;388;6;394
75;Nouvelle-Aquitaine;87;2;07;043;Cheissoux;204;2;206
75;Nouvelle-Aquitaine;87;3;18;044;Chéronnac;323;6;329
75;Nouvelle-Aquitaine;87;1;03;045;Cieux;1002;13;1015
75;Nouvelle-Aquitaine;87;3;18;046;Cognac-la-Forêt;1188;9;1197
75;Nouvelle-Aquitaine;87;1;03;047;Compreignac;1854;16;1870
75;Nouvelle-Aquitaine;87;2;05;048;Condat-sur-Vienne;5128;73;5201
75;Nouvelle-Aquitaine;87;2;07;049;Coussac-Bonneval;1317;34;1351
75;Nouvelle-Aquitaine;87;2;06;050;Couzeix;9518;161;9679
75;Nouvelle-Aquitaine;87;2;07;051;La Croisille-sur-Briance;624;12;636
75;Nouvelle-Aquitaine;87;1;04;052;La Croix-sur-Gartempe;180;1;181
75;Nouvelle-Aquitaine;87;1;04;053;Cromac;244;2;246
75;Nouvelle-Aquitaine;87;3;18;054;Cussac;1192;18;1210
75;Nouvelle-Aquitaine;87;1;04;056;Dinsac;275;3;278
75;Nouvelle-Aquitaine;87;1;04;057;Dompierre-les-Églises;369;5;374
75;Nouvelle-Aquitaine;87;2;07;058;Domps;107;3;110
75;Nouvelle-Aquitaine;87;1;04;059;Le Dorat;1586;64;1650
75;Nouvelle-Aquitaine;87;3;18;060;Dournazac;671;9;680
75;Nouvelle-Aquitaine;87;1;04;061;Droux;346;5;351
75;Nouvelle-Aquitaine;87;2;20;062;Eybouleuf;457;8;465
75;Nouvelle-Aquitaine;87;2;05;063;Eyjeaux;1316;22;1338
75;Nouvelle-Aquitaine;87;2;07;064;Eymoutiers;2077;24;2101
75;Nouvelle-Aquitaine;87;2;17;065;Feytiat;6118;78;6196
75;Nouvelle-Aquitaine;87;2;21;066;Flavignac;1075;11;1086
75;Nouvelle-Aquitaine;87;1;02;067;Folles;466;9;475
75;Nouvelle-Aquitaine;87;1;02;068;Fromental;517;16;533
75;Nouvelle-Aquitaine;87;1;03;069;Gajoubert;140;1;141
75;Nouvelle-Aquitaine;87;2;20;070;La Geneytouse;975;17;992
75;Nouvelle-Aquitaine;87;2;21;071;Glandon;780;18;798
75;Nouvelle-Aquitaine;87;2;07;072;Glanges;507;10;517
75;Nouvelle-Aquitaine;87;3;18;073;Gorre;388;9;397
75;Nouvelle-Aquitaine;87;1;04;074;Les Grands-Chézeaux;246;2;248
75;Nouvelle-Aquitaine;87;2;16;075;Isle;7847;151;7998
75;Nouvelle-Aquitaine;87;2;02;076;Jabreilles-les-Bordes;235;3;238
75;Nouvelle-Aquitaine;87;2;21;077;Janailhac;527;9;536
75;Nouvelle-Aquitaine;87;3;19;078;Javerdat;695;5;700
75;Nouvelle-Aquitaine;87;2;02;079;La Jonchère-Saint-Maurice;839;12;851
75;Nouvelle-Aquitaine;87;1;04;080;Jouac;179;3;182
75;Nouvelle-Aquitaine;87;2;01;081;Jourgnac;1106;14;1120
75;Nouvelle-Aquitaine;87;2;21;082;Ladignac-le-Long;1165;12;1177
75;Nouvelle-Aquitaine;87;2;02;083;Laurière;543;7;550
75;Nouvelle-Aquitaine;87;2;21;084;Lavignac;165;4;169
75;Nouvelle-Aquitaine;87;2;99;085;Limoges;130876;2260;133136
75;Nouvelle-Aquitaine;87;2;07;086;Linards;1030;16;1046
75;Nouvelle-Aquitaine;87;1;04;087;Lussac-les-Églises;488;3;491
75;Nouvelle-Aquitaine;87;2;07;088;Magnac-Bourg;1106;20;1126
75;Nouvelle-Aquitaine;87;1;04;089;Magnac-Laval;1711;168;1879
75;Nouvelle-Aquitaine;87;1;04;090;Mailhac-sur-Benaize;265;5;270
75;Nouvelle-Aquitaine;87;3;18;091;Maisonnais-sur-Tardoire;384;7;391
75;Nouvelle-Aquitaine;87;3;18;092;Marval;500;6;506
75;Nouvelle-Aquitaine;87;2;07;093;Masléon;281;3;284
75;Nouvelle-Aquitaine;87;2;21;094;Meilhac;527;5;532
75;Nouvelle-Aquitaine;87;2;07;095;Meuzac;733;13;746
75;Nouvelle-Aquitaine;87;2;21;096;La Meyze;847;20;867
75;Nouvelle-Aquitaine;87;1;03;097;Val d'Issoire;1025;12;1037
75;Nouvelle-Aquitaine;87;2;20;099;Moissannes;337;16;353
75;Nouvelle-Aquitaine;87;1;03;100;Montrol-Sénard;268;2;270
75;Nouvelle-Aquitaine;87;1;03;101;Mortemart;119;1;120
75;Nouvelle-Aquitaine;87;1;03;103;Nantiat;1614;25;1639
75;Nouvelle-Aquitaine;87;2;07;104;Nedde;456;4;460
75;Nouvelle-Aquitaine;87;2;07;105;Neuvic-Entier;923;17;940
75;Nouvelle-Aquitaine;87;2;21;106;Nexon;2509;45;2554
75;Nouvelle-Aquitaine;87;2;06;107;Nieul;1635;18;1653
75;Nouvelle-Aquitaine;87;1;03;108;Nouic;461;5;466
75;Nouvelle-Aquitaine;87;1;04;109;Oradour-Saint-Genest;329;34;363
75;Nouvelle-Aquitaine;87;3;19;110;Oradour-sur-Glane;2477;22;2499
75;Nouvelle-Aquitaine;87;3;18;111;Oradour-sur-Vayres;1490;20;1510
75;Nouvelle-Aquitaine;87;2;21;112;Pageas;576;13;589
75;Nouvelle-Aquitaine;87;2;12;113;Le Palais-sur-Vienne;6023;64;6087
75;Nouvelle-Aquitaine;87;2;17;114;Panazol;10900;212;11112
75;Nouvelle-Aquitaine;87;3;18;115;Pensol;173;2;175
75;Nouvelle-Aquitaine;87;1;03;116;Peyrat-de-Bellac;1044;24;1068
75;Nouvelle-Aquitaine;87;2;07;117;Peyrat-le-Château;1027;16;1043
75;Nouvelle-Aquitaine;87;2;06;118;Peyrilhac;1278;13;1291
75;Nouvelle-Aquitaine;87;2;05;119;Pierre-Buffière;1161;11;1172
75;Nouvelle-Aquitaine;87;2;07;120;La Porcherie;504;11;515
75;Nouvelle-Aquitaine;87;1;04;121;Rancon;488;11;499
75;Nouvelle-Aquitaine;87;1;02;122;Razès;1173;13;1186
75;Nouvelle-Aquitaine;87;2;07;123;Rempnat;149;4;153
75;Nouvelle-Aquitaine;87;2;21;124;Rilhac-Lastours;373;2;375
75;Nouvelle-Aquitaine;87;2;12;125;Rilhac-Rancon;4608;65;4673
75;Nouvelle-Aquitaine;87;3;18;126;Rochechouart;3767;51;3818
75;Nouvelle-Aquitaine;87;2;21;127;La Roche-l'Abeille;604;13;617
75;Nouvelle-Aquitaine;87;1;03;128;Saint-Pardoux-le-Lac;1327;13;1340
75;Nouvelle-Aquitaine;87;2;20;129;Royères;955;7;962
75;Nouvelle-Aquitaine;87;2;07;130;Roziers-Saint-Georges;172;0;172
75;Nouvelle-Aquitaine;87;3;19;131;Saillat-sur-Vienne;812;12;824
75;Nouvelle-Aquitaine;87;2;07;132;Saint-Amand-le-Petit;110;4;114
75;Nouvelle-Aquitaine;87;1;04;133;Saint-Amand-Magnazeix;496;4;500
75;Nouvelle-Aquitaine;87;2;07;134;Sainte-Anne-Saint-Priest;155;3;158
75;Nouvelle-Aquitaine;87;3;18;135;Saint-Auvent;960;18;978
75;Nouvelle-Aquitaine;87;3;18;137;Saint-Bazile;129;2;131
75;Nouvelle-Aquitaine;87;2;05;138;Saint-Bonnet-Briance;571;14;585
75;Nouvelle-Aquitaine;87;1;03;139;Saint-Bonnet-de-Bellac;460;8;468
75;Nouvelle-Aquitaine;87;3;19;140;Saint-Brice-sur-Vienne;1682;17;1699
75;Nouvelle-Aquitaine;87;3;18;141;Saint-Cyr;683;10;693
75;Nouvelle-Aquitaine;87;2;20;142;Saint-Denis-des-Murs;541;7;548
75;Nouvelle-Aquitaine;87;2;06;143;Saint-Gence;2170;27;2197
75;Nouvelle-Aquitaine;87;2;05;144;Saint-Genest-sur-Roselle;518;5;523
75;Nouvelle-Aquitaine;87;1;04;145;Saint-Georges-les-Landes;237;1;238
75;Nouvelle-Aquitaine;87;2;07;146;Saint-Germain-les-Belles;1159;13;1172
75;Nouvelle-Aquitaine;87;2;07;147;Saint-Gilles-les-Forêts;47;2;49
75;Nouvelle-Aquitaine;87;2;05;148;Saint-Hilaire-Bonneval;990;12;1002
75;Nouvelle-Aquitaine;87;1;04;149;Saint-Hilaire-la-Treille;374;8;382
75;Nouvelle-Aquitaine;87;2;21;150;Saint-Hilaire-les-Places;849;14;863
75;Nouvelle-Aquitaine;87;2;05;151;Saint-Jean-Ligoure;500;9;509
75;Nouvelle-Aquitaine;87;2;06;152;Saint-Jouvent;1658;23;1681
75;Nouvelle-Aquitaine;87;2;07;153;Saint-Julien-le-Petit;291;0;291
75;Nouvelle-Aquitaine;87;3;19;154;Saint-Junien;11254;277;11531
75;Nouvelle-Aquitaine;87;1;03;155;Saint-Junien-les-Combes;179;7;186
75;Nouvelle-Aquitaine;87;2;20;156;Saint-Just-le-Martel;2670;46;2716
75;Nouvelle-Aquitaine;87;2;02;157;Saint-Laurent-les-Églises;843;34;877
75;Nouvelle-Aquitaine;87;3;18;158;Saint-Laurent-sur-Gorre;1439;14;1453
75;Nouvelle-Aquitaine;87;2;02;159;Saint-Léger-la-Montagne;350;3;353
75;Nouvelle-Aquitaine;87;1;04;160;Saint-Léger-Magnazeix;495;4;499
75;Nouvelle-Aquitaine;87;2;20;161;Saint-Léonard-de-Noblat;4385;115;4500
75;Nouvelle-Aquitaine;87;3;18;162;Sainte-Marie-de-Vaux;204;2;206
75;Nouvelle-Aquitaine;87;1;03;163;Saint-Martial-sur-Isop;140;4;144
75;Nouvelle-Aquitaine;87;3;19;164;Saint-Martin-de-Jussac;568;10;578
75;Nouvelle-Aquitaine;87;1;04;165;Saint-Martin-le-Mault;137;1;138
75;Nouvelle-Aquitaine;87;2;01;166;Saint-Martin-le-Vieux;930;16;946
75;Nouvelle-Aquitaine;87;2;20;167;Saint-Martin-Terressus;553;5;558
75;Nouvelle-Aquitaine;87;3;18;168;Saint-Mathieu;1079;14;1093
75;Nouvelle-Aquitaine;87;2;05;169;Saint-Maurice-les-Brousses;1052;25;1077
75;Nouvelle-Aquitaine;87;2;07;170;Saint-Méard;351;7;358
75;Nouvelle-Aquitaine;87;1;04;172;Saint-Ouen-sur-Gartempe;216;5;221
75;Nouvelle-Aquitaine;87;2;05;174;Saint-Paul;1227;23;1250
75;Nouvelle-Aquitaine;87;2;07;176;Saint-Priest-Ligoure;667;12;679
75;Nouvelle-Aquitaine;87;2;01;177;Saint-Priest-sous-Aixe;1790;19;1809
75;Nouvelle-Aquitaine;87;2;20;178;Saint-Priest-Taurion;2888;32;2920
75;Nouvelle-Aquitaine;87;1;04;179;Saint-Sornin-la-Marche;241;0;241
75;Nouvelle-Aquitaine;87;1;04;180;Saint-Sornin-Leulac;577;4;581
75;Nouvelle-Aquitaine;87;2;02;181;Saint-Sulpice-Laurière;825;17;842
75;Nouvelle-Aquitaine;87;1;04;182;Saint-Sulpice-les-Feuilles;1203;17;1220
75;Nouvelle-Aquitaine;87;2;02;183;Saint-Sylvestre;919;10;929
75;Nouvelle-Aquitaine;87;3;19;185;Saint-Victurnien;1774;29;1803
75;Nouvelle-Aquitaine;87;2;07;186;Saint-Vitte-sur-Briance;320;4;324
75;Nouvelle-Aquitaine;87;2;21;187;Saint-Yrieix-la-Perche;6718;432;7150
75;Nouvelle-Aquitaine;87;2;01;188;Saint-Yrieix-sous-Aixe;432;3;435
75;Nouvelle-Aquitaine;87;3;18;189;Les Salles-Lavauguyon;139;1;140
75;Nouvelle-Aquitaine;87;2;20;190;Sauviat-sur-Vige;870;7;877
75;Nouvelle-Aquitaine;87;2;01;191;Séreilhac;1989;23;2012
75;Nouvelle-Aquitaine;87;2;05;192;Solignac;1583;24;1607
75;Nouvelle-Aquitaine;87;2;07;193;Surdoux;44;3;47
75;Nouvelle-Aquitaine;87;2;07;194;Sussac;347;3;350
75;Nouvelle-Aquitaine;87;1;04;195;Tersannes;135;1;136
75;Nouvelle-Aquitaine;87;1;03;197;Thouron;565;9;574
75;Nouvelle-Aquitaine;87;1;03;198;Vaulry;413;5;418
75;Nouvelle-Aquitaine;87;3;18;199;Vayres;734;13;747
75;Nouvelle-Aquitaine;87;1;04;200;Verneuil-Moustiers;129;0;129
75;Nouvelle-Aquitaine;87;2;01;201;Verneuil-sur-Vienne;4881;217;5098
75;Nouvelle-Aquitaine;87;2;06;202;Veyrac;2112;35;2147
75;Nouvelle-Aquitaine;87;2;07;203;Vicq-sur-Breuilh;1327;27;1354
75;Nouvelle-Aquitaine;87;3;18;204;Videix;204;4;208
75;Nouvelle-Aquitaine;87;2;05;205;Le Vigen;2236;40;2276
75;Nouvelle-Aquitaine;87;1;04;206;Villefavard;159;1;160
44;Grand Est;88;1;04;001;Les Ableuvenettes;58;0;58
44;Grand Est;88;1;04;002;Ahéville;75;0;75
44;Grand Est;88;2;17;003;Aingeville;62;1;63
44;Grand Est;88;2;04;004;Ainvelle;133;6;139
44;Grand Est;88;3;11;005;Allarmont;203;4;207
44;Grand Est;88;1;09;006;Ambacourt;290;8;298
44;Grand Est;88;2;04;007;Ameuvelle;48;1;49
44;Grand Est;88;1;11;008;Anglemont;168;3;171
44;Grand Est;88;3;07;009;Anould;3368;68;3436
44;Grand Est;88;2;09;010;Aouze;198;1;199
44;Grand Est;88;1;05;011;Arches;1634;53;1687
44;Grand Est;88;1;06;012;Archettes;1105;13;1118
44;Grand Est;88;2;09;013;Aroffe;86;0;86
44;Grand Est;88;3;07;014;Arrentès-de-Corcieux;183;5;188
44;Grand Est;88;2;10;015;Attignéville;206;3;209
44;Grand Est;88;2;04;016;Attigny;212;9;221
44;Grand Est;88;2;17;017;Aulnois;166;6;172
44;Grand Est;88;2;10;019;Autigny-la-Tour;149;3;152
44;Grand Est;88;2;10;020;Autreville;188;5;193
44;Grand Est;88;1;13;021;Autrey;283;12;295
44;Grand Est;88;2;17;022;Auzainvilliers;234;6;240
44;Grand Est;88;1;03;023;Avillers;81;2;83
44;Grand Est;88;1;03;024;Avrainville;114;0;114
44;Grand Est;88;2;10;025;Avranville;69;3;72
44;Grand Est;88;1;02;026;Aydoilles;1009;48;1057
44;Grand Est;88;1;02;027;Badménil-aux-Bois;144;6;150
44;Grand Est;88;1;06;028;La Baffe;618;95;713
44;Grand Est;88;1;16;029;La Vôge-les-Bains;1609;126;1735
44;Grand Est;88;1;04;030;Bainville-aux-Saules;147;0;147
44;Grand Est;88;2;09;031;Balléville;99;4;103
44;Grand Est;88;3;14;032;Ban-de-Laveline;1199;33;1232
44;Grand Est;88;3;11;033;Ban-de-Sapt;350;7;357
44;Grand Est;88;3;07;035;Barbey-Seroux;145;6;151
44;Grand Est;88;2;10;036;Barville;96;2;98
44;Grand Est;88;3;01;037;Basse-sur-le-Rupt;871;27;898
44;Grand Est;88;1;03;038;Battexey;36;0;36
44;Grand Est;88;1;09;039;Baudricourt;331;7;338
44;Grand Est;88;1;02;040;Bayecourt;250;5;255
44;Grand Est;88;1;04;041;Bazegney;109;8;117
44;Grand Est;88;1;11;042;Bazien;80;1;81
44;Grand Est;88;2;17;043;Bazoilles-et-Ménil;110;3;113
44;Grand Est;88;2;10;044;Bazoilles-sur-Meuse;603;16;619
44;Grand Est;88;2;10;045;Beaufremont;87;0;87
44;Grand Est;88;1;02;046;Beauménil;130;4;134
44;Grand Est;88;1;04;047;Begnécourt;148;7;155
44;Grand Est;88;1;16;048;Bellefontaine;981;26;1007
44;Grand Est;88;2;04;049;Belmont-lès-Darney;113;2;115
44;Grand Est;88;1;02;050;Belmont-sur-Buttant;303;5;308
44;Grand Est;88;2;17;051;Belmont-sur-Vair;133;1;134
44;Grand Est;88;2;04;052;Belrupt;97;2;99
44;Grand Est;88;3;11;053;Belval;161;2;163
44;Grand Est;88;3;14;054;Bertrimoutier;306;10;316
44;Grand Est;88;1;03;055;Bettegney-Saint-Brice;164;0;164
44;Grand Est;88;1;03;056;Bettoncourt;96;2;98
44;Grand Est;88;3;14;057;Le Beulay;92;6;98
44;Grand Est;88;1;09;058;Biécourt;97;5;102
44;Grand Est;88;3;02;059;Biffontaine;398;12;410
44;Grand Est;88;1;09;060;Blémerey;32;1;33
44;Grand Est;88;2;04;061;Bleurville;298;13;311
44;Grand Est;88;2;04;062;Blevaincourt;98;2;100
44;Grand Est;88;1;04;063;Bocquegney;136;4;140
44;Grand Est;88;3;02;064;Bois-de-Champ;108;1;109
44;Grand Est;88;2;04;065;Bonvillet;288;5;293
44;Grand Est;88;1;09;066;Boulaincourt;68;4;72
44;Grand Est;88;3;13;068;La Bourgonce;899;20;919
44;Grand Est;88;1;03;069;Bouxières-aux-Bois;136;6;142
44;Grand Est;88;1;03;070;Bouxurulles;174;1;175
44;Grand Est;88;1;04;071;Bouzemont;52;1;53
44;Grand Est;88;1;03;073;Brantigny;213;4;217
44;Grand Est;88;2;10;074;Brechainville;60;0;60
44;Grand Est;88;3;01;075;La Bresse;4143;150;4293
44;Grand Est;88;1;02;076;Brouvelieures;433;10;443
44;Grand Est;88;1;11;077;Brû;566;14;580
44;Grand Est;88;1;02;078;Bruyères;3073;54;3127
44;Grand Est;88;2;17;079;Bulgnéville;1539;103;1642
44;Grand Est;88;1;03;080;Bult;306;2;308
44;Grand Est;88;1;15;081;Bussang;1349;23;1372
44;Grand Est;88;3;11;082;Celles-sur-Plaine;784;17;801
44;Grand Est;88;2;10;083;Certilleux;211;10;221
44;Grand Est;88;1;03;084;Chamagne;466;9;475
44;Grand Est;88;3;02;085;Champdray;187;2;189
44;Grand Est;88;1;02;086;Champ-le-Duc;518;24;542
44;Grand Est;88;1;05;087;Chantraine;3197;95;3292
44;Grand Est;88;1;16;088;La Chapelle-aux-Bois;672;8;680
44;Grand Est;88;3;07;089;La Chapelle-devant-Bruyères;562;14;576
44;Grand Est;88;1;03;090;Charmes;4690;55;4745
44;Grand Est;88;1;02;091;Charmois-devant-Bruyères;387;9;396
44;Grand Est;88;1;16;092;Charmois-l'Orgueilleux;587;8;595
44;Grand Est;88;3;11;093;Châtas;43;2;45
44;Grand Est;88;1;03;094;Châtel-sur-Moselle;1708;50;1758
44;Grand Est;88;2;09;095;Châtenois;1702;44;1746
44;Grand Est;88;2;04;096;Châtillon-sur-Saône;112;8;120
44;Grand Est;88;1;09;097;Chauffecourt;43;1;44
44;Grand Est;88;1;05;098;Chaumousey;901;25;926
44;Grand Est;88;1;08;099;Chavelot;1367;22;1389
44;Grand Est;88;1;09;100;Chef-Haut;46;2;48
44;Grand Est;88;1;02;101;Cheniménil;1236;24;1260
44;Grand Est;88;2;10;102;Chermisey;95;1;96
44;Grand Est;88;1;04;103;Circourt;87;2;89
44;Grand Est;88;2;10;104;Circourt-sur-Mouzon;185;10;195
44;Grand Est;88;2;04;105;Claudon;213;4;217
44;Grand Est;88;3;07;106;Ban-sur-Meurthe-Clefcy;946;29;975
44;Grand Est;88;2;10;107;Clérey-la-Côte;34;0;34
44;Grand Est;88;1;16;108;Le Clerjus;508;19;527
44;Grand Est;88;3;12;109;Cleurie;646;13;659
44;Grand Est;88;1;03;110;Clézentaine;219;5;224
44;Grand Est;88;3;14;111;Coinches;355;4;359
44;Grand Est;88;3;14;113;Combrimont;134;1;135
44;Grand Est;88;2;17;114;Contrexéville;3190;224;3414
44;Grand Est;88;3;07;115;Corcieux;1500;14;1514
44;Grand Est;88;3;01;116;Cornimont;3111;71;3182
44;Grand Est;88;2;09;117;Courcelles-sous-Châtenois;78;1;79
44;Grand Est;88;2;10;118;Coussey;713;20;733
44;Grand Est;88;2;17;119;Crainvilliers;174;2;176
44;Grand Est;88;3;14;120;La Croix-aux-Mines;486;9;495
44;Grand Est;88;1;03;121;Damas-aux-Bois;271;6;277
44;Grand Est;88;1;04;122;Damas-et-Bettegney;364;7;371
44;Grand Est;88;2;04;123;Damblain;252;5;257
44;Grand Est;88;2;04;124;Darney;1076;53;1129
44;Grand Est;88;2;09;125;Darney-aux-Chênes;66;1;67
44;Grand Est;88;1;08;126;Darnieulles;1380;31;1411
44;Grand Est;88;1;03;127;Deinvillers;59;2;61
44;Grand Est;88;3;11;128;Denipaire;249;5;254
44;Grand Est;88;1;03;129;Derbamont;114;3;117
44;Grand Est;88;1;02;130;Destord;248;4;252
44;Grand Est;88;1;02;131;Deycimont;307;14;321
44;Grand Est;88;1;06;132;Deyvillers;1361;38;1399
44;Grand Est;88;1;06;133;Dignonville;199;9;208
44;Grand Est;88;1;05;134;Dinozé;624;14;638
44;Grand Est;88;1;02;135;Docelles;864;17;881
44;Grand Est;88;1;06;136;Dogneville;1484;27;1511
44;Grand Est;88;2;09;137;Dolaincourt;100;0;100
44;Grand Est;88;2;04;138;Dombasle-devant-Darney;79;2;81
44;Grand Est;88;1;09;139;Dombasle-en-Xaintois;120;1;121
44;Grand Est;88;2;17;140;Dombrot-le-Sec;368;14;382
44;Grand Est;88;2;17;141;Dombrot-sur-Vair;239;3;242
44;Grand Est;88;1;08;142;Domèvre-sur-Avière;406;8;414
44;Grand Est;88;1;02;143;Domèvre-sur-Durbion;265;14;279
44;Grand Est;88;2;17;144;Domèvre-sous-Montfort;56;0;56
44;Grand Est;88;1;02;145;Domfaing;216;2;218
44;Grand Est;88;2;17;146;Domjulien;175;2;177
44;Grand Est;88;1;04;147;Dommartin-aux-Bois;382;5;387
44;Grand Est;88;1;15;148;Dommartin-lès-Remiremont;1882;51;1933
44;Grand Est;88;2;04;149;Dommartin-lès-Vallois;54;0;54
44;Grand Est;88;2;09;150;Dommartin-sur-Vraine;294;6;300
44;Grand Est;88;1;04;151;Dompaire;1108;28;1136
44;Grand Est;88;1;02;152;Dompierre;249;14;263
44;Grand Est;88;1;11;153;Domptail;346;8;354
44;Grand Est;88;2;10;154;Domrémy-la-Pucelle;91;2;93
44;Grand Est;88;1;09;155;Domvallier;101;8;109
44;Grand Est;88;1;11;156;Doncières;132;2;134
44;Grand Est;88;1;16;157;Dounoux;856;18;874
44;Grand Est;88;1;12;158;Éloyes;3122;60;3182
44;Grand Est;88;3;14;159;Entre-deux-Eaux;497;8;505
44;Grand Est;88;1;98;160;Épinal;32256;1450;33706
44;Grand Est;88;2;04;161;Escles;434;12;446
44;Grand Est;88;2;04;162;Esley;193;5;198
44;Grand Est;88;1;03;163;Essegney;745;9;754
44;Grand Est;88;2;17;164;Estrennes;94;1;95
44;Grand Est;88;3;11;165;Étival-Clairefontaine;2610;53;2663
44;Grand Est;88;1;03;166;Évaux-et-Ménil;356;3;359
44;Grand Est;88;1;01;167;Faucompierre;233;5;238
44;Grand Est;88;1;03;168;Fauconcourt;136;2;138
44;Grand Est;88;1;02;169;Fays;215;6;221
44;Grand Est;88;1;15;170;Ferdrupt;725;17;742
44;Grand Est;88;2;04;171;Fignévelle;47;1;48
44;Grand Est;88;1;02;172;Fiménil;227;4;231
44;Grand Est;88;1;03;173;Florémont;462;12;474
44;Grand Est;88;1;08;174;Fomerey;151;4;155
44;Grand Est;88;1;02;175;Fontenay;458;20;478
44;Grand Est;88;1;16;176;Fontenoy-le-Château;508;35;543
44;Grand Est;88;3;01;177;La Forge;520;11;531
44;Grand Est;88;1;05;178;Les Forges;1833;69;1902
44;Grand Est;88;2;04;179;Fouchécourt;44;3;47
44;Grand Est;88;2;04;180;Frain;126;2;128
44;Grand Est;88;3;07;181;Fraize;2841;46;2887
44;Grand Est;88;3;14;182;Frapelle;195;9;204
44;Grand Est;88;2;10;183;Frebécourt;335;7;342
44;Grand Est;88;1;02;184;Fremifontaine;440;11;451
44;Grand Est;88;1;09;185;Frenelle-la-Grande;109;4;113
44;Grand Est;88;1;09;186;Frenelle-la-Petite;46;0;46
44;Grand Est;88;2;04;187;Frénois;54;1;55
44;Grand Est;88;1;15;188;Fresse-sur-Moselle;1726;48;1774
44;Grand Est;88;2;10;189;Fréville;135;4;139
44;Grand Est;88;1;08;190;Frizon;521;6;527
44;Grand Est;88;1;04;192;Gelvécourt-et-Adompt;105;1;106
44;Grand Est;88;3;14;193;Gemaingoutte;145;1;146
44;Grand Est;88;2;17;194;Gemmelaincourt;140;12;152
44;Grand Est;88;2;17;195;Gendreville;105;3;108
44;Grand Est;88;3;07;196;Gérardmer;7807;624;8431
44;Grand Est;88;3;01;197;Gerbamont;352;11;363
44;Grand Est;88;3;07;198;Gerbépal;601;12;613
44;Grand Est;88;2;04;199;Gignéville;78;3;81
44;Grand Est;88;1;08;200;Gigney;53;1;54
44;Grand Est;88;1;04;201;Girancourt;900;14;914
44;Grand Est;88;1;03;202;Gircourt-lès-Viéville;191;3;194
44;Grand Est;88;1;02;203;Girecourt-sur-Durbion;351;11;362
44;Grand Est;88;1;16;205;Girmont-Val-d'Ajol;254;17;271
44;Grand Est;88;2;09;206;Gironcourt-sur-Vraine;889;17;906
44;Grand Est;88;2;04;208;Godoncourt;115;4;119
44;Grand Est;88;1;08;209;Golbey;8798;123;8921
44;Grand Est;88;1;04;210;Gorhey;173;6;179
44;Grand Est;88;2;10;212;Grand;351;10;361
44;Grand Est;88;3;14;213;La Grande-Fosse;135;0;135
44;Grand Est;88;2;16;214;Grandrupt-de-Bains;76;4;80
44;Grand Est;88;3;11;215;Grandrupt;77;2;79
44;Grand Est;88;1;02;216;Grandvillers;744;11;755
44;Grand Est;88;3;07;218;Granges-Aumontzey;2613;56;2669
44;Grand Est;88;2;10;219;Greux;149;6;155
44;Grand Est;88;2;04;220;Grignoncourt;46;1;47
44;Grand Est;88;1;16;221;Gruey-lès-Surance;237;11;248
44;Grand Est;88;1;02;222;Gugnécourt;253;19;272
44;Grand Est;88;1;03;223;Gugney-aux-Aulx;164;7;171
44;Grand Est;88;1;03;224;Hadigny-les-Verrières;388;12;400
44;Grand Est;88;1;16;225;Hadol;2359;105;2464
44;Grand Est;88;1;04;226;Hagécourt;126;3;129
44;Grand Est;88;2;17;227;Hagnéville-et-Roncourt;86;1;87
44;Grand Est;88;1;03;228;Haillainville;174;4;178
44;Grand Est;88;2;10;229;Harchéchamp;73;4;77
44;Grand Est;88;1;03;230;Hardancourt;40;0;40
44;Grand Est;88;2;17;231;Haréville;477;18;495
44;Grand Est;88;2;10;232;Harmonville;219;4;223
44;Grand Est;88;1;04;233;Harol;628;52;680
44;Grand Est;88;1;16;236;La Haye;125;0;125
44;Grand Est;88;1;04;237;Hennecourt;370;7;377
44;Grand Est;88;2;04;238;Hennezel;393;12;405
44;Grand Est;88;1;03;239;Hergugney;135;3;138
44;Grand Est;88;1;02;240;Herpelmont;279;2;281
44;Grand Est;88;2;09;241;Houécourt;441;12;453
44;Grand Est;88;2;10;242;Houéville;45;1;46
44;Grand Est;88;1;13;243;Housseras;485;7;492
44;Grand Est;88;3;07;244;La Houssière;547;18;565
44;Grand Est;88;3;11;245;Hurbache;319;13;332
44;Grand Est;88;1;09;246;Hymont;484;12;496
44;Grand Est;88;1;08;247;Igney;1160;14;1174
44;Grand Est;88;2;04;248;Isches;174;4;178
44;Grand Est;88;2;10;249;Jainvillotte;76;3;79
44;Grand Est;88;1;12;250;Jarménil;478;5;483
44;Grand Est;88;1;13;251;Jeanménil;1119;35;1154
44;Grand Est;88;2;04;252;Jésonville;132;7;139
44;Grand Est;88;1;06;253;Jeuxey;683;16;699
44;Grand Est;88;1;03;254;Jorxey;82;1;83
44;Grand Est;88;2;10;255;Jubainville;91;3;94
44;Grand Est;88;1;02;256;Jussarupt;270;5;275
44;Grand Est;88;1;09;257;Juvaincourt;179;3;182
44;Grand Est;88;2;04;258;Lamarche;858;16;874
44;Grand Est;88;2;10;259;Landaville;298;9;307
44;Grand Est;88;1;03;260;Langley;154;2;156
44;Grand Est;88;1;02;261;Laval-sur-Vologne;626;11;637
44;Grand Est;88;1;02;262;Laveline-devant-Bruyères;582;12;594
44;Grand Est;88;1;02;263;Laveline-du-Houx;206;6;212
44;Grand Est;88;1;04;264;Légéville-et-Bonfays;61;3;64
44;Grand Est;88;2;10;265;Lemmecourt;30;0;30
44;Grand Est;88;1;02;266;Lépanges-sur-Vologne;834;18;852
44;Grand Est;88;2;04;267;Lerrain;451;16;467
44;Grand Est;88;3;14;268;Lesseux;142;8;150
44;Grand Est;88;3;07;269;Liézey;297;7;304
44;Grand Est;88;2;10;270;Liffol-le-Grand;2124;61;2185
44;Grand Est;88;2;17;271;Lignéville;307;7;314
44;Grand Est;88;2;04;272;Lironcourt;71;0;71
44;Grand Est;88;1;06;273;Longchamp;456;11;467
44;Grand Est;88;2;09;274;Longchamp-sous-Châtenois;78;1;79
44;Grand Est;88;3;14;275;Lubine;239;2;241
44;Grand Est;88;3;14;276;Lusse;395;16;411
44;Grand Est;88;3;11;277;Luvigny;115;3;118
44;Grand Est;88;2;09;278;Maconcourt;72;1;73
44;Grand Est;88;1;09;279;Madecourt;50;1;51
44;Grand Est;88;1;03;280;Madegney;137;0;137
44;Grand Est;88;1;04;281;Madonne-et-Lamerey;405;12;417
44;Grand Est;88;2;17;283;Malaincourt;81;2;83
44;Grand Est;88;3;14;284;Mandray;581;12;593
44;Grand Est;88;2;17;285;Mandres-sur-Vair;440;129;569
44;Grand Est;88;1;03;286;Marainville-sur-Madon;98;0;98
44;Grand Est;88;2;04;287;Marey;63;1;64
44;Grand Est;88;1;04;288;Maroncourt;7;0;7
44;Grand Est;88;2;04;289;Martigny-les-Bains;816;66;882
44;Grand Est;88;2;10;290;Martigny-les-Gerbonvaux;105;2;107
44;Grand Est;88;2;04;291;Martinvelle;131;3;134
44;Grand Est;88;1;09;292;Mattaincourt;806;25;831
44;Grand Est;88;2;10;293;Maxey-sur-Meuse;216;4;220
44;Grand Est;88;1;08;294;Mazeley;263;3;266
44;Grand Est;88;1;09;295;Mazirot;228;7;235
44;Grand Est;88;2;17;296;Médonville;74;0;74
44;Grand Est;88;1;02;297;Méménil;157;5;162
44;Grand Est;88;1;11;298;Ménarmont;67;0;67
44;Grand Est;88;2;09;299;Ménil-en-Xaintois;147;1;148
44;Grand Est;88;3;11;300;Ménil-de-Senones;131;6;137
44;Grand Est;88;1;11;301;Ménil-sur-Belvitte;294;11;305
44;Grand Est;88;1;15;302;Le Ménil;1026;22;1048
44;Grand Est;88;2;10;303;Midrevaux;199;1;200
44;Grand Est;88;1;09;304;Mirecourt;4949;487;5436
44;Grand Est;88;2;10;305;Moncel-sur-Vair;196;5;201
44;Grand Est;88;3;11;306;Le Mont;51;0;51
44;Grand Est;88;2;04;307;Mont-lès-Lamarche;95;2;97
44;Grand Est;88;2;10;308;Mont-lès-Neufchâteau;302;5;307
44;Grand Est;88;2;17;309;Monthureux-le-Sec;159;9;168
44;Grand Est;88;2;04;310;Monthureux-sur-Saône;909;18;927
44;Grand Est;88;1;16;311;Montmotier;37;1;38
44;Grand Est;88;2;09;312;Morelmaison;197;5;202
44;Grand Est;88;1;03;313;Moriville;420;8;428
44;Grand Est;88;2;04;314;Morizécourt;101;4;105
44;Grand Est;88;3;02;315;Mortagne;171;2;173
44;Grand Est;88;2;17;316;Morville;48;2;50
44;Grand Est;88;3;11;317;Moussey;566;5;571
44;Grand Est;88;1;03;318;Moyemont;227;5;232
44;Grand Est;88;3;11;319;Moyenmoutier;3089;64;3153
44;Grand Est;88;3;14;320;Nayemont-les-Fosses;780;39;819
44;Grand Est;88;2;10;321;Neufchâteau;6636;284;6920
44;Grand Est;88;1;02;322;La Neuveville-devant-Lépanges;506;12;518
44;Grand Est;88;2;09;324;La Neuveville-sous-Châtenois;379;10;389
44;Grand Est;88;2;17;325;La Neuveville-sous-Montfort;183;7;190
44;Grand Est;88;3;14;326;Neuvillers-sur-Fave;349;10;359
44;Grand Est;88;1;03;327;Nomexy;2005;22;2027
44;Grand Est;88;3;11;328;Nompatelize;542;23;565
44;Grand Est;88;2;04;330;Nonville;195;2;197
44;Grand Est;88;1;02;331;Nonzeville;53;2;55
44;Grand Est;88;2;17;332;Norroy;215;6;221
44;Grand Est;88;1;11;333;Nossoncourt;123;1;124
44;Grand Est;88;1;09;334;Oëlleville;312;5;317
44;Grand Est;88;2;17;335;Offroicourt;154;3;157
44;Grand Est;88;2;09;336;Ollainville;73;1;74
44;Grand Est;88;1;03;338;Ortoncourt;84;0;84
44;Grand Est;88;1;02;340;Padoux;499;11;510
44;Grand Est;88;3;14;341;Pair-et-Grandrupt;508;10;518
44;Grand Est;88;1;02;342;Pallegney;164;3;167
44;Grand Est;88;2;17;343;Parey-sous-Montfort;159;4;163
44;Grand Est;88;2;10;344;Pargny-sous-Mureau;182;5;187
44;Grand Est;88;3;14;345;La Petite-Fosse;72;3;75
44;Grand Est;88;3;11;346;La Petite-Raon;742;12;754
44;Grand Est;88;1;04;347;Pierrefitte;118;1;119
44;Grand Est;88;1;02;348;Pierrepont-sur-l'Arentèle;131;2;133
44;Grand Est;88;3;07;349;Plainfaing;1641;26;1667
44;Grand Est;88;2;09;350;Pleuvezain;78;3;81
44;Grand Est;88;1;16;351;Plombières-les-Bains;1604;34;1638
44;Grand Est;88;2;10;352;Pompierre;195;5;200
44;Grand Est;88;2;04;353;Pont-lès-Bonfays;108;3;111
44;Grand Est;88;1;03;354;Pont-sur-Madon;185;0;185
44;Grand Est;88;1;03;355;Portieux;1239;21;1260
44;Grand Est;88;3;02;356;Les Poulières;272;5;277
44;Grand Est;88;1;09;357;Poussay;685;21;706
44;Grand Est;88;1;12;358;Pouxeux;1980;35;2015
44;Grand Est;88;1;02;359;Prey;91;2;93
44;Grand Est;88;2;04;360;Provenchères-lès-Darney;153;5;158
44;Grand Est;88;3;14;361;Provenchères-et-Colroy;1343;115;1458
44;Grand Est;88;3;11;362;Le Puid;113;1;114
44;Grand Est;88;2;10;363;Punerot;156;5;161
44;Grand Est;88;1;09;364;Puzieux;146;3;149
44;Grand Est;88;1;04;365;Racécourt;158;9;167
44;Grand Est;88;2;09;366;Rainville;279;12;291
44;Grand Est;88;1;13;367;Rambervillers;5096;135;5231
44;Grand Est;88;1;09;368;Ramecourt;191;4;195
44;Grand Est;88;1;15;369;Ramonchamp;1889;135;2024
44;Grand Est;88;1;17;370;Rancourt;61;1;62
44;Grand Est;88;1;12;371;Raon-aux-Bois;1228;18;1246
44;Grand Est;88;3;11;372;Raon-l'Étape;6205;141;6346
44;Grand Est;88;3;11;373;Raon-sur-Plaine;147;2;149
44;Grand Est;88;1;03;374;Rapey;23;0;23
44;Grand Est;88;3;14;375;Raves;471;7;478
44;Grand Est;88;2;10;376;Rebeuville;278;7;285
44;Grand Est;88;2;04;377;Regnévelle;122;2;124
44;Grand Est;88;1;03;378;Regney;96;2;98
44;Grand Est;88;1;03;379;Rehaincourt;356;6;362
44;Grand Est;88;3;02;380;Rehaupal;209;2;211
44;Grand Est;88;2;04;381;Relanges;199;11;210
44;Grand Est;88;1;09;382;Remicourt;67;1;68
44;Grand Est;88;1;12;383;Remiremont;7691;301;7992
44;Grand Est;88;2;17;385;Remoncourt;573;10;583
44;Grand Est;88;3;14;386;Remomeix;457;4;461
44;Grand Est;88;2;09;387;Removille;217;4;221
44;Grand Est;88;1;05;388;Renauvoid;121;3;124
44;Grand Est;88;1;09;389;Repel;81;0;81
44;Grand Est;88;2;04;390;Robécourt;106;8;114
44;Grand Est;88;3;01;391;Rochesson;686;17;703
44;Grand Est;88;2;10;393;Rollainville;315;9;324
44;Grand Est;88;2;04;394;Romain-aux-Bois;51;0;51
44;Grand Est;88;1;03;395;Romont;375;8;383
44;Grand Est;88;3;02;398;Les Rouges-Eaux;85;4;89
44;Grand Est;88;1;02;399;Le Roulier;202;4;206
44;Grand Est;88;1;09;400;Rouvres-en-Xaintois;274;12;286
44;Grand Est;88;2;10;401;Rouvres-la-Chétive;447;9;456
44;Grand Est;88;1;11;402;Roville-aux-Chênes;370;139;509
44;Grand Est;88;2;17;403;Rozerotte;190;2;192
44;Grand Est;88;2;04;404;Rozières-sur-Mouzon;67;1;68
44;Grand Est;88;1;03;406;Rugney;134;1;135
44;Grand Est;88;2;10;407;Ruppes;141;3;144
44;Grand Est;88;1;15;408;Rupt-sur-Moselle;3529;68;3597
44;Grand Est;88;1;12;409;Saint-Amé;2146;38;2184
44;Grand Est;88;1;11;410;Sainte-Barbe;272;4;276
44;Grand Est;88;2;04;411;Saint-Baslemont;78;1;79
44;Grand Est;88;1;11;412;Saint-Benoît-la-Chipotte;438;9;447
44;Grand Est;88;3;99;413;Saint-Dié-des-Vosges;19576;484;20060
44;Grand Est;88;1;12;415;Saint-Étienne-lès-Remiremont;3847;80;3927
44;Grand Est;88;1;03;416;Saint-Genest;135;2;137
44;Grand Est;88;1;13;417;Saint-Gorgon;386;9;395
44;Grand Est;88;1;02;418;Sainte-Hélène;456;4;460
44;Grand Est;88;3;11;419;Saint-Jean-d'Ormont;119;0;119
44;Grand Est;88;2;04;421;Saint-Julien;109;2;111
44;Grand Est;88;3;14;423;Saint-Léonard;1351;22;1373
44;Grand Est;88;3;14;424;Sainte-Marguerite;2308;69;2377
44;Grand Est;88;1;03;425;Saint-Maurice-sur-Mortagne;181;5;186
44;Grand Est;88;1;15;426;Saint-Maurice-sur-Moselle;1367;36;1403
44;Grand Est;88;2;09;427;Saint-Menge;129;1;130
44;Grand Est;88;3;13;428;Saint-Michel-sur-Meurthe;1836;56;1892
44;Grand Est;88;1;12;429;Saint-Nabord;3994;257;4251
44;Grand Est;88;2;17;430;Saint-Ouen-lès-Parey;503;13;516
44;Grand Est;88;2;09;431;Saint-Paul;165;3;168
44;Grand Est;88;1;11;432;Saint-Pierremont;153;3;156
44;Grand Est;88;1;09;433;Saint-Prancher;76;1;77
44;Grand Est;88;2;17;434;Saint-Remimont;222;4;226
44;Grand Est;88;3;11;435;Saint-Remy;518;12;530
44;Grand Est;88;3;11;436;Saint-Stail;72;1;73
44;Grand Est;88;1;03;437;Saint-Vallier;99;3;102
44;Grand Est;88;3;13;438;La Salle;392;7;399
44;Grand Est;88;1;05;439;Sanchey;943;36;979
44;Grand Est;88;2;09;440;Sandaucourt;168;4;172
44;Grand Est;88;2;04;441;Sans-Vallois;128;2;130
44;Grand Est;88;3;01;442;Sapois;635;9;644
44;Grand Est;88;2;10;443;Sartes;95;2;97
44;Grand Est;88;3;11;444;Le Saulcy;326;11;337
44;Grand Est;88;3;14;445;Saulcy-sur-Meurthe;2328;56;2384
44;Grand Est;88;2;17;446;Saulxures-lès-Bulgnéville;250;2;252
44;Grand Est;88;3;01;447;Saulxures-sur-Moselotte;2517;80;2597
44;Grand Est;88;2;17;448;Sauville;178;7;185
44;Grand Est;88;1;03;449;Savigny;187;0;187
44;Grand Est;88;2;04;450;Senaide;183;1;184
44;Grand Est;88;3;11;451;Senones;2423;35;2458
44;Grand Est;88;2;04;452;Senonges;132;0;132
44;Grand Est;88;2;10;453;Seraumont;34;0;34
44;Grand Est;88;1;02;454;Sercœur;231;10;241
44;Grand Est;88;2;04;455;Serécourt;98;6;104
44;Grand Est;88;2;04;456;Serocourt;84;3;87
44;Grand Est;88;2;10;457;Sionne;144;1;145
44;Grand Est;88;1;03;458;Socourt;277;3;280
44;Grand Est;88;2;09;459;Soncourt;43;1;44
44;Grand Est;88;2;10;460;Soulosse-sous-Saint-Élophe;655;13;668
44;Grand Est;88;2;17;461;Suriauville;215;0;215
44;Grand Est;88;3;01;462;Le Syndicat;1884;40;1924
44;Grand Est;88;3;13;463;Taintrux;1529;42;1571
44;Grand Est;88;3;01;464;Tendon;510;7;517
44;Grand Est;88;1;08;465;Capavenir Vosges;8634;214;8848
44;Grand Est;88;2;17;466;They-sous-Montfort;129;5;134
44;Grand Est;88;3;01;467;Thiéfosse;577;15;592
44;Grand Est;88;1;15;468;Le Thillot;3376;56;3432
44;Grand Est;88;1;09;469;Thiraucourt;99;4;103
44;Grand Est;88;3;01;470;Le Tholy;1555;43;1598
44;Grand Est;88;2;04;471;Les Thons;102;1;103
44;Grand Est;88;2;17;472;Thuillières;117;4;121
44;Grand Est;88;2;04;473;Tignécourt;106;4;110
44;Grand Est;88;2;10;474;Tilleux;64;0;64
44;Grand Est;88;2;04;475;Tollaincourt;121;5;126
44;Grand Est;88;1;09;476;Totainville;119;1;120
44;Grand Est;88;2;10;477;Trampot;97;1;98
44;Grand Est;88;2;10;478;Tranqueville-Graux;104;1;105
44;Grand Est;88;1;16;479;Trémonzey;259;4;263
44;Grand Est;88;1;03;480;Ubexy;167;0;167
44;Grand Est;88;1;16;481;Uriménil;1340;22;1362
44;Grand Est;88;2;17;482;Urville;56;2;58
44;Grand Est;88;1;08;483;Uxegney;2296;67;2363
44;Grand Est;88;1;16;484;Uzemain;1035;30;1065
44;Grand Est;88;2;17;485;La Vacheresse-et-la-Rouillie;120;0;120
44;Grand Est;88;3;01;486;Vagney;3911;108;4019
44;Grand Est;88;1;16;487;Le Val-d'Ajol;3864;99;3963
44;Grand Est;88;2;17;488;Valfroicourt;235;5;240
44;Grand Est;88;1;09;489;Valleroy-aux-Saules;253;8;261
44;Grand Est;88;2;17;490;Valleroy-le-Sec;178;4;182
44;Grand Est;88;2;04;491;Les Vallois;119;5;124
44;Grand Est;88;3;07;492;Le Valtin;73;2;75
44;Grand Est;88;1;03;493;Varmonzey;24;1;25
44;Grand Est;88;1;04;494;Vaubexy;121;2;123
44;Grand Est;88;1;06;495;Vaudéville;177;6;183
44;Grand Est;88;2;17;496;Vaudoncourt;161;3;164
44;Grand Est;88;1;08;497;Vaxoncourt;443;8;451
44;Grand Est;88;1;15;498;Vecoux;858;21;879
44;Grand Est;88;1;04;499;Velotte-et-Tatignécourt;160;3;163
44;Grand Est;88;3;01;500;Ventron;832;14;846
44;Grand Est;88;3;11;501;Le Vermont;71;0;71
44;Grand Est;88;1;02;502;Vervezelle;133;4;137
44;Grand Est;88;3;11;503;Vexaincourt;148;3;151
44;Grand Est;88;2;09;504;Vicherey;207;4;211
44;Grand Est;88;3;07;505;Vienville;124;2;126
44;Grand Est;88;3;11;506;Vieux-Moulin;314;6;320
44;Grand Est;88;1;09;507;Villers;200;6;206
44;Grand Est;88;1;04;508;Ville-sur-Illon;541;11;552
44;Grand Est;88;1;02;509;Villoncourt;109;1;110
44;Grand Est;88;2;04;510;Villotte;154;0;154
44;Grand Est;88;2;10;511;Villouxel;86;2;88
44;Grand Est;88;1;02;512;Viménil;254;3;257
44;Grand Est;88;1;03;513;Vincey;2190;26;2216
44;Grand Est;88;2;09;514;Viocourt;160;7;167
44;Grand Est;88;2;16;515;Vioménil;151;2;153
44;Grand Est;88;2;17;516;Vittel;4832;138;4970
44;Grand Est;88;2;04;517;Viviers-le-Gras;202;3;205
44;Grand Est;88;2;17;518;Viviers-lès-Offroicourt;37;0;37
44;Grand Est;88;3;13;519;La Voivre;676;22;698
44;Grand Est;88;1;16;520;Les Voivres;298;9;307
44;Grand Est;88;1;03;521;Vomécourt;259;3;262
44;Grand Est;88;1;03;522;Vomécourt-sur-Madon;71;3;74
44;Grand Est;88;2;09;523;Vouxey;153;5;158
44;Grand Est;88;2;17;524;Vrécourt;351;4;355
44;Grand Est;88;1;09;525;Vroville;129;2;131
44;Grand Est;88;3;14;526;Wisembach;419;10;429
44;Grand Est;88;1;11;527;Xaffévillers;144;2;146
44;Grand Est;88;1;02;528;Xamontarupt;156;3;159
44;Grand Est;88;1;03;529;Xaronval;111;4;115
44;Grand Est;88;1;16;530;Xertigny;2586;49;2635
44;Grand Est;88;3;07;531;Xonrupt-Longemer;1515;50;1565
44;Grand Est;88;1;02;532;Zincourt;77;4;81
27;Bourgogne-Franche-Comté;89;1;07;002;Aigremont;77;3;80
27;Bourgogne-Franche-Comté;89;1;08;003;Montholon;2856;60;2916
27;Bourgogne-Franche-Comté;89;2;19;004;Aisy-sur-Armançon;238;11;249
27;Bourgogne-Franche-Comté;89;2;19;005;Ancy-le-Franc;853;22;875
27;Bourgogne-Franche-Comté;89;2;19;006;Ancy-le-Libre;160;6;166
27;Bourgogne-Franche-Comté;89;1;21;007;Andryes;425;12;437
27;Bourgogne-Franche-Comté;89;2;07;008;Angely;157;7;164
27;Bourgogne-Franche-Comté;89;2;05;009;Annay-la-Côte;349;17;366
27;Bourgogne-Franche-Comté;89;2;07;010;Annay-sur-Serein;207;5;212
27;Bourgogne-Franche-Comté;89;2;05;011;Annéot;122;10;132
27;Bourgogne-Franche-Comté;89;2;07;012;Annoux;84;2;86
27;Bourgogne-Franche-Comté;89;1;02;013;Appoigny;3245;50;3295
27;Bourgogne-Franche-Comté;89;3;06;014;Arces-Dilo;607;8;615
27;Bourgogne-Franche-Comté;89;2;12;015;Arcy-sur-Cure;472;12;484
27;Bourgogne-Franche-Comté;89;2;19;016;Argentenay;78;3;81
27;Bourgogne-Franche-Comté;89;2;19;017;Argenteuil-sur-Armançon;220;2;222
27;Bourgogne-Franche-Comté;89;3;20;018;Armeau;769;6;775
27;Bourgogne-Franche-Comté;89;2;19;019;Arthonnay;151;1;152
27;Bourgogne-Franche-Comté;89;2;12;020;Asnières-sous-Bois;113;2;115
27;Bourgogne-Franche-Comté;89;2;12;021;Asquins;291;13;304
27;Bourgogne-Franche-Comté;89;2;05;022;Athie;132;3;135
27;Bourgogne-Franche-Comté;89;1;03;023;Augy;1008;23;1031
27;Bourgogne-Franche-Comté;89;1;98;024;Auxerre;34451;1103;35554
27;Bourgogne-Franche-Comté;89;2;05;025;Avallon;6462;220;6682
27;Bourgogne-Franche-Comté;89;3;06;027;Bagneaux;205;5;210
27;Bourgogne-Franche-Comté;89;2;19;028;Baon;61;5;66
27;Bourgogne-Franche-Comté;89;1;13;029;Bassou;877;20;897
27;Bourgogne-Franche-Comté;89;1;12;030;Bazarnes;413;9;422
27;Bourgogne-Franche-Comté;89;1;15;031;Beaumont;632;12;644
27;Bourgogne-Franche-Comté;89;2;05;032;Beauvilliers;67;3;70
27;Bourgogne-Franche-Comté;89;1;09;033;Beauvoir;394;11;405
27;Bourgogne-Franche-Comté;89;1;07;034;Beine;470;13;483
27;Bourgogne-Franche-Comté;89;1;06;035;Bellechaume;443;14;457
27;Bourgogne-Franche-Comté;89;3;10;036;La Belliole;246;6;252
27;Bourgogne-Franche-Comté;89;3;11;037;Béon;519;18;537
27;Bourgogne-Franche-Comté;89;2;19;038;Bernouil;112;0;112
27;Bourgogne-Franche-Comté;89;1;07;039;Béru;76;4;80
27;Bourgogne-Franche-Comté;89;1;12;040;Bessy-sur-Cure;188;3;191
27;Bourgogne-Franche-Comté;89;1;15;041;Beugnon;301;15;316
27;Bourgogne-Franche-Comté;89;2;07;042;Bierry-les-Belles-Fontaines;166;5;171
27;Bourgogne-Franche-Comté;89;2;07;043;Blacy;100;1;101
27;Bourgogne-Franche-Comté;89;2;12;044;Blannay;106;1;107
27;Bourgogne-Franche-Comté;89;1;03;045;Bleigny-le-Carreau;283;7;290
27;Bourgogne-Franche-Comté;89;1;09;046;Bléneau;1176;17;1193
27;Bourgogne-Franche-Comté;89;3;06;048;Bœurs-en-Othe;341;7;348
27;Bourgogne-Franche-Comté;89;2;12;049;Bois-d'Arcy;21;3;24
27;Bourgogne-Franche-Comté;89;1;13;050;Bonnard;859;10;869
27;Bourgogne-Franche-Comté;89;3;20;051;Les Bordes;542;12;554
27;Bourgogne-Franche-Comté;89;1;02;053;Branches;439;10;449
27;Bourgogne-Franche-Comté;89;3;10;054;Brannay;787;9;796
27;Bourgogne-Franche-Comté;89;1;06;055;Brienon-sur-Armançon;3192;71;3263
27;Bourgogne-Franche-Comté;89;3;13;056;Brion;628;14;642
27;Bourgogne-Franche-Comté;89;2;12;057;Brosses;303;4;307
27;Bourgogne-Franche-Comté;89;2;05;058;Bussières;122;2;124
27;Bourgogne-Franche-Comté;89;3;13;059;Bussy-en-Othe;716;11;727
27;Bourgogne-Franche-Comté;89;3;20;060;Bussy-le-Repos;457;11;468
27;Bourgogne-Franche-Comté;89;1;15;061;Butteaux;251;3;254
27;Bourgogne-Franche-Comté;89;1;07;062;Carisey;360;4;364
27;Bourgogne-Franche-Comté;89;3;11;063;La Celle-Saint-Cyr;805;19;824
27;Bourgogne-Franche-Comté;89;2;07;064;Censy;56;1;57
27;Bourgogne-Franche-Comté;89;3;06;065;Cérilly;39;1;40
27;Bourgogne-Franche-Comté;89;3;06;066;Cerisiers;972;24;996
27;Bourgogne-Franche-Comté;89;3;11;067;Cézy;1106;16;1122
27;Bourgogne-Franche-Comté;89;1;07;068;Chablis;2205;39;2244
27;Bourgogne-Franche-Comté;89;1;15;069;Chailley;531;11;542
27;Bourgogne-Franche-Comté;89;2;12;071;Chamoux;103;0;103
27;Bourgogne-Franche-Comté;89;1;09;072;Champcevrais;306;3;309
27;Bourgogne-Franche-Comté;89;1;09;073;Champignelles;920;40;960
27;Bourgogne-Franche-Comté;89;3;14;074;Champigny;2117;40;2157
27;Bourgogne-Franche-Comté;89;3;11;075;Champlay;723;11;734
27;Bourgogne-Franche-Comté;89;1;06;076;Champlost;787;11;798
27;Bourgogne-Franche-Comté;89;1;03;077;Champs-sur-Yonne;1571;92;1663
27;Bourgogne-Franche-Comté;89;3;08;079;Chamvres;659;23;682
27;Bourgogne-Franche-Comté;89;3;18;080;La Chapelle-sur-Oreuse;642;4;646
27;Bourgogne-Franche-Comté;89;1;07;081;La Chapelle-Vaupelteigne;89;0;89
27;Bourgogne-Franche-Comté;89;1;02;083;Charbuy;1854;47;1901
27;Bourgogne-Franche-Comté;89;1;21;084;Charentenay;281;5;286
27;Bourgogne-Franche-Comté;89;1;13;085;Charmoy;1130;23;1153
27;Bourgogne-Franche-Comté;89;1;08;086;Charny Orée de Puisaye;4815;71;4886
27;Bourgogne-Franche-Comté;89;2;19;087;Chassignelles;300;9;309
27;Bourgogne-Franche-Comté;89;1;08;088;Chassy;464;12;476
27;Bourgogne-Franche-Comté;89;2;05;089;Chastellux-sur-Cure;137;5;142
27;Bourgogne-Franche-Comté;89;2;12;091;Châtel-Censoir;597;15;612
27;Bourgogne-Franche-Comté;89;2;07;092;Châtel-Gérard;207;11;218
27;Bourgogne-Franche-Comté;89;3;14;093;Chaumont;645;11;656
27;Bourgogne-Franche-Comté;89;3;20;094;Chaumot;708;15;723
27;Bourgogne-Franche-Comté;89;1;07;095;Chemilly-sur-Serein;140;8;148
27;Bourgogne-Franche-Comté;89;1;15;096;Chemilly-sur-Yonne;906;26;932
27;Bourgogne-Franche-Comté;89;2;19;098;Cheney;225;6;231
27;Bourgogne-Franche-Comté;89;1;13;099;Cheny;2356;38;2394
27;Bourgogne-Franche-Comté;89;3;10;100;Chéroy;1676;16;1692
27;Bourgogne-Franche-Comté;89;1;15;101;Chéu;551;11;562
27;Bourgogne-Franche-Comté;89;1;04;102;Chevannes;2169;64;2233
27;Bourgogne-Franche-Comté;89;1;07;104;Chichée;303;13;316
27;Bourgogne-Franche-Comté;89;1;13;105;Chichery;484;17;501
27;Bourgogne-Franche-Comté;89;1;07;108;Chitry;345;9;354
27;Bourgogne-Franche-Comté;89;3;06;111;Les Clérimois;301;5;306
27;Bourgogne-Franche-Comté;89;2;19;112;Collan;163;8;171
27;Bourgogne-Franche-Comté;89;3;10;113;Collemiers;676;17;693
27;Bourgogne-Franche-Comté;89;3;18;115;Compigny;206;6;212
27;Bourgogne-Franche-Comté;89;3;10;116;Cornant;359;7;366
27;Bourgogne-Franche-Comté;89;1;21;117;Coulangeron;217;1;218
27;Bourgogne-Franche-Comté;89;1;21;118;Coulanges-la-Vineuse;806;19;825
27;Bourgogne-Franche-Comté;89;1;12;119;Coulanges-sur-Yonne;512;10;522
27;Bourgogne-Franche-Comté;89;3;06;120;Coulours;129;3;132
27;Bourgogne-Franche-Comté;89;3;06;122;Courgenay;569;8;577
27;Bourgogne-Franche-Comté;89;1;07;123;Courgis;260;8;268
27;Bourgogne-Franche-Comté;89;3;18;124;Courlon-sur-Yonne;1190;20;1210
27;Bourgogne-Franche-Comté;89;1;21;125;Courson-les-Carrières;939;20;959
27;Bourgogne-Franche-Comté;89;3;10;126;Courtoin;33;1;34
27;Bourgogne-Franche-Comté;89;3;14;127;Courtois-sur-Yonne;784;24;808
27;Bourgogne-Franche-Comté;89;2;12;128;Coutarnoux;137;4;141
27;Bourgogne-Franche-Comté;89;1;12;129;Crain;410;9;419
27;Bourgogne-Franche-Comté;89;1;12;130;Deux Rivières;1265;29;1294
27;Bourgogne-Franche-Comté;89;2;19;131;Cruzy-le-Châtel;234;4;238
27;Bourgogne-Franche-Comté;89;2;19;132;Cry;165;6;171
27;Bourgogne-Franche-Comté;89;3;11;133;Cudot;351;4;355
27;Bourgogne-Franche-Comté;89;2;05;134;Cussy-les-Forges;327;8;335
27;Bourgogne-Franche-Comté;89;3;18;136;Cuy;861;29;890
27;Bourgogne-Franche-Comté;89;2;19;137;Dannemoine;472;10;482
27;Bourgogne-Franche-Comté;89;1;09;139;Diges;1102;35;1137
27;Bourgogne-Franche-Comté;89;2;12;141;Dissangis;116;7;123
27;Bourgogne-Franche-Comté;89;3;20;142;Dixmont;918;26;944
27;Bourgogne-Franche-Comté;89;3;10;143;Dollot;316;3;319
27;Bourgogne-Franche-Comté;89;3;10;144;Domats;812;14;826
27;Bourgogne-Franche-Comté;89;2;12;145;Domecy-sur-Cure;379;12;391
27;Bourgogne-Franche-Comté;89;2;05;146;Domecy-sur-le-Vault;86;3;89
27;Bourgogne-Franche-Comté;89;1;09;147;Dracy;233;2;235
27;Bourgogne-Franche-Comté;89;1;21;148;Druyes-les-Belles-Fontaines;266;4;270
27;Bourgogne-Franche-Comté;89;2;19;149;Dyé;214;6;220
27;Bourgogne-Franche-Comté;89;1;09;150;Égleny;449;9;458
27;Bourgogne-Franche-Comté;89;3;10;151;Égriselles-le-Bocage;1346;21;1367
27;Bourgogne-Franche-Comté;89;1;13;152;Épineau-les-Voves;742;15;757
27;Bourgogne-Franche-Comté;89;2;19;153;Épineuil;554;17;571
27;Bourgogne-Franche-Comté;89;1;21;154;Escamps;886;24;910
27;Bourgogne-Franche-Comté;89;1;21;155;Escolives-Sainte-Camille;699;11;710
27;Bourgogne-Franche-Comté;89;1;06;156;Esnon;394;7;401
27;Bourgogne-Franche-Comté;89;1;21;158;Étais-la-Sauvin;626;15;641
27;Bourgogne-Franche-Comté;89;2;05;159;Étaule;390;10;400
27;Bourgogne-Franche-Comté;89;3;20;160;Étigny;761;25;786
27;Bourgogne-Franche-Comté;89;2;07;161;Étivey;195;5;200
27;Bourgogne-Franche-Comté;89;3;18;162;Évry;390;3;393
27;Bourgogne-Franche-Comté;89;1;08;163;La Ferté-Loupière;526;9;535
27;Bourgogne-Franche-Comté;89;1;12;164;Festigny;91;0;91
27;Bourgogne-Franche-Comté;89;3;06;165;Flacy;107;2;109
27;Bourgogne-Franche-Comté;89;1;08;167;Fleury-la-Vallée;1112;35;1147
27;Bourgogne-Franche-Comté;89;1;07;168;Fleys;175;3;178
27;Bourgogne-Franche-Comté;89;2;19;169;Flogny-la-Chapelle;974;21;995
27;Bourgogne-Franche-Comté;89;2;12;170;Foissy-lès-Vézelay;124;2;126
27;Bourgogne-Franche-Comté;89;3;06;171;Foissy-sur-Vanne;297;3;300
27;Bourgogne-Franche-Comté;89;3;06;172;Fontaine-la-Gaillarde;503;25;528
27;Bourgogne-Franche-Comté;89;1;09;173;Fontaines;469;5;474
27;Bourgogne-Franche-Comté;89;1;07;175;Fontenay-près-Chablis;149;6;155
27;Bourgogne-Franche-Comté;89;2;12;176;Fontenay-près-Vézelay;137;2;139
27;Bourgogne-Franche-Comté;89;1;12;177;Fontenay-sous-Fouronnes;72;0;72
27;Bourgogne-Franche-Comté;89;1;21;179;Fontenoy;300;8;308
27;Bourgogne-Franche-Comté;89;3;10;180;Fouchères;480;10;490
27;Bourgogne-Franche-Comté;89;3;06;181;Fournaudin;119;2;121
27;Bourgogne-Franche-Comté;89;1;21;182;Fouronnes;171;4;175
27;Bourgogne-Franche-Comté;89;2;07;183;Fresnes;68;0;68
27;Bourgogne-Franche-Comté;89;2;19;184;Fulvy;130;2;132
27;Bourgogne-Franche-Comté;89;1;15;186;Germigny;530;13;543
27;Bourgogne-Franche-Comté;89;2;19;187;Gigny;88;2;90
27;Bourgogne-Franche-Comté;89;2;05;188;Girolles;167;6;173
27;Bourgogne-Franche-Comté;89;3;18;189;Gisy-les-Nobles;575;19;594
27;Bourgogne-Franche-Comté;89;2;12;190;Givry;180;8;188
27;Bourgogne-Franche-Comté;89;2;19;191;Gland;46;2;48
27;Bourgogne-Franche-Comté;89;2;07;194;Grimault;116;6;122
27;Bourgogne-Franche-Comté;89;3;17;195;Gron;1251;73;1324
27;Bourgogne-Franche-Comté;89;1;08;196;Valravillon;1755;52;1807
27;Bourgogne-Franche-Comté;89;2;07;197;Guillon-Terre-Plaine;748;8;756
27;Bourgogne-Franche-Comté;89;1;02;198;Gurgy;1699;38;1737
27;Bourgogne-Franche-Comté;89;1;21;199;Gy-l'Évêque;454;10;464
27;Bourgogne-Franche-Comté;89;1;15;200;Hauterive;389;16;405
27;Bourgogne-Franche-Comté;89;1;15;201;Héry;1786;40;1826
27;Bourgogne-Franche-Comté;89;1;21;202;Irancy;260;7;267
27;Bourgogne-Franche-Comté;89;2;05;203;Island;186;6;192
27;Bourgogne-Franche-Comté;89;2;07;204;L'Isle-sur-Serein;661;14;675
27;Bourgogne-Franche-Comté;89;1;15;205;Jaulges;579;4;583
27;Bourgogne-Franche-Comté;89;3;11;206;Joigny;9557;322;9879
27;Bourgogne-Franche-Comté;89;2;07;207;Jouancy;25;0;25
27;Bourgogne-Franche-Comté;89;2;12;208;Joux-la-Ville;1153;18;1171
27;Bourgogne-Franche-Comté;89;3;10;209;Jouy;512;11;523
27;Bourgogne-Franche-Comté;89;2;19;210;Jully;131;7;138
27;Bourgogne-Franche-Comté;89;2;19;211;Junay;68;0;68
27;Bourgogne-Franche-Comté;89;1;21;212;Jussy;368;15;383
27;Bourgogne-Franche-Comté;89;3;06;214;Lailly;194;2;196
27;Bourgogne-Franche-Comté;89;1;21;215;Lain;186;4;190
27;Bourgogne-Franche-Comté;89;1;21;216;Lainsecq;319;10;329
27;Bourgogne-Franche-Comté;89;1;09;217;Lalande;137;2;139
27;Bourgogne-Franche-Comté;89;1;13;218;Laroche-Saint-Cydroine;1260;22;1282
27;Bourgogne-Franche-Comté;89;1;15;219;Lasson;144;0;144
27;Bourgogne-Franche-Comté;89;1;09;220;Lavau;459;8;467
27;Bourgogne-Franche-Comté;89;1;09;221;Leugny;327;5;332
27;Bourgogne-Franche-Comté;89;1;21;222;Levis;219;6;225
27;Bourgogne-Franche-Comté;89;2;19;223;Lézinnes;661;20;681
27;Bourgogne-Franche-Comté;89;1;07;224;Lichères-près-Aigremont;156;3;159
27;Bourgogne-Franche-Comté;89;2;12;225;Lichères-sur-Yonne;44;0;44
27;Bourgogne-Franche-Comté;89;1;07;226;Lignorelles;190;5;195
27;Bourgogne-Franche-Comté;89;1;07;227;Ligny-le-Châtel;1228;27;1255
27;Bourgogne-Franche-Comté;89;1;01;228;Lindry;1393;43;1436
27;Bourgogne-Franche-Comté;89;3;10;229;Lixy;472;12;484
27;Bourgogne-Franche-Comté;89;3;11;230;Looze;437;18;455
27;Bourgogne-Franche-Comté;89;2;05;232;Lucy-le-Bois;289;16;305
27;Bourgogne-Franche-Comté;89;1;12;233;Lucy-sur-Cure;200;5;205
27;Bourgogne-Franche-Comté;89;1;12;234;Lucy-sur-Yonne;120;2;122
27;Bourgogne-Franche-Comté;89;2;05;235;Magny;873;22;895
27;Bourgogne-Franche-Comté;89;3;17;236;Maillot;1178;31;1209
27;Bourgogne-Franche-Comté;89;1;12;237;Mailly-la-Ville;497;9;506
27;Bourgogne-Franche-Comté;89;1;12;238;Mailly-le-Château;545;6;551
27;Bourgogne-Franche-Comté;89;3;17;239;Malay-le-Grand;1547;45;1592
27;Bourgogne-Franche-Comté;89;3;06;240;Malay-le-Petit;327;9;336
27;Bourgogne-Franche-Comté;89;1;07;242;Maligny;805;19;824
27;Bourgogne-Franche-Comté;89;2;07;244;Marmeaux;86;4;90
27;Bourgogne-Franche-Comté;89;3;20;245;Marsangy;843;19;862
27;Bourgogne-Franche-Comté;89;2;07;246;Massangis;355;5;360
27;Bourgogne-Franche-Comté;89;2;19;247;Mélisey;237;2;239
27;Bourgogne-Franche-Comté;89;2;05;248;Menades;41;2;43
27;Bourgogne-Franche-Comté;89;1;06;249;Mercy;78;1;79
27;Bourgogne-Franche-Comté;89;1;07;250;Méré;201;3;204
27;Bourgogne-Franche-Comté;89;1;08;251;Merry-la-Vallée;371;9;380
27;Bourgogne-Franche-Comté;89;1;21;252;Merry-Sec;177;4;181
27;Bourgogne-Franche-Comté;89;2;12;253;Merry-sur-Yonne;192;1;193
27;Bourgogne-Franche-Comté;89;1;09;254;Mézilles;523;8;531
27;Bourgogne-Franche-Comté;89;3;18;255;Michery;1067;22;1089
27;Bourgogne-Franche-Comté;89;1;21;256;Migé;415;3;418
27;Bourgogne-Franche-Comté;89;1;13;257;Migennes;7258;112;7370
27;Bourgogne-Franche-Comté;89;2;07;259;Môlay;90;2;92
27;Bourgogne-Franche-Comté;89;3;06;261;Molinons;275;6;281
27;Bourgogne-Franche-Comté;89;2;19;262;Molosmes;171;8;179
27;Bourgogne-Franche-Comté;89;1;02;263;Monéteau;4125;79;4204
27;Bourgogne-Franche-Comté;89;3;10;264;Montacher-Villegardin;732;27;759
27;Bourgogne-Franche-Comté;89;1;07;265;Montigny-la-Resle;583;20;603
27;Bourgogne-Franche-Comté;89;2;12;266;Montillot;262;7;269
27;Bourgogne-Franche-Comté;89;2;07;267;Montréal;177;6;183
27;Bourgogne-Franche-Comté;89;1;15;268;Mont-Saint-Sulpice;793;16;809
27;Bourgogne-Franche-Comté;89;1;21;270;Mouffy;127;2;129
27;Bourgogne-Franche-Comté;89;2;07;271;Moulins-en-Tonnerrois;104;1;105
27;Bourgogne-Franche-Comté;89;1;09;272;Moulins-sur-Ouanne;293;2;295
27;Bourgogne-Franche-Comté;89;1;21;273;Moutiers-en-Puisaye;280;4;284
27;Bourgogne-Franche-Comté;89;3;10;274;Nailly;1336;36;1372
27;Bourgogne-Franche-Comté;89;1;15;276;Neuvy-Sautour;885;40;925
27;Bourgogne-Franche-Comté;89;1;07;277;Nitry;367;10;377
27;Bourgogne-Franche-Comté;89;3;06;278;Noé;552;5;557
27;Bourgogne-Franche-Comté;89;2;07;279;Noyers;589;18;607
27;Bourgogne-Franche-Comté;89;2;19;280;Nuits;393;9;402
27;Bourgogne-Franche-Comté;89;1;08;281;Les Ormes;362;2;364
27;Bourgogne-Franche-Comté;89;1;15;282;Ormoy;678;12;690
27;Bourgogne-Franche-Comté;89;1;21;283;Ouanne;599;16;615
27;Bourgogne-Franche-Comté;89;2;19;284;Pacy-sur-Armançon;183;4;187
27;Bourgogne-Franche-Comté;89;3;18;285;Pailly;314;3;317
27;Bourgogne-Franche-Comté;89;1;09;286;Parly;830;15;845
27;Bourgogne-Franche-Comté;89;3;17;287;Paron;4828;118;4946
27;Bourgogne-Franche-Comté;89;1;06;288;Paroy-en-Othe;179;3;182
27;Bourgogne-Franche-Comté;89;3;08;289;Paroy-sur-Tholon;283;12;295
27;Bourgogne-Franche-Comté;89;2;07;290;Pasilly;44;1;45
27;Bourgogne-Franche-Comté;89;3;20;291;Passy;340;10;350
27;Bourgogne-Franche-Comté;89;1;15;292;Percey;250;5;255
27;Bourgogne-Franche-Comté;89;1;02;295;Perrigny;1258;32;1290
27;Bourgogne-Franche-Comté;89;2;19;296;Perrigny-sur-Armançon;130;1;131
27;Bourgogne-Franche-Comté;89;2;12;297;Pierre-Perthuis;112;1;113
27;Bourgogne-Franche-Comté;89;3;20;298;Piffonds;612;9;621
27;Bourgogne-Franche-Comté;89;2;19;299;Pimelles;63;2;65
27;Bourgogne-Franche-Comté;89;2;07;300;Pisy;80;1;81
27;Bourgogne-Franche-Comté;89;3;18;302;Plessis-Saint-Jean;205;5;210
27;Bourgogne-Franche-Comté;89;1;07;303;Poilly-sur-Serein;251;6;257
27;Bourgogne-Franche-Comté;89;1;08;304;Poilly-sur-Tholon;677;17;694
27;Bourgogne-Franche-Comté;89;2;05;306;Pontaubert;366;11;377
27;Bourgogne-Franche-Comté;89;1;07;307;Pontigny;749;9;758
27;Bourgogne-Franche-Comté;89;3;06;308;Pont-sur-Vanne;188;7;195
27;Bourgogne-Franche-Comté;89;3;14;309;Pont-sur-Yonne;3316;60;3376
27;Bourgogne-Franche-Comté;89;3;06;310;La Postolle;140;3;143
27;Bourgogne-Franche-Comté;89;1;09;311;Pourrain;1392;34;1426
27;Bourgogne-Franche-Comté;89;2;12;312;Précy-le-Sec;248;5;253
27;Bourgogne-Franche-Comté;89;3;11;313;Précy-sur-Vrin;425;16;441
27;Bourgogne-Franche-Comté;89;1;12;314;Prégilbert;181;1;182
27;Bourgogne-Franche-Comté;89;1;07;315;Préhy;153;1;154
27;Bourgogne-Franche-Comté;89;2;05;316;Provency;254;8;262
27;Bourgogne-Franche-Comté;89;2;05;318;Quarré-les-Tombes;633;20;653
27;Bourgogne-Franche-Comté;89;1;03;319;Quenne;483;14;497
27;Bourgogne-Franche-Comté;89;2;19;320;Quincerot;63;2;65
27;Bourgogne-Franche-Comté;89;2;19;321;Ravières;718;17;735
27;Bourgogne-Franche-Comté;89;2;19;323;Roffey;141;4;145
27;Bourgogne-Franche-Comté;89;1;09;324;Rogny-les-Sept-Écluses;657;17;674
27;Bourgogne-Franche-Comté;89;1;09;325;Ronchères;91;1;92
27;Bourgogne-Franche-Comté;89;3;17;326;Rosoy;1090;32;1122
27;Bourgogne-Franche-Comté;89;3;20;327;Rousson;395;10;405
27;Bourgogne-Franche-Comté;89;1;07;328;Rouvray;371;9;380
27;Bourgogne-Franche-Comté;89;2;19;329;Rugny;75;1;76
27;Bourgogne-Franche-Comté;89;1;21;331;Sainpuits;312;12;324
27;Bourgogne-Franche-Comté;89;3;10;332;Saint-Agnan;953;27;980
27;Bourgogne-Franche-Comté;89;2;07;333;Saint-André-en-Terre-Plaine;152;4;156
27;Bourgogne-Franche-Comté;89;1;08;334;Le Val d'Ocre;557;7;564
27;Bourgogne-Franche-Comté;89;3;11;335;Saint-Aubin-sur-Yonne;418;13;431
27;Bourgogne-Franche-Comté;89;2;05;336;Saint-Brancher;283;7;290
27;Bourgogne-Franche-Comté;89;1;03;337;Saint-Bris-le-Vineux;1021;26;1047
27;Bourgogne-Franche-Comté;89;3;16;338;Saint-Clément;2740;77;2817
27;Bourgogne-Franche-Comté;89;2;12;339;Sainte-Colombe;190;7;197
27;Bourgogne-Franche-Comté;89;1;07;341;Saint-Cyr-les-Colons;448;5;453
27;Bourgogne-Franche-Comté;89;3;18;342;Saint-Denis-lès-Sens;650;18;668
27;Bourgogne-Franche-Comté;89;1;09;344;Saint-Fargeau;1495;15;1510
27;Bourgogne-Franche-Comté;89;1;15;345;Saint-Florentin;4240;62;4302
27;Bourgogne-Franche-Comté;89;1;01;346;Saint-Georges-sur-Baulche;3225;143;3368
27;Bourgogne-Franche-Comté;89;2;05;347;Saint-Germain-des-Champs;349;10;359
27;Bourgogne-Franche-Comté;89;3;11;348;Saint-Julien-du-Sault;2236;48;2284
27;Bourgogne-Franche-Comté;89;2;05;349;Saint-Léger-Vauban;354;6;360
27;Bourgogne-Franche-Comté;89;3;11;350;Saint-Loup-d'Ordon;261;4;265
27;Bourgogne-Franche-Comté;89;2;05;351;Sainte-Magnance;482;8;490
27;Bourgogne-Franche-Comté;89;1;09;352;Saint-Martin-des-Champs;268;7;275
27;Bourgogne-Franche-Comté;89;3;11;353;Saint-Martin-d'Ordon;418;4;422
27;Bourgogne-Franche-Comté;89;3;16;354;Saint-Martin-du-Tertre;1525;42;1567
27;Bourgogne-Franche-Comté;89;2;19;355;Saint-Martin-sur-Armançon;145;6;151
27;Bourgogne-Franche-Comté;89;3;06;359;Saint-Maurice-aux-Riches-Hommes;417;5;422
27;Bourgogne-Franche-Comté;89;1;08;360;Saint-Maurice-le-Vieil;372;6;378
27;Bourgogne-Franche-Comté;89;1;08;361;Saint-Maurice-Thizouaille;255;2;257
27;Bourgogne-Franche-Comté;89;2;12;362;Saint-Moré;178;5;183
27;Bourgogne-Franche-Comté;89;1;12;363;Sainte-Pallaye;107;2;109
27;Bourgogne-Franche-Comté;89;2;12;364;Saint-Père;295;5;300
27;Bourgogne-Franche-Comté;89;1;09;365;Saint-Privé;526;15;541
27;Bourgogne-Franche-Comté;89;1;21;367;Saints-en-Puisaye;548;11;559
27;Bourgogne-Franche-Comté;89;1;21;368;Saint-Sauveur-en-Puisaye;892;20;912
27;Bourgogne-Franche-Comté;89;3;14;369;Saint-Sérotin;572;12;584
27;Bourgogne-Franche-Comté;89;3;10;370;Saint-Valérien;1727;21;1748
27;Bourgogne-Franche-Comté;89;2;07;371;Sainte-Vertu;84;0;84
27;Bourgogne-Franche-Comté;89;3;06;373;Saligny;675;10;685
27;Bourgogne-Franche-Comté;89;2;19;374;Sambourg;73;3;76
27;Bourgogne-Franche-Comté;89;2;07;375;Santigny;84;3;87
27;Bourgogne-Franche-Comté;89;2;07;376;Sarry;144;7;151
27;Bourgogne-Franche-Comté;89;2;07;377;Sauvigny-le-Beuréal;70;0;70
27;Bourgogne-Franche-Comté;89;2;05;378;Sauvigny-le-Bois;722;15;737
27;Bourgogne-Franche-Comté;89;2;07;379;Savigny-en-Terre-Plaine;151;3;154
27;Bourgogne-Franche-Comté;89;3;10;380;Savigny-sur-Clairis;454;7;461
27;Bourgogne-Franche-Comté;89;1;15;382;Seignelay;1476;37;1513
27;Bourgogne-Franche-Comté;89;1;21;383;Sementron;104;2;106
27;Bourgogne-Franche-Comté;89;1;08;384;Senan;683;24;707
27;Bourgogne-Franche-Comté;89;2;19;385;Sennevoy-le-Bas;77;3;80
27;Bourgogne-Franche-Comté;89;2;19;386;Sennevoy-le-Haut;115;1;116
27;Bourgogne-Franche-Comté;89;3;99;387;Sens;26688;515;27203
27;Bourgogne-Franche-Comté;89;3;08;388;Sépeaux-Saint Romain;519;14;533
27;Bourgogne-Franche-Comté;89;3;18;390;Serbonnes;663;10;673
27;Bourgogne-Franche-Comté;89;3;18;391;Sergines;1269;26;1295
27;Bourgogne-Franche-Comté;89;2;05;392;Sermizelles;248;3;251
27;Bourgogne-Franche-Comté;89;2;19;393;Serrigny;110;2;112
27;Bourgogne-Franche-Comté;89;1;12;394;Sery;80;1;81
27;Bourgogne-Franche-Comté;89;3;06;395;Les Sièges;409;8;417
27;Bourgogne-Franche-Comté;89;1;08;397;Sommecaise;364;5;369
27;Bourgogne-Franche-Comté;89;1;15;398;Sormery;360;4;364
27;Bourgogne-Franche-Comté;89;3;18;399;Soucy;1592;45;1637
27;Bourgogne-Franche-Comté;89;1;21;400;Sougères-en-Puisaye;316;5;321
27;Bourgogne-Franche-Comté;89;1;15;402;Soumaintrain;221;4;225
27;Bourgogne-Franche-Comté;89;2;19;403;Stigny;88;8;96
27;Bourgogne-Franche-Comté;89;3;10;404;Subligny;523;9;532
27;Bourgogne-Franche-Comté;89;1;21;405;Les Hauts de Forterre;499;6;505
27;Bourgogne-Franche-Comté;89;2;07;406;Talcy;72;2;74
27;Bourgogne-Franche-Comté;89;2;19;407;Tanlay;935;31;966
27;Bourgogne-Franche-Comté;89;1;09;408;Tannerre-en-Puisaye;277;7;284
27;Bourgogne-Franche-Comté;89;2;12;409;Tharoiseau;61;1;62
27;Bourgogne-Franche-Comté;89;2;05;410;Tharot;100;1;101
27;Bourgogne-Franche-Comté;89;3;06;411;Les Vallées de la Vanne;1038;18;1056
27;Bourgogne-Franche-Comté;89;2;07;412;Thizy;185;8;193
27;Bourgogne-Franche-Comté;89;2;19;413;Thorey;36;1;37
27;Bourgogne-Franche-Comté;89;3;18;414;Thorigny-sur-Oreuse;1417;30;1447
27;Bourgogne-Franche-Comté;89;2;05;415;Thory;200;3;203
27;Bourgogne-Franche-Comté;89;1;21;416;Thury;439;7;446
27;Bourgogne-Franche-Comté;89;2;19;417;Tissey;109;2;111
27;Bourgogne-Franche-Comté;89;2;19;418;Tonnerre;4381;165;4546
27;Bourgogne-Franche-Comté;89;1;09;419;Toucy;2615;141;2756
27;Bourgogne-Franche-Comté;89;1;21;420;Treigny-Perreuse-Sainte-Colombe;969;20;989
27;Bourgogne-Franche-Comté;89;2;19;422;Trichey;41;2;43
27;Bourgogne-Franche-Comté;89;2;19;423;Tronchoy;127;3;130
27;Bourgogne-Franche-Comté;89;1;12;424;Trucy-sur-Yonne;134;6;140
27;Bourgogne-Franche-Comté;89;1;15;425;Turny;674;20;694
27;Bourgogne-Franche-Comté;89;1;21;426;Val-de-Mercy;387;12;399
27;Bourgogne-Franche-Comté;89;1;04;427;Vallan;681;19;700
27;Bourgogne-Franche-Comté;89;3;10;428;Vallery;564;6;570
27;Bourgogne-Franche-Comté;89;1;07;430;Varennes;322;9;331
27;Bourgogne-Franche-Comté;89;2;07;431;Vassy-sous-Pisy;71;1;72
27;Bourgogne-Franche-Comté;89;3;06;432;Vaudeurs;461;8;469
27;Bourgogne-Franche-Comté;89;2;05;433;Vault-de-Lugny;274;5;279
27;Bourgogne-Franche-Comté;89;3;06;434;Vaumort;349;8;357
27;Bourgogne-Franche-Comté;89;1;06;436;Venizy;877;15;892
27;Bourgogne-Franche-Comté;89;1;07;437;Venouse;301;7;308
27;Bourgogne-Franche-Comté;89;1;03;438;Venoy;1759;200;1959
27;Bourgogne-Franche-Comté;89;1;15;439;Vergigny;1528;24;1552
27;Bourgogne-Franche-Comté;89;3;11;440;Verlin;413;5;418
27;Bourgogne-Franche-Comté;89;1;12;441;Vermenton;1255;25;1280
27;Bourgogne-Franche-Comté;89;3;10;442;Vernoy;241;7;248
27;Bourgogne-Franche-Comté;89;3;20;443;Véron;1887;62;1949
27;Bourgogne-Franche-Comté;89;2;19;445;Vézannes;52;2;54
27;Bourgogne-Franche-Comté;89;2;12;446;Vézelay;418;4;422
27;Bourgogne-Franche-Comté;89;2;19;447;Vézinnes;156;5;161
27;Bourgogne-Franche-Comté;89;3;14;449;Villeblevin;1815;35;1850
27;Bourgogne-Franche-Comté;89;3;10;450;Villebougis;627;22;649
27;Bourgogne-Franche-Comté;89;3;06;451;Villechétive;250;4;254
27;Bourgogne-Franche-Comté;89;3;11;452;Villecien;380;13;393
27;Bourgogne-Franche-Comté;89;1;01;453;Villefargeau;1126;30;1156
27;Bourgogne-Franche-Comté;89;3;14;456;Villemanoche;668;8;676
27;Bourgogne-Franche-Comté;89;3;14;458;Villenavotte;166;9;175
27;Bourgogne-Franche-Comté;89;3;10;459;Villeneuve-la-Dondagre;318;0;318
27;Bourgogne-Franche-Comté;89;3;14;460;Villeneuve-la-Guyard;3515;46;3561
27;Bourgogne-Franche-Comté;89;3;06;461;Villeneuve-l'Archevêque;1112;19;1131
27;Bourgogne-Franche-Comté;89;1;09;462;Villeneuve-les-Genêts;296;3;299
27;Bourgogne-Franche-Comté;89;1;07;463;Villeneuve-Saint-Salves;254;4;258
27;Bourgogne-Franche-Comté;89;3;20;464;Villeneuve-sur-Yonne;5165;85;5250
27;Bourgogne-Franche-Comté;89;3;14;465;Villeperrot;321;1;322
27;Bourgogne-Franche-Comté;89;3;10;466;Villeroy;388;9;397
27;Bourgogne-Franche-Comté;89;3;10;467;Villethierry;819;14;833
27;Bourgogne-Franche-Comté;89;3;11;468;Villevallier;419;59;478
27;Bourgogne-Franche-Comté;89;3;18;469;Perceneige;949;21;970
27;Bourgogne-Franche-Comté;89;2;19;470;Villiers-les-Hauts;121;7;128
27;Bourgogne-Franche-Comté;89;3;06;471;Villiers-Louis;467;15;482
27;Bourgogne-Franche-Comté;89;1;09;472;Villiers-Saint-Benoît;448;9;457
27;Bourgogne-Franche-Comté;89;1;15;474;Villiers-Vineux;275;6;281
27;Bourgogne-Franche-Comté;89;2;19;475;Villon;109;2;111
27;Bourgogne-Franche-Comté;89;1;07;477;Villy;112;2;114
27;Bourgogne-Franche-Comté;89;1;21;478;Vincelles;914;15;929
27;Bourgogne-Franche-Comté;89;1;21;479;Vincelottes;292;6;298
27;Bourgogne-Franche-Comté;89;3;18;480;Vinneuf;1594;24;1618
27;Bourgogne-Franche-Comté;89;2;19;481;Vireaux;107;6;113
27;Bourgogne-Franche-Comté;89;2;19;482;Viviers;111;1;112
27;Bourgogne-Franche-Comté;89;3;18;483;Voisines;509;18;527
27;Bourgogne-Franche-Comté;89;2;12;485;Voutenay-sur-Cure;204;6;210
27;Bourgogne-Franche-Comté;89;2;19;486;Yrouerre;154;3;157
27;Bourgogne-Franche-Comté;90;1;05;001;Andelnans;1171;21;1192
27;Bourgogne-Franche-Comté;90;1;08;002;Angeot;356;8;364
27;Bourgogne-Franche-Comté;90;1;07;003;Anjoutey;589;22;611
27;Bourgogne-Franche-Comté;90;1;05;004;Argiésans;512;15;527
27;Bourgogne-Franche-Comté;90;1;07;005;Auxelles-Bas;453;13;466
27;Bourgogne-Franche-Comté;90;1;07;006;Auxelles-Haut;286;7;293
27;Bourgogne-Franche-Comté;90;1;05;007;Banvillars;288;12;300
27;Bourgogne-Franche-Comté;90;1;01;008;Bavilliers;4659;108;4767
27;Bourgogne-Franche-Comté;90;1;06;009;Beaucourt;5010;64;5074
27;Bourgogne-Franche-Comté;90;1;99;010;Belfort;46443;799;47242
27;Bourgogne-Franche-Comté;90;1;05;011;Bermont;378;9;387
27;Bourgogne-Franche-Comté;90;1;08;012;Bessoncourt;1283;46;1329
27;Bourgogne-Franche-Comté;90;1;08;013;Bethonvilliers;239;11;250
27;Bourgogne-Franche-Comté;90;1;08;014;Boron;488;8;496
27;Bourgogne-Franche-Comté;90;1;05;015;Botans;238;9;247
27;Bourgogne-Franche-Comté;90;1;07;016;Bourg-sous-Châtelet;123;2;125
27;Bourgogne-Franche-Comté;90;1;05;017;Bourogne;1903;26;1929
27;Bourgogne-Franche-Comté;90;1;08;018;Brebotte;396;7;403
27;Bourgogne-Franche-Comté;90;1;08;019;Bretagne;270;6;276
27;Bourgogne-Franche-Comté;90;1;05;020;Buc;275;9;284
27;Bourgogne-Franche-Comté;90;1;05;021;Charmois;363;4;367
27;Bourgogne-Franche-Comté;90;1;05;022;Châtenois-les-Forges;2667;51;2718
27;Bourgogne-Franche-Comté;90;1;07;023;Chaux;1164;32;1196
27;Bourgogne-Franche-Comté;90;1;08;024;Chavanatte;141;3;144
27;Bourgogne-Franche-Comté;90;1;08;025;Chavannes-les-Grands;344;4;348
27;Bourgogne-Franche-Comté;90;1;05;026;Chèvremont;1570;38;1608
27;Bourgogne-Franche-Comté;90;1;06;027;Courcelles;116;0;116
27;Bourgogne-Franche-Comté;90;1;06;028;Courtelevant;388;7;395
27;Bourgogne-Franche-Comté;90;1;01;029;Cravanche;1951;53;2004
27;Bourgogne-Franche-Comté;90;1;06;030;Croix;168;3;171
27;Bourgogne-Franche-Comté;90;1;08;031;Cunelières;344;9;353
27;Bourgogne-Franche-Comté;90;1;01;032;Danjoutin;3620;68;3688
27;Bourgogne-Franche-Comté;90;1;06;033;Delle;5667;86;5753
27;Bourgogne-Franche-Comté;90;1;09;034;Denney;757;26;783
27;Bourgogne-Franche-Comté;90;1;05;035;Dorans;797;10;807
27;Bourgogne-Franche-Comté;90;1;08;036;Eguenigue;270;9;279
27;Bourgogne-Franche-Comté;90;1;09;037;Éloie;941;26;967
27;Bourgogne-Franche-Comté;90;1;01;039;Essert;3321;103;3424
27;Bourgogne-Franche-Comté;90;1;07;041;Étueffont;1430;51;1481
27;Bourgogne-Franche-Comté;90;1;09;042;Évette-Salbert;2032;69;2101
27;Bourgogne-Franche-Comté;90;1;06;043;Faverois;582;2;584
27;Bourgogne-Franche-Comté;90;1;07;044;Felon;239;5;244
27;Bourgogne-Franche-Comté;90;1;06;045;Fêche-l'Église;762;13;775
27;Bourgogne-Franche-Comté;90;1;06;046;Florimont;447;6;453
27;Bourgogne-Franche-Comté;90;1;08;047;Fontaine;596;15;611
27;Bourgogne-Franche-Comté;90;1;08;048;Fontenelle;122;3;125
27;Bourgogne-Franche-Comté;90;1;08;049;Foussemagne;919;18;937
27;Bourgogne-Franche-Comté;90;1;08;050;Frais;240;7;247
27;Bourgogne-Franche-Comté;90;1;08;051;Froidefontaine;467;8;475
27;Bourgogne-Franche-Comté;90;1;07;052;Giromagny;2929;80;3009
27;Bourgogne-Franche-Comté;90;1;08;053;Grandvillars;3003;61;3064
27;Bourgogne-Franche-Comté;90;1;07;054;Grosmagny;521;10;531
27;Bourgogne-Franche-Comté;90;1;08;055;Grosne;336;2;338
27;Bourgogne-Franche-Comté;90;1;06;056;Joncherey;1410;29;1439
27;Bourgogne-Franche-Comté;90;1;07;057;Lachapelle-sous-Chaux;746;26;772
27;Bourgogne-Franche-Comté;90;1;07;058;Lachapelle-sous-Rougemont;580;6;586
27;Bourgogne-Franche-Comté;90;1;08;059;Lacollonge;227;10;237
27;Bourgogne-Franche-Comté;90;1;08;060;Lagrange;139;3;142
27;Bourgogne-Franche-Comté;90;1;07;061;Lamadeleine-Val-des-Anges;43;2;45
27;Bourgogne-Franche-Comté;90;1;08;062;Larivière;284;10;294
27;Bourgogne-Franche-Comté;90;1;06;063;Lebetain;415;9;424
27;Bourgogne-Franche-Comté;90;1;06;064;Lepuix-Neuf;303;4;307
27;Bourgogne-Franche-Comté;90;1;07;065;Lepuix;1156;21;1177
27;Bourgogne-Franche-Comté;90;1;07;066;Leval;242;1;243
27;Bourgogne-Franche-Comté;90;1;08;067;Menoncourt;397;18;415
27;Bourgogne-Franche-Comté;90;1;05;068;Meroux-Moval;1368;31;1399
27;Bourgogne-Franche-Comté;90;1;08;069;Méziré;1308;24;1332
27;Bourgogne-Franche-Comté;90;1;06;070;Montbouton;404;9;413
27;Bourgogne-Franche-Comté;90;1;08;071;Montreux-Château;1175;21;1196
27;Bourgogne-Franche-Comté;90;1;08;072;Morvillars;1076;22;1098
27;Bourgogne-Franche-Comté;90;1;08;074;Novillard;302;4;306
27;Bourgogne-Franche-Comté;90;1;09;075;Offemont;4219;99;4318
27;Bourgogne-Franche-Comté;90;1;01;076;Pérouse;1176;41;1217
27;Bourgogne-Franche-Comté;90;1;08;077;Petit-Croix;299;7;306
27;Bourgogne-Franche-Comté;90;1;07;078;Petitefontaine;189;5;194
27;Bourgogne-Franche-Comté;90;1;07;079;Petitmagny;314;6;320
27;Bourgogne-Franche-Comté;90;1;08;080;Phaffans;439;13;452
27;Bourgogne-Franche-Comté;90;1;06;081;Réchésy;776;13;789
27;Bourgogne-Franche-Comté;90;1;08;082;Autrechêne;277;9;286
27;Bourgogne-Franche-Comté;90;1;08;083;Recouvrance;124;0;124
27;Bourgogne-Franche-Comté;90;1;08;084;Reppe;343;10;353
27;Bourgogne-Franche-Comté;90;1;07;085;Riervescemont;95;2;97
27;Bourgogne-Franche-Comté;90;1;07;086;Romagny-sous-Rougemont;221;6;227
27;Bourgogne-Franche-Comté;90;1;09;087;Roppe;1040;31;1071
27;Bourgogne-Franche-Comté;90;1;07;088;Rougegoutte;966;25;991
27;Bourgogne-Franche-Comté;90;1;07;089;Rougemont-le-Château;1497;65;1562
27;Bourgogne-Franche-Comté;90;1;06;090;Saint-Dizier-l'Évêque;435;12;447
27;Bourgogne-Franche-Comté;90;1;07;091;Saint-Germain-le-Châtelet;643;23;666
27;Bourgogne-Franche-Comté;90;1;09;093;Sermamagny;916;20;936
27;Bourgogne-Franche-Comté;90;1;05;094;Sevenans;702;24;726
27;Bourgogne-Franche-Comté;90;1;08;095;Suarce;434;3;437
27;Bourgogne-Franche-Comté;90;1;06;096;Thiancourt;282;8;290
27;Bourgogne-Franche-Comté;90;1;05;097;Trévenans;1283;32;1315
27;Bourgogne-Franche-Comté;90;1;05;098;Urcerey;242;11;253
27;Bourgogne-Franche-Comté;90;1;09;099;Valdoie;5269;239;5508
27;Bourgogne-Franche-Comté;90;1;08;100;Vauthiermont;201;12;213
27;Bourgogne-Franche-Comté;90;1;08;101;Vellescot;243;6;249
27;Bourgogne-Franche-Comté;90;1;07;102;Vescemont;719;23;742
27;Bourgogne-Franche-Comté;90;1;09;103;Vétrigne;660;22;682
27;Bourgogne-Franche-Comté;90;1;05;104;Vézelois;986;23;1009
27;Bourgogne-Franche-Comté;90;1;06;105;Villars-le-Sec;179;5;184
11;Île-de-France;91;1;08;001;Abbéville-la-Rivière;324;8;332
11;Île-de-France;91;1;08;016;Angerville;4353;70;4423
11;Île-de-France;91;3;05;017;Angervilliers;1723;26;1749
11;Île-de-France;91;3;01;021;Arpajon;11355;92;11447
11;Île-de-France;91;1;08;022;Arrancourt;135;5;140
11;Île-de-France;91;3;02;027;Athis-Mons;35670;331;36001
11;Île-de-France;91;1;08;035;Authon-la-Plaine;374;6;380
11;Île-de-France;91;2;13;037;Auvernaux;324;1;325
11;Île-de-France;91;1;08;038;Auvers-Saint-Georges;1273;22;1295
11;Île-de-France;91;3;01;041;Avrainville;995;7;1002
11;Île-de-France;91;3;11;044;Ballainvilliers;4600;42;4642
11;Île-de-France;91;2;13;045;Ballancourt-sur-Essonne;7593;100;7693
11;Île-de-France;91;1;13;047;Baulne;1311;13;1324
11;Île-de-France;91;3;10;064;Bièvres;4823;112;4935
11;Île-de-France;91;1;08;067;Blandy;117;4;121
11;Île-de-France;91;2;13;069;Boigneville;387;10;397
11;Île-de-France;91;1;08;075;Bois-Herpin;80;1;81
11;Île-de-France;91;1;08;079;Boissy-la-Rivière;510;7;517
11;Île-de-France;91;1;08;080;Boissy-le-Cutté;1341;14;1355
11;Île-de-France;91;1;08;081;Boissy-le-Sec;689;17;706
11;Île-de-France;91;1;01;085;Boissy-sous-Saint-Yon;3828;47;3875
11;Île-de-France;91;2;15;086;Bondoufle;10046;98;10144
11;Île-de-France;91;3;10;093;Boullay-les-Troux;648;21;669
11;Île-de-France;91;1;01;095;Bouray-sur-Juine;2113;26;2139
11;Île-de-France;91;2;07;097;Boussy-Saint-Antoine;7983;75;8058
11;Île-de-France;91;1;08;098;Boutervilliers;426;5;431
11;Île-de-France;91;1;13;099;Boutigny-sur-Essonne;2963;41;3004
11;Île-de-France;91;1;08;100;Bouville;646;16;662
11;Île-de-France;91;3;03;103;Brétigny-sur-Orge;27412;321;27733
11;Île-de-France;91;3;05;105;Breuillet;8566;120;8686
11;Île-de-France;91;1;05;106;Breux-Jouy;1290;12;1302
11;Île-de-France;91;1;08;109;Brières-les-Scellés;1260;9;1269
11;Île-de-France;91;3;05;111;Briis-sous-Forges;3342;39;3381
11;Île-de-France;91;1;08;112;Brouy;128;4;132
11;Île-de-France;91;2;98;114;Brunoy;25330;427;25757
11;Île-de-France;91;3;01;115;Bruyères-le-Châtel;3497;43;3540
11;Île-de-France;91;2;13;121;Buno-Bonnevaux;434;7;441
11;Île-de-France;91;3;10;122;Bures-sur-Yvette;9408;220;9628
11;Île-de-France;91;1;08;129;Cerny;3337;165;3502
11;Île-de-France;91;1;08;130;Chalo-Saint-Mars;1026;28;1054
11;Île-de-France;91;1;08;131;Chalou-Moulineux;404;8;412
11;Île-de-France;91;1;05;132;Chamarande;1133;12;1145
11;Île-de-France;91;2;13;135;Champcueil;2867;56;2923
11;Île-de-France;91;3;11;136;Champlan;2778;18;2796
11;Île-de-France;91;1;08;137;Champmotteux;370;6;376
11;Île-de-France;91;1;08;145;Chatignonville;69;0;69
11;Île-de-France;91;1;05;148;Chauffour-lès-Étréchy;137;0;137
11;Île-de-France;91;3;01;156;Cheptainville;2226;30;2256
11;Île-de-France;91;2;13;159;Chevannes;1590;28;1618
11;Île-de-France;91;3;12;161;Chilly-Mazarin;19822;128;19950
11;Île-de-France;91;2;04;174;Corbeil-Essonnes;51234;294;51528
11;Île-de-France;91;1;05;175;Corbreuse;1718;31;1749
11;Île-de-France;91;2;13;179;Le Coudray-Montceaux;4844;45;4889
11;Île-de-France;91;2;13;180;Courances;337;10;347
11;Île-de-France;91;2;13;184;Courdimanche-sur-Essonne;276;7;283
11;Île-de-France;91;3;05;186;Courson-Monteloup;577;8;585
11;Île-de-France;91;2;19;191;Crosne;9369;58;9427
11;Île-de-France;91;2;13;195;Dannemois;822;6;828
11;Île-de-France;91;1;08;198;D'Huison-Longueville;1495;24;1519
11;Île-de-France;91;1;05;200;Dourdan;10452;187;10639
11;Île-de-France;91;2;06;201;Draveil;28602;265;28867
11;Île-de-France;91;2;04;204;Écharcon;791;17;808
11;Île-de-France;91;3;01;207;Égly;6322;53;6375
11;Île-de-France;91;2;07;215;Épinay-sous-Sénart;12266;83;12349
11;Île-de-France;91;3;11;216;Épinay-sur-Orge;11184;145;11329
11;Île-de-France;91;1;08;223;Étampes;25629;184;25813
11;Île-de-France;91;2;06;225;Étiolles;3144;150;3294
11;Île-de-France;91;1;05;226;Étréchy;6729;92;6821
11;Île-de-France;91;2;09;228;Évry-Courcouronnes;66851;466;67317
11;Île-de-France;91;1;13;232;La Ferté-Alais;3659;55;3714
11;Île-de-France;91;2;15;235;Fleury-Mérogis;13641;18;13659
11;Île-de-France;91;1;08;240;Fontaine-la-Rivière;182;4;186
11;Île-de-France;91;3;05;243;Fontenay-lès-Briis;2232;32;2264
11;Île-de-France;91;2;13;244;Fontenay-le-Vicomte;1591;26;1617
11;Île-de-France;91;1;05;247;La Forêt-le-Roi;519;7;526
11;Île-de-France;91;1;08;248;La Forêt-Sainte-Croix;161;1;162
11;Île-de-France;91;3;05;249;Forges-les-Bains;3923;75;3998
11;Île-de-France;91;3;10;272;Gif-sur-Yvette;21007;595;21602
11;Île-de-France;91;2;13;273;Gironville-sur-Essonne;766;18;784
11;Île-de-France;91;3;10;274;Gometz-la-Ville;1502;24;1526
11;Île-de-France;91;3;18;275;Gometz-le-Châtel;2664;50;2714
11;Île-de-France;91;1;05;284;Les Granges-le-Roi;1177;23;1200
11;Île-de-France;91;2;20;286;Grigny;28201;98;28299
11;Île-de-France;91;3;01;292;Guibeville;842;15;857
11;Île-de-France;91;1;13;293;Guigneville-sur-Essonne;903;17;920
11;Île-de-France;91;1;08;294;Guillerval;814;11;825
11;Île-de-France;91;3;14;312;Igny;9917;303;10220
11;Île-de-France;91;1;13;315;Itteville;6522;61;6583
11;Île-de-France;91;1;01;318;Janville-sur-Juine;1970;49;2019
11;Île-de-France;91;3;05;319;Janvry;635;10;645
11;Île-de-France;91;3;02;326;Juvisy-sur-Orge;17454;127;17581
11;Île-de-France;91;1;01;330;Lardy;5483;102;5585
11;Île-de-France;91;3;03;332;Leudeville;1477;24;1501
11;Île-de-France;91;3;01;333;Leuville-sur-Orge;4378;43;4421
11;Île-de-France;91;3;05;338;Limours;6492;121;6613
11;Île-de-France;91;3;11;339;Linas;6842;51;6893
11;Île-de-France;91;2;04;340;Lisses;7333;63;7396
11;Île-de-France;91;3;11;345;Longjumeau;21269;143;21412
11;Île-de-France;91;3;03;347;Longpont-sur-Orge;6375;53;6428
11;Île-de-France;91;2;13;359;Maisse;2780;40;2820
11;Île-de-France;91;3;18;363;Marcoussis;8138;157;8295
11;Île-de-France;91;1;08;374;Marolles-en-Beauce;237;3;240
11;Île-de-France;91;3;03;376;Marolles-en-Hurepoix;5610;54;5664
11;Île-de-France;91;3;12;377;Massy;50644;352;50996
11;Île-de-France;91;1;05;378;Mauchamps;289;3;292
11;Île-de-France;91;2;13;386;Mennecy;15292;291;15583
11;Île-de-France;91;1;08;390;Le Mérévillois;3305;43;3348
11;Île-de-France;91;1;08;393;Mérobert;625;8;633
11;Île-de-France;91;1;08;399;Mespuits;227;5;232
11;Île-de-France;91;2;13;405;Milly-la-Forêt;4635;92;4727
11;Île-de-France;91;2;13;408;Moigny-sur-École;1252;30;1282
11;Île-de-France;91;3;10;411;Les Molières;1874;49;1923
11;Île-de-France;91;1;13;412;Mondeville;738;15;753
11;Île-de-France;91;1;08;414;Monnerville;382;5;387
11;Île-de-France;91;2;99;421;Montgeron;23760;293;24053
11;Île-de-France;91;3;11;425;Montlhéry;7681;223;7904
11;Île-de-France;91;3;17;432;Morangis;13424;78;13502
11;Île-de-France;91;1;08;433;Morigny-Champigny;4346;106;4452
11;Île-de-France;91;2;16;434;Morsang-sur-Orge;20124;165;20289
11;Île-de-France;91;2;07;435;Morsang-sur-Seine;550;27;577
11;Île-de-France;91;2;13;441;Nainville-les-Roches;503;11;514
11;Île-de-France;91;3;01;457;La Norville;4331;46;4377
11;Île-de-France;91;3;18;458;Nozay;4511;73;4584
11;Île-de-France;91;3;01;461;Ollainville;4759;58;4817
11;Île-de-France;91;2;13;463;Oncy-sur-École;1044;21;1065
11;Île-de-France;91;2;13;468;Ormoy;2158;21;2179
11;Île-de-France;91;1;08;469;Ormoy-la-Rivière;911;49;960
11;Île-de-France;91;3;14;471;Orsay;15503;329;15832
11;Île-de-France;91;1;08;473;Orveau;168;2;170
11;Île-de-France;91;3;14;477;Palaiseau;35236;332;35568
11;Île-de-France;91;3;02;479;Paray-Vieille-Poste;7814;58;7872
11;Île-de-France;91;3;10;482;Pecqueuse;548;11;559
11;Île-de-France;91;3;15;494;Le Plessis-Pâté;4140;58;4198
11;Île-de-France;91;1;08;495;Plessis-Saint-Benoist;337;3;340
11;Île-de-France;91;2;13;507;Prunay-sur-Essonne;289;5;294
11;Île-de-France;91;1;08;508;Puiselet-le-Marais;258;4;262
11;Île-de-France;91;1;08;511;Pussay;2106;29;2135
11;Île-de-France;91;2;07;514;Quincy-sous-Sénart;9426;47;9473
11;Île-de-France;91;1;05;519;Richarville;393;11;404
11;Île-de-France;91;2;15;521;Ris-Orangis;29745;182;29927
11;Île-de-France;91;1;05;525;Roinville;1340;25;1365
11;Île-de-France;91;1;08;526;Roinvilliers;107;1;108
11;Île-de-France;91;1;08;533;Saclas;1859;24;1883
11;Île-de-France;91;3;10;534;Saclay;4256;57;4313
11;Île-de-France;91;3;10;538;Saint-Aubin;696;20;716
11;Île-de-France;91;1;05;540;Saint-Chéron;5238;79;5317
11;Île-de-France;91;1;08;544;Saint-Cyr-la-Rivière;524;9;533
11;Île-de-France;91;1;05;546;Saint-Cyr-sous-Dourdan;937;22;959
11;Île-de-France;91;1;08;547;Saint-Escobille;506;17;523
11;Île-de-France;91;3;16;549;Sainte-Geneviève-des-Bois;35830;310;36140
11;Île-de-France;91;3;01;552;Saint-Germain-lès-Arpajon;10983;77;11060
11;Île-de-France;91;2;06;553;Saint-Germain-lès-Corbeil;7488;97;7585
11;Île-de-France;91;1;08;556;Saint-Hilaire;410;9;419
11;Île-de-France;91;3;18;560;Saint-Jean-de-Beauregard;487;7;494
11;Île-de-France;91;3;05;568;Saint-Maurice-Montcouronne;1544;37;1581
11;Île-de-France;91;3;03;570;Saint-Michel-sur-Orge;20484;147;20631
11;Île-de-France;91;2;07;573;Saint-Pierre-du-Perray;11220;111;11331
11;Île-de-France;91;2;07;577;Saintry-sur-Seine;5797;65;5862
11;Île-de-France;91;1;05;578;Saint-Sulpice-de-Favières;278;5;283
11;Île-de-France;91;3;03;579;Saint-Vrain;3059;52;3111
11;Île-de-France;91;1;01;581;Saint-Yon;902;10;912
11;Île-de-France;91;3;11;587;Saulx-les-Chartreux;6416;56;6472
11;Île-de-France;91;3;17;589;Savigny-sur-Orge;36577;246;36823
11;Île-de-France;91;1;05;593;Sermaise;1610;38;1648
11;Île-de-France;91;2;13;599;Soisy-sur-École;1282;22;1304
11;Île-de-France;91;2;06;600;Soisy-sur-Seine;7213;138;7351
11;Île-de-France;91;1;05;602;Souzy-la-Briche;441;9;450
11;Île-de-France;91;1;08;613;Congerville-Thionville;216;8;224
11;Île-de-France;91;2;07;617;Tigery;4294;76;4370
11;Île-de-France;91;1;01;619;Torfou;274;10;284
11;Île-de-France;91;1;08;629;Valpuiseaux;620;12;632
11;Île-de-France;91;1;05;630;Le Val-Saint-Germain;1486;32;1518
11;Île-de-France;91;2;07;631;Varennes-Jarcy;2300;31;2331
11;Île-de-France;91;3;05;634;Vaugrigneuse;1355;31;1386
11;Île-de-France;91;3;10;635;Vauhallan;2064;32;2096
11;Île-de-France;91;1;08;639;Vayres-sur-Essonne;959;68;1027
11;Île-de-France;91;3;10;645;Verrières-le-Buisson;14888;360;15248
11;Île-de-France;91;2;15;648;Vert-le-Grand;2262;27;2289
11;Île-de-France;91;2;15;649;Vert-le-Petit;2818;38;2856
11;Île-de-France;91;1;13;654;Videlles;595;17;612
11;Île-de-France;91;2;19;657;Vigneux-sur-Seine;31394;181;31575
11;Île-de-France;91;2;04;659;Villabé;5487;43;5530
11;Île-de-France;91;3;18;661;Villebon-sur-Yvette;10466;165;10631
11;Île-de-France;91;1;05;662;Villeconin;726;22;748
11;Île-de-France;91;3;11;665;La Ville-du-Bois;8010;65;8075
11;Île-de-France;91;3;18;666;Villejust;2425;18;2443
11;Île-de-France;91;3;16;667;Villemoisson-sur-Orge;7058;90;7148
11;Île-de-France;91;1;08;671;Villeneuve-sur-Auvers;604;7;611
11;Île-de-France;91;3;10;679;Villiers-le-Bâcle;1212;17;1229
11;Île-de-France;91;3;16;685;Villiers-sur-Orge;4600;39;4639
11;Île-de-France;91;2;20;687;Viry-Châtillon;30865;214;31079
11;Île-de-France;91;3;17;689;Wissous;7133;69;7202
11;Île-de-France;91;2;21;691;Yerres;29318;209;29527
11;Île-de-France;91;3;18;692;Les Ulis;25024;150;25174
11;Île-de-France;92;1;01;002;Antony;62760;775;63535
11;Île-de-France;92;2;95;004;Asnières-sur-Seine;87143;666;87809
11;Île-de-France;92;1;03;007;Bagneux;40936;134;41070
11;Île-de-France;92;2;11;009;Bois-Colombes;28841;241;29082
11;Île-de-France;92;3;96;012;Boulogne-Billancourt;121583;1242;122825
11;Île-de-France;92;1;03;014;Bourg-la-Reine;21050;360;21410
11;Île-de-France;92;1;06;019;Châtenay-Malabry;34021;357;34378
11;Île-de-France;92;1;07;020;Châtillon;36639;295;36934
11;Île-de-France;92;3;17;022;Chaville;20771;310;21081
11;Île-de-France;92;1;08;023;Clamart;52925;499;53424
11;Île-de-France;92;2;09;024;Clichy;63089;257;63346
11;Île-de-France;92;2;97;025;Colombes;86534;586;87120
11;Île-de-France;92;2;98;026;Courbevoie;81558;655;82213
11;Île-de-France;92;1;07;032;Fontenay-aux-Roses;25531;231;25762
11;Île-de-France;92;2;23;033;Garches;17795;438;18233
11;Île-de-France;92;2;11;035;La Garenne-Colombes;29642;247;29889
11;Île-de-France;92;2;14;036;Gennevilliers;48530;216;48746
11;Île-de-France;92;3;15;040;Issy-les-Moulineaux;67981;704;68685
11;Île-de-France;92;2;16;044;Levallois-Perret;66082;571;66653
11;Île-de-France;92;1;18;046;Malakoff;30950;201;31151
11;Île-de-France;92;3;23;047;Marnes-la-Coquette;1774;61;1835
11;Île-de-France;92;3;17;048;Meudon;45818;684;46502
11;Île-de-France;92;1;18;049;Montrouge;48352;235;48587
11;Île-de-France;92;2;99;050;Nanterre;96277;640;96917
11;Île-de-France;92;2;21;051;Neuilly-sur-Seine;59599;985;60584
11;Île-de-France;92;1;06;060;Le Plessis-Robinson;30061;154;30215
11;Île-de-France;92;2;13;062;Puteaux;45157;289;45446
11;Île-de-France;92;2;22;063;Rueil-Malmaison;78317;1471;79788
11;Île-de-France;92;2;23;064;Saint-Cloud;30012;598;30610
11;Île-de-France;92;1;06;071;Sceaux;20004;370;20374
11;Île-de-France;92;3;05;072;Sèvres;23463;389;23852
11;Île-de-France;92;2;20;073;Suresnes;49311;505;49816
11;Île-de-France;92;3;08;075;Vanves;27846;285;28131
11;Île-de-France;92;2;23;076;Vaucresson;8683;325;9008
11;Île-de-France;92;3;23;077;Ville-d'Avray;11225;302;11527
11;Île-de-France;92;2;14;078;Villeneuve-la-Garenne;24097;86;24183
11;Île-de-France;93;3;01;001;Aubervilliers;88948;191;89139
11;Île-de-France;93;2;02;005;Aulnay-sous-Bois;86969;410;87379
11;Île-de-France;93;1;03;006;Bagnolet;36060;106;36166
11;Île-de-France;93;2;04;007;Le Blanc-Mesnil;57498;166;57664
11;Île-de-France;93;1;95;008;Bobigny;54363;165;54528
11;Île-de-France;93;1;06;010;Bondy;54587;159;54746
11;Île-de-France;93;2;07;013;Le Bourget;15905;43;15948
11;Île-de-France;93;2;11;014;Clichy-sous-Bois;28782;92;28874
11;Île-de-France;93;2;20;015;Coubron;4921;42;4963
11;Île-de-France;93;3;07;027;La Courneuve;45053;128;45181
11;Île-de-France;93;2;96;029;Drancy;72376;282;72658
11;Île-de-France;93;2;07;030;Dugny;11073;40;11113
11;Île-de-France;93;3;97;031;Épinay-sur-Seine;54611;157;54768
11;Île-de-France;93;2;10;032;Gagny;39661;199;39860
11;Île-de-France;93;2;14;033;Gournay-sur-Marne;6844;61;6905
11;Île-de-France;93;3;18;039;L'Île-Saint-Denis;8288;41;8329
11;Île-de-France;93;1;03;045;Les Lilas;23447;128;23575
11;Île-de-France;93;2;11;046;Livry-Gargan;45692;216;45908
11;Île-de-France;93;2;20;047;Montfermeil;27928;130;28058
11;Île-de-France;93;1;98;048;Montreuil;111240;570;111810
11;Île-de-France;93;2;21;049;Neuilly-Plaisance;20878;129;21007
11;Île-de-France;93;2;10;050;Neuilly-sur-Marne;35907;121;36028
11;Île-de-France;93;2;14;051;Noisy-le-Grand;67871;385;68256
11;Île-de-France;93;1;05;053;Noisy-le-Sec;44463;128;44591
11;Île-de-France;93;1;15;055;Pantin;59846;181;60027
11;Île-de-France;93;2;06;057;Les Pavillons-sous-Bois;23898;97;23995
11;Île-de-France;93;3;09;059;Pierrefitte-sur-Seine;30861;47;30908
11;Île-de-France;93;1;15;061;Le Pré-Saint-Gervais;17351;72;17423
11;Île-de-France;93;2;21;062;Le Raincy;14569;198;14767
11;Île-de-France;93;1;03;063;Romainville;30087;84;30171
11;Île-de-France;93;2;12;064;Rosny-sous-Bois;46024;174;46198
11;Île-de-France;93;3;99;066;Saint-Denis;112852;914;113766
11;Île-de-France;93;3;18;070;Saint-Ouen-sur-Seine;50697;129;50826
11;Île-de-France;93;2;19;071;Sevran;51734;173;51907
11;Île-de-France;93;3;17;072;Stains;38285;76;38361
11;Île-de-France;93;2;20;073;Tremblay-en-France;36461;163;36624
11;Île-de-France;93;2;20;074;Vaujours;7181;89;7270
11;Île-de-France;93;2;21;077;Villemomble;30405;185;30590
11;Île-de-France;93;2;19;078;Villepinte;37713;83;37796
11;Île-de-France;93;3;09;079;Villetaneuse;13574;82;13656
11;Île-de-France;94;3;15;001;Ablon-sur-Seine;5852;27;5879
11;Île-de-France;94;1;01;002;Alfortville;44805;161;44966
11;Île-de-France;94;3;02;003;Arcueil;21788;122;21910
11;Île-de-France;94;1;16;004;Boissy-Saint-Léger;16977;55;17032
11;Île-de-France;94;1;18;011;Bonneuil-sur-Marne;18062;72;18134
11;Île-de-France;94;2;22;015;Bry-sur-Marne;17525;198;17723
11;Île-de-France;94;3;02;016;Cachan;30440;274;30714
11;Île-de-France;94;2;93;017;Champigny-sur-Marne;76990;344;77334
11;Île-de-France;94;2;05;018;Charenton-le-Pont;29882;204;30086
11;Île-de-France;94;1;04;019;Chennevières-sur-Marne;18039;114;18153
11;Île-de-France;94;3;19;021;Chevilly-Larue;19988;69;20057
11;Île-de-France;94;3;06;022;Choisy-le-Roi;46150;209;46359
11;Île-de-France;94;1;94;028;Créteil;93246;476;93722
11;Île-de-France;94;2;09;033;Fontenay-sous-Bois;52008;419;52427
11;Île-de-France;94;3;10;034;Fresnes;28710;112;28822
11;Île-de-France;94;3;12;037;Gentilly;18815;106;18921
11;Île-de-France;94;3;10;038;L'Haÿ-les-Roses;32071;173;32244
11;Île-de-France;94;3;11;041;Ivry-sur-Seine;63748;250;63998
11;Île-de-France;94;2;05;042;Joinville-le-Pont;19652;155;19807
11;Île-de-France;94;3;12;043;Le Kremlin-Bicêtre;24971;114;25085
11;Île-de-France;94;1;21;044;Limeil-Brévannes;27833;112;27945
11;Île-de-France;94;2;13;046;Maisons-Alfort;56483;291;56774
11;Île-de-France;94;1;16;047;Mandres-les-Roses;4777;48;4825
11;Île-de-France;94;1;16;048;Marolles-en-Brie;4783;105;4888
11;Île-de-France;94;2;95;052;Nogent-sur-Marne;34042;236;34278
11;Île-de-France;94;1;16;053;Noiseau;4607;42;4649
11;Île-de-France;94;3;15;054;Orly;24627;178;24805
11;Île-de-France;94;1;18;055;Ormesson-sur-Marne;10419;91;10510
11;Île-de-France;94;1;16;056;Périgny;2688;24;2712
11;Île-de-France;94;2;14;058;Le Perreux-sur-Marne;33588;303;33891
11;Île-de-France;94;1;22;059;Le Plessis-Trévise;19829;78;19907
11;Île-de-France;94;1;16;060;La Queue-en-Brie;12051;133;12184
11;Île-de-France;94;3;19;065;Rungis;5657;67;5724
11;Île-de-France;94;2;23;067;Saint-Mandé;22377;199;22576
11;Île-de-France;94;2;96;068;Saint-Maur-des-Fossés;74976;912;75888
11;Île-de-France;94;2;05;069;Saint-Maurice;14189;118;14307
11;Île-de-France;94;1;16;070;Santeny;4014;61;4075
11;Île-de-France;94;1;18;071;Sucy-en-Brie;27157;258;27415
11;Île-de-France;94;3;19;073;Thiais;30676;234;30910
11;Île-de-France;94;3;21;074;Valenton;14883;51;14934
11;Île-de-France;94;1;16;075;Villecresnes;11779;65;11844
11;Île-de-France;94;3;20;076;Villejuif;55208;243;55451
11;Île-de-France;94;3;15;077;Villeneuve-le-Roi;21679;96;21775
11;Île-de-France;94;3;97;078;Villeneuve-Saint-Georges;34890;102;34992
11;Île-de-France;94;2;22;079;Villiers-sur-Marne;28895;119;29014
11;Île-de-France;94;2;98;080;Vincennes;49788;442;50230
11;Île-de-France;94;3;99;081;Vitry-sur-Seine;95510;459;95969
11;Île-de-France;95;3;16;002;Ableiges;1124;14;1138
11;Île-de-France;95;3;20;008;Aincourt;887;12;899
11;Île-de-France;95;3;20;011;Ambleville;387;3;390
11;Île-de-France;95;3;20;012;Amenucourt;205;6;211
11;Île-de-France;95;2;15;014;Andilly;2574;54;2628
11;Île-de-France;95;1;98;018;Argenteuil;111038;557;111595
11;Île-de-France;95;2;11;019;Arnouville;14255;80;14335
11;Île-de-France;95;3;16;023;Arronville;637;3;640
11;Île-de-France;95;3;20;024;Arthies;271;5;276
11;Île-de-France;95;2;14;026;Asnières-sur-Oise;2939;39;2978
11;Île-de-France;95;2;09;028;Attainville;1691;8;1699
11;Île-de-France;95;3;17;039;Auvers-sur-Oise;6813;102;6915
11;Île-de-France;95;3;20;040;Avernes;857;14;871
11;Île-de-France;95;2;07;042;Baillet-en-France;1899;15;1914
11;Île-de-France;95;3;20;046;Banthelu;148;2;150
11;Île-de-France;95;1;19;051;Beauchamp;8687;94;8781
11;Île-de-France;95;3;14;052;Beaumont-sur-Oise;9504;103;9607
11;Île-de-France;95;3;16;054;Le Bellay-en-Vexin;212;5;217
11;Île-de-France;95;2;09;055;Bellefontaine;477;3;480
11;Île-de-France;95;2;09;056;Belloy-en-France;2203;9;2212
11;Île-de-France;95;3;14;058;Bernes-sur-Oise;2733;24;2757
11;Île-de-France;95;3;16;059;Berville;350;3;353
11;Île-de-France;95;1;19;060;Bessancourt;7878;61;7939
11;Île-de-France;95;3;07;061;Béthemont-la-Forêt;410;2;412
11;Île-de-France;95;1;03;063;Bezons;31671;124;31795
11;Île-de-France;95;3;05;074;Boisemont;818;15;833
11;Île-de-France;95;3;16;078;Boissy-l'Aillerie;1844;31;1875
11;Île-de-France;95;2;21;088;Bonneuil-en-France;1129;2;1131
11;Île-de-France;95;2;07;091;Bouffémont;6578;58;6636
11;Île-de-France;95;2;21;094;Bouqueval;302;3;305
11;Île-de-France;95;3;20;101;Bray-et-Lû;962;12;974
11;Île-de-France;95;3;16;102;Bréançon;404;9;413
11;Île-de-France;95;3;16;110;Brignancourt;212;3;215
11;Île-de-France;95;3;14;116;Bruyères-sur-Oise;4347;34;4381
11;Île-de-France;95;3;20;119;Buhy;322;3;325
11;Île-de-France;95;3;17;120;Butry-sur-Oise;2276;24;2300
11;Île-de-France;95;3;99;127;Cergy;65911;518;66429
11;Île-de-France;95;3;14;134;Champagne-sur-Oise;5018;42;5060
11;Île-de-France;95;3;20;139;La Chapelle-en-Vexin;316;5;321
11;Île-de-France;95;3;20;141;Charmont;36;0;36
11;Île-de-France;95;3;16;142;Chars;2046;17;2063
11;Île-de-France;95;2;09;144;Châtenay-en-France;76;1;77
11;Île-de-France;95;2;09;149;Chaumontel;3241;54;3295
11;Île-de-France;95;3;20;150;Chaussy;582;15;597
11;Île-de-France;95;3;07;151;Chauvry;299;5;304
11;Île-de-France;95;2;12;154;Chennevières-lès-Louvres;305;3;308
11;Île-de-France;95;3;20;157;Chérence;124;4;128
11;Île-de-France;95;3;20;166;Cléry-en-Vexin;465;7;472
11;Île-de-France;95;3;16;169;Commeny;498;3;501
11;Île-de-France;95;3;20;170;Condécourt;548;1;549
11;Île-de-France;95;1;10;176;Cormeilles-en-Parisis;25406;214;25620
11;Île-de-France;95;3;16;177;Cormeilles-en-Vexin;1333;14;1347
11;Île-de-France;95;3;16;181;Courcelles-sur-Viosne;288;3;291
11;Île-de-France;95;3;20;183;Courdimanche;6709;111;6820
11;Île-de-France;95;2;06;197;Deuil-la-Barre;22149;187;22336
11;Île-de-France;95;2;07;199;Domont;15504;194;15698
11;Île-de-France;95;1;08;203;Eaubonne;25335;318;25653
11;Île-de-France;95;2;09;205;Écouen;7125;44;7169
11;Île-de-France;95;2;15;210;Enghien-les-Bains;11470;158;11628
11;Île-de-France;95;3;16;211;Ennery;2418;24;2442
11;Île-de-France;95;2;12;212;Épiais-lès-Louvres;109;0;109
11;Île-de-France;95;3;16;213;Épiais-Rhus;616;15;631
11;Île-de-France;95;2;09;214;Épinay-Champlâtreux;70;0;70
11;Île-de-France;95;3;05;218;Éragny;18296;120;18416
11;Île-de-France;95;1;08;219;Ermont;28939;244;29183
11;Île-de-France;95;2;09;229;Ézanville;9656;56;9712
11;Île-de-France;95;2;09;241;Fontenay-en-Parisis;2007;16;2023
11;Île-de-France;95;2;09;250;Fosses;9791;61;9852
11;Île-de-France;95;1;10;252;Franconville;37394;170;37564
11;Île-de-France;95;3;20;253;Frémainville;520;11;531
11;Île-de-France;95;3;16;254;Frémécourt;558;7;565
11;Île-de-France;95;1;17;256;Frépillon;3342;44;3386
11;Île-de-France;95;1;13;257;La Frette-sur-Seine;4701;41;4742
11;Île-de-France;95;3;17;258;Frouville;349;8;357
11;Île-de-France;95;2;11;268;Garges-lès-Gonesse;43239;94;43333
11;Île-de-France;95;3;20;270;Genainville;541;19;560
11;Île-de-France;95;3;16;271;Génicourt;519;9;528
11;Île-de-France;95;2;21;277;Gonesse;26106;122;26228
11;Île-de-France;95;2;12;280;Goussainville;31068;143;31211
11;Île-de-France;95;3;16;282;Gouzangrez;160;1;161
11;Île-de-France;95;3;16;287;Grisy-les-Plâtres;694;12;706
11;Île-de-France;95;2;06;288;Groslay;8509;52;8561
11;Île-de-France;95;3;20;295;Guiry-en-Vexin;142;3;145
11;Île-de-France;95;3;16;298;Haravilliers;561;7;568
11;Île-de-France;95;3;20;301;Haute-Isle;286;6;292
11;Île-de-France;95;3;16;303;Le Heaulme;206;1;207
11;Île-de-France;95;3;17;304;Hédouville;281;2;283
11;Île-de-France;95;1;13;306;Herblay-sur-Seine;31314;231;31545
11;Île-de-France;95;3;17;308;Hérouville-en-Vexin;576;12;588
11;Île-de-France;95;3;20;309;Hodent;207;3;210
11;Île-de-France;95;3;14;313;L'Isle-Adam;12063;216;12279
11;Île-de-France;95;2;09;316;Jagny-sous-Bois;271;2;273
11;Île-de-France;95;3;05;323;Jouy-le-Moutier;16741;132;16873
11;Île-de-France;95;3;17;328;Labbeville;643;7;650
11;Île-de-France;95;2;09;331;Lassy;190;3;193
11;Île-de-France;95;3;16;341;Livilliers;383;9;392
11;Île-de-France;95;3;20;348;Longuesse;550;6;556
11;Île-de-France;95;2;12;351;Louvres;11037;83;11120
11;Île-de-France;95;2;09;352;Luzarches;4733;79;4812
11;Île-de-France;95;2;09;353;Maffliers;1834;17;1851
11;Île-de-France;95;3;20;355;Magny-en-Vexin;5846;58;5904
11;Île-de-France;95;2;09;365;Mareil-en-France;707;8;715
11;Île-de-France;95;2;15;369;Margency;2846;50;2896
11;Île-de-France;95;3;16;370;Marines;3446;52;3498
11;Île-de-France;95;2;12;371;Marly-la-Ville;5663;43;5706
11;Île-de-France;95;3;20;379;Maudétour-en-Vexin;188;2;190
11;Île-de-France;95;3;16;387;Menouville;62;0;62
11;Île-de-France;95;3;20;388;Menucourt;5902;53;5955
11;Île-de-France;95;3;17;392;Mériel;5168;53;5221
11;Île-de-France;95;3;17;394;Méry-sur-Oise;9865;97;9962
11;Île-de-France;95;2;09;395;Le Mesnil-Aubry;898;9;907
11;Île-de-France;95;2;07;409;Moisselles;1287;3;1290
11;Île-de-France;95;3;16;422;Montgeroult;347;3;350
11;Île-de-France;95;1;13;424;Montigny-lès-Cormeilles;21528;110;21638
11;Île-de-France;95;2;15;426;Montlignon;2937;75;3012
11;Île-de-France;95;2;06;427;Montmagny;14523;65;14588
11;Île-de-France;95;2;15;428;Montmorency;21723;252;21975
11;Île-de-France;95;3;20;429;Montreuil-sur-Epte;406;10;416
11;Île-de-France;95;2;07;430;Montsoult;3633;35;3668
11;Île-de-France;95;3;14;436;Mours;1629;9;1638
11;Île-de-France;95;3;16;438;Moussy;121;2;123
11;Île-de-France;95;3;14;445;Nerville-la-Forêt;747;4;751
11;Île-de-France;95;3;17;446;Nesles-la-Vallée;1803;31;1834
11;Île-de-France;95;3;16;447;Neuilly-en-Vexin;220;4;224
11;Île-de-France;95;3;05;450;Neuville-sur-Oise;2043;28;2071
11;Île-de-France;95;3;14;452;Nointel;863;7;870
11;Île-de-France;95;3;14;456;Noisy-sur-Oise;653;4;657
11;Île-de-France;95;3;16;459;Nucourt;699;15;714
11;Île-de-France;95;3;20;462;Omerville;323;8;331
11;Île-de-France;95;3;04;476;Osny;17446;239;17685
11;Île-de-France;95;3;14;480;Parmain;5589;112;5701
11;Île-de-France;95;3;16;483;Le Perchay;533;4;537
11;Île-de-France;95;3;14;487;Persan;13734;54;13788
11;Île-de-France;95;1;19;488;Pierrelaye;9423;39;9462
11;Île-de-France;95;2;07;489;Piscop;671;69;740
11;Île-de-France;95;1;07;491;Le Plessis-Bouchard;8514;75;8589
11;Île-de-France;95;2;09;492;Le Plessis-Gassot;74;0;74
11;Île-de-France;95;2;09;493;Le Plessis-Luzarches;128;1;129
11;Île-de-France;95;3;16;500;Pontoise;32405;486;32891
11;Île-de-France;95;3;14;504;Presles;3923;51;3974
11;Île-de-France;95;2;09;509;Puiseux-en-France;3563;32;3595
11;Île-de-France;95;3;04;510;Puiseux-Pontoise;583;11;594
11;Île-de-France;95;3;20;523;La Roche-Guyon;479;37;516
11;Île-de-France;95;2;21;527;Roissy-en-France;2833;26;2859
11;Île-de-France;95;3;14;529;Ronquerolles;866;8;874
11;Île-de-France;95;3;20;535;Sagy;1104;26;1130
11;Île-de-France;95;2;06;539;Saint-Brice-sous-Forêt;15043;78;15121
11;Île-de-France;95;3;20;541;Saint-Clair-sur-Epte;1001;13;1014
11;Île-de-France;95;3;20;543;Saint-Cyr-en-Arthies;240;1;241
11;Île-de-France;95;3;20;554;Saint-Gervais;896;19;915
11;Île-de-France;95;2;01;555;Saint-Gratien;20895;166;21061
11;Île-de-France;95;1;07;563;Saint-Leu-la-Forêt;16130;174;16304
11;Île-de-France;95;2;09;566;Saint-Martin-du-Tertre;2697;24;2721
11;Île-de-France;95;3;17;572;Saint-Ouen-l'Aumône;24674;115;24789
11;Île-de-France;95;2;07;574;Saint-Prix;7036;107;7143
11;Île-de-France;95;2;12;580;Saint-Witz;2379;104;2483
11;Île-de-France;95;1;01;582;Sannois;26565;336;26901
11;Île-de-France;95;3;16;584;Santeuil;663;7;670
11;Île-de-France;95;2;18;585;Sarcelles;59196;252;59448
11;Île-de-France;95;3;20;592;Seraincourt;1290;14;1304
11;Île-de-France;95;2;09;594;Seugy;1025;14;1039
11;Île-de-France;95;2;15;598;Soisy-sous-Montmorency;18033;161;18194
11;Île-de-France;95;2;12;604;Survilliers;4213;25;4238
11;Île-de-France;95;1;19;607;Taverny;26872;190;27062
11;Île-de-France;95;3;20;610;Théméricourt;300;7;307
11;Île-de-France;95;3;16;611;Theuville;50;0;50
11;Île-de-France;95;2;21;612;Le Thillay;4567;21;4588
11;Île-de-France;95;3;16;625;Us;1339;12;1351
11;Île-de-France;95;3;16;627;Vallangoujard;598;13;611
11;Île-de-France;95;3;17;628;Valmondois;1213;25;1238
11;Île-de-France;95;2;21;633;Vaudherland;98;0;98
11;Île-de-France;95;3;20;637;Vauréal;16456;219;16675
11;Île-de-France;95;2;12;641;Vémars;2699;22;2721
11;Île-de-France;95;3;20;651;Vétheuil;884;19;903
11;Île-de-France;95;2;09;652;Viarmes;5194;73;5267
11;Île-de-France;95;3;20;656;Vienne-en-Arthies;379;6;385
11;Île-de-France;95;3;20;658;Vigny;1083;22;1105
11;Île-de-France;95;2;09;660;Villaines-sous-Bois;775;8;783
11;Île-de-France;95;2;12;675;Villeron;1506;14;1520
11;Île-de-France;95;3;20;676;Villers-en-Arthies;490;10;500
11;Île-de-France;95;3;14;678;Villiers-Adam;861;11;872
11;Île-de-France;95;2;21;680;Villiers-le-Bel;28423;117;28540
11;Île-de-France;95;2;09;682;Villiers-le-Sec;189;3;192
11;Île-de-France;95;3;20;690;Wy-dit-Joli-Village;330;7;337
01;Guadeloupe;971;2;93;101;Les Abymes;53514;513;54027
01;Guadeloupe;971;2;14;102;Anse-Bertrand;4001;64;4065
01;Guadeloupe;971;1;94;103;Baie-Mahault;30837;498;31335
01;Guadeloupe;971;1;21;104;Baillif;5203;92;5295
01;Guadeloupe;971;1;06;105;Basse-Terre;9861;244;10105
01;Guadeloupe;971;1;95;106;Bouillante;6847;111;6958
01;Guadeloupe;971;1;07;107;Capesterre-Belle-Eau;17741;173;17914
01;Guadeloupe;971;2;10;108;Capesterre-de-Marie-Galante;3298;43;3341
01;Guadeloupe;971;1;20;109;Gourbeyre;7760;185;7945
01;Guadeloupe;971;2;16;110;La Désirade;1419;34;1453
01;Guadeloupe;971;1;18;111;Deshaies;3998;65;4063
01;Guadeloupe;971;2;10;112;Grand-Bourg;4870;132;5002
01;Guadeloupe;971;2;96;113;Le Gosier;26489;344;26833
01;Guadeloupe;971;1;13;114;Goyave;7621;138;7759
01;Guadeloupe;971;1;09;115;Lamentin;16354;297;16651
01;Guadeloupe;971;2;12;116;Morne-à-l'Eau;16495;197;16692
01;Guadeloupe;971;2;11;117;Le Moule;22149;274;22423
01;Guadeloupe;971;1;97;118;Petit-Bourg;24753;421;25174
01;Guadeloupe;971;2;14;119;Petit-Canal;8203;123;8326
01;Guadeloupe;971;2;15;120;Pointe-à-Pitre;15181;108;15289
01;Guadeloupe;971;1;18;121;Pointe-Noire;6031;144;6175
01;Guadeloupe;971;2;14;122;Port-Louis;5618;70;5688
01;Guadeloupe;971;1;06;124;Saint-Claude;10466;265;10731
01;Guadeloupe;971;2;16;125;Saint-François;11689;160;11849
01;Guadeloupe;971;2;10;126;Saint-Louis;2397;54;2451
01;Guadeloupe;971;2;98;128;Sainte-Anne;24151;269;24420
01;Guadeloupe;971;1;99;129;Sainte-Rose;17985;294;18279
01;Guadeloupe;971;1;20;130;Terre-de-Bas;975;24;999
01;Guadeloupe;971;1;20;131;Terre-de-Haut;1519;51;1570
01;Guadeloupe;971;1;20;132;Trois-Rivières;7862;148;8010
01;Guadeloupe;971;1;20;133;Vieux-Fort;1842;31;1873
01;Guadeloupe;971;1;21;134;Vieux-Habitants;7110;190;7300
02;Martinique;972;2;  ;201;L'Ajoupa-Bouillon;1756;31;1787
02;Martinique;972;3;  ;202;Les Anses-d'Arlet;3494;53;3547
02;Martinique;972;2;  ;203;Basse-Pointe;2823;42;2865
02;Martinique;972;4;  ;204;Le Carbet;3461;47;3508
02;Martinique;972;4;  ;205;Case-Pilote;4455;68;4523
02;Martinique;972;3;  ;206;Le Diamant;5511;74;5585
02;Martinique;972;3;  ;207;Ducos;17655;287;17942
02;Martinique;972;4;  ;208;Fonds-Saint-Denis;680;12;692
02;Martinique;972;1;  ;209;Fort-de-France;76512;898;77410
02;Martinique;972;3;  ;210;Le François;15980;210;16190
02;Martinique;972;2;  ;211;Grand'Rivière;610;11;621
02;Martinique;972;2;  ;212;Gros-Morne;9689;88;9777
02;Martinique;972;1;  ;213;Le Lamentin;40095;590;40685
02;Martinique;972;2;  ;214;Le Lorrain;6768;76;6844
02;Martinique;972;2;  ;215;Macouba;1050;8;1058
02;Martinique;972;2;  ;216;Le Marigot;3117;49;3166
02;Martinique;972;3;  ;217;Le Marin;8751;145;8896
02;Martinique;972;4;  ;218;Le Morne-Rouge;4795;53;4848
02;Martinique;972;4;  ;219;Le Prêcheur;1203;23;1226
02;Martinique;972;3;  ;220;Rivière-Pilote;11877;143;12020
02;Martinique;972;3;  ;221;Rivière-Salée;11874;237;12111
02;Martinique;972;2;  ;222;Le Robert;21913;183;22096
02;Martinique;972;3;  ;223;Saint-Esprit;9890;97;9987
02;Martinique;972;1;  ;224;Saint-Joseph;15883;249;16132
02;Martinique;972;4;  ;225;Saint-Pierre;4121;55;4176
02;Martinique;972;3;  ;226;Sainte-Anne;4444;59;4503
02;Martinique;972;3;  ;227;Sainte-Luce;9487;204;9691
02;Martinique;972;2;  ;228;Sainte-Marie;15487;165;15652
02;Martinique;972;1;  ;229;Schœlcher;19612;218;19830
02;Martinique;972;2;  ;230;La Trinité;12025;152;12177
02;Martinique;972;3;  ;231;Les Trois-Îlets;7242;123;7365
02;Martinique;972;3;  ;232;Le Vauclin;8619;96;8715
02;Martinique;972;4;  ;233;Le Morne-Vert;1816;26;1842
02;Martinique;972;4;  ;234;Bellefontaine;1813;126;1939
03;Guyane;973;1;  ;301;Régina;854;26;880
03;Guyane;973;1;  ;302;Cayenne;65493;385;65878
03;Guyane;973;1;  ;303;Iracoubo;1748;20;1768
03;Guyane;973;1;  ;304;Kourou;24903;245;25148
03;Guyane;973;1;  ;305;Macouria;16219;186;16405
03;Guyane;973;2;  ;306;Mana;11675;170;11845
03;Guyane;973;1;  ;307;Matoury;33458;238;33696
03;Guyane;973;1;  ;308;Saint-Georges;4245;90;4335
03;Guyane;973;1;  ;309;Remire-Montjoly;26358;381;26739
03;Guyane;973;1;  ;310;Roura;3458;54;3512
03;Guyane;973;2;  ;311;Saint-Laurent-du-Maroni;47621;342;47963
03;Guyane;973;1;  ;312;Sinnamary;2875;44;2919
03;Guyane;973;1;  ;313;Montsinéry-Tonnegrande;2957;19;2976
03;Guyane;973;1;  ;314;Ouanary;242;1;243
03;Guyane;973;2;  ;352;Saül;152;7;159
03;Guyane;973;2;  ;353;Maripasoula;11842;125;11967
03;Guyane;973;1;  ;356;Camopi;1864;24;1888
03;Guyane;973;2;  ;357;Grand-Santi;8779;5;8784
03;Guyane;973;1;  ;358;Saint-Élie;247;1;248
03;Guyane;973;2;  ;360;Apatou;9482;15;9497
03;Guyane;973;2;  ;361;Awala-Yalimapo;1449;12;1461
03;Guyane;973;2;  ;362;Papaichton;5757;17;5774
04;La Réunion;974;2;01;401;Les Avirons;11440;210;11650
04;La Réunion;974;3;06;402;Bras-Panon;13057;203;13260
04;La Réunion;974;2;16;403;Entre-Deux;6927;65;6992
04;La Réunion;974;2;01;404;L'Étang-Salé;14059;199;14258
04;La Réunion;974;2;22;405;Petite-Île;12395;123;12518
04;La Réunion;974;3;07;406;La Plaine-des-Palmistes;6626;99;6725
04;La Réunion;974;4;02;407;Le Port;32977;258;33235
04;La Réunion;974;4;03;408;La Possession;32985;420;33405
04;La Réunion;974;3;91;409;Saint-André;56902;464;57366
04;La Réunion;974;3;92;410;Saint-Benoît;37036;249;37285
04;La Réunion;974;1;93;411;Saint-Denis;153810;1492;155302
04;La Réunion;974;2;94;412;Saint-Joseph;37918;507;38425
04;La Réunion;974;4;95;413;Saint-Leu;34586;476;35062
04;La Réunion;974;2;96;414;Saint-Louis;53120;573;53693
04;La Réunion;974;4;97;415;Saint-Paul;103208;1348;104556
04;La Réunion;974;2;98;416;Saint-Pierre;84982;896;85878
04;La Réunion;974;2;08;417;Saint-Philippe;5198;66;5264
04;La Réunion;974;1;23;418;Sainte-Marie;34061;450;34511
04;La Réunion;974;3;08;419;Sainte-Rose;6345;77;6422
04;La Réunion;974;1;04;420;Sainte-Suzanne;24065;227;24292
04;La Réunion;974;3;06;421;Salazie;7136;73;7209
04;La Réunion;974;2;99;422;Le Tampon;79824;1009;80833
04;La Réunion;974;4;14;423;Les Trois-Bassins;7015;91;7106
04;La Réunion;974;2;16;424;Cilaos;5538;85;5623
